ordem;nivel;cod_dim2;Zona Geográfica;População residente - Total;População residente - H;População residente - M;População presente - Total;População presente - H;População presente - M;Famílias - Clássicas ;Famílias - Institucionais;Núcleos familiares ;Alojamentos familiares - Total ;Alojamentos familiares - Clássicos;Alojamentos familiares - Não clássicos;Alojamentos colectivos;Edifícios clássicos
231883000;3;18;            Alentejo;757302;366739;390563;733327;352913;380414;302975;543;233364;470284;469287;997;1455;383866
231884000;4;181;                Alentejo Litoral;97925;48624;49301;95376;47467;47909;40533;48;30280;68532;68352;180;266;53482
231885000;5;211;                    Odemira;26066;13171;12895;25716;12955;12761;11362;10;7927;20924;20851;73;108;18449
231886000;6;21101;                        Colos;1005;497;508;977;481;496;417;2;298;750;750;0;2;745
231954000;6;21102;                        Relíquias;931;462;469;1065;516;549;413;1;278;772;771;1;2;763
232007000;6;21103;                        Sabóia;1152;603;549;1153;604;549;540;1;317;918;917;1;2;878
232064000;6;21104;                        Santa Clara-a-Velha;602;310;292;599;311;288;271;0;174;553;552;1;2;550
232094000;6;21105;                        Odemira (Santa Maria);1301;609;692;1318;607;711;533;4;362;822;822;0;7;714
232145000;6;21106;                        São Luís;1989;995;994;1936;969;967;881;0;643;1759;1756;3;9;1701
232232000;6;21107;                        São Martinho das Amoreiras;1006;515;491;989;505;484;442;1;302;1024;1024;0;2;958
232277000;6;21108;                        Odemira (São Salvador);1818;884;934;1735;856;879;796;0;578;1204;1200;4;5;1038
232352000;6;21109;                        São Teotónio;5527;2911;2616;5449;2852;2597;2593;1;1620;3745;3725;20;21;3342
232551000;6;21110;                        Vale de Santiago;554;278;276;525;262;263;248;0;175;467;464;3;0;466
232589000;6;21111;                        Vila Nova de Milfontes;5031;2480;2551;4947;2429;2518;2062;0;1559;4635;4618;17;28;3556
232812000;6;21112;                        Pereiras-Gare;271;143;128;266;140;126;126;0;84;334;334;0;1;329
232836000;6;21113;                        Bicos;549;287;262;529;276;253;227;0;178;407;406;1;0;380
232868000;6;21114;                        Zambujeira do Mar;912;452;460;907;455;452;432;0;288;1064;1051;13;14;748
232968000;6;21115;                        Luzianes-Gare;429;242;187;408;231;177;206;0;127;435;435;0;1;409
232989000;6;21116;                        Boavista dos Pinheiros;1633;822;811;1592;799;793;617;0;518;823;821;2;3;745
233051000;6;21117;                        Longueira/Almograve;1356;681;675;1321;662;659;558;0;426;1212;1205;7;9;1127
233118000;5;1501;                    Alcácer do Sal;13046;6332;6714;12582;6089;6493;5236;8;4114;8818;8798;20;30;7535
233119000;6;150101;                        Alcácer do Sal (Santa Maria do Castelo);4048;1972;2076;3947;1925;2022;1617;2;1266;2416;2406;10;5;1894
233324000;6;150102;                        Santa Susana;353;180;173;339;172;167;168;0;128;420;420;0;1;420
233375000;6;150103;                        Alcácer do Sal (Santiago);4632;2206;2426;4477;2115;2362;1806;4;1429;2714;2711;3;13;2220
233574000;6;150104;                        Torrão;2295;1093;1202;2172;1032;1140;935;2;733;1805;1804;1;6;1611
233739000;6;150105;                        São Martinho;450;229;221;432;224;208;196;0;161;370;370;0;0;369
233773000;6;150106;                        Comporta;1268;652;616;1215;621;594;514;0;397;1093;1087;6;5;1021
233888000;5;1505;                    Grândola;14826;7506;7320;14475;7294;7181;5974;14;4497;12041;12025;16;35;9337
233889000;6;150501;                        Azinheira Barros e São Mamede do Sádão;704;364;340;685;350;335;320;0;216;614;614;0;3;614
233929000;6;150502;                        Grândola;10657;5163;5494;10245;4922;5323;4395;5;3324;6701;6689;12;16;5458
234252000;6;150503;                        Melides;1658;825;833;1702;846;856;729;0;555;1747;1744;3;3;1623
234334000;6;150504;                        Santa Margarida da Serra;177;94;83;177;94;83;87;0;58;262;262;0;0;222
234356000;6;150505;                        Carvalhal;1630;1060;570;1666;1082;584;443;9;344;2717;2716;1;13;1420
234450000;5;1509;                    Santiago do Cacém;29749;14586;15163;28323;13852;14471;12345;11;9364;18431;18387;44;46;13370
234451000;6;150901;                        Abela;890;442;448;898;445;453;382;0;285;603;600;3;1;592
234501000;6;150902;                        Alvalade;2098;1024;1074;2021;987;1034;894;0;665;1175;1173;2;2;1123
234608000;6;150903;                        Cercal;3362;1650;1712;3131;1517;1614;1460;0;1074;2686;2680;6;8;2431
234729000;6;150904;                        Ermidas-Sado;2020;979;1041;1936;929;1007;870;2;642;1391;1386;5;4;1278
234833000;6;150905;                        Santa Cruz;461;237;224;449;232;217;206;0;148;363;362;1;0;348
234857000;6;150906;                        Santiago do Cacém;7603;3676;3927;7315;3564;3751;3126;6;2300;4369;4358;11;20;2831
235094000;6;150907;                        Santo André;10647;5247;5400;9995;4896;5099;4265;3;3416;5881;5869;12;9;2870
235333000;6;150908;                        São Bartolomeu da Serra;390;209;181;376;203;173;171;0;122;289;288;1;0;265
235360000;6;150909;                        São Domingos;854;408;446;830;393;437;363;0;265;597;596;1;0;588
235410000;6;150910;                        São Francisco da Serra;809;411;398;778;397;381;345;0;245;595;594;1;1;567
235438000;6;150911;                        Vale de Água;615;303;312;594;289;305;263;0;202;482;481;1;1;477
235467000;5;1513;                    Sines;14238;7029;7209;14280;7277;7003;5616;5;4378;8318;8291;27;47;4791
235468000;6;151301;                        Sines;13200;6513;6687;13203;6729;6474;5194;5;4045;7170;7144;26;40;3866
235819000;6;151302;                        Porto Covo;1038;516;522;1077;548;529;422;0;333;1148;1147;1;7;925
235926000;4;182;                Alto Alentejo;118410;56796;61614;114613;54702;59911;47524;118;36291;81351;81147;204;296;68275
235927000;5;707;                    Mora;4978;2415;2563;4823;2311;2512;2063;6;1523;3880;3877;3;19;3867
235928000;6;70701;                        Brotas;451;219;232;436;209;227;208;1;147;386;386;0;1;387
235967000;6;70702;                        Cabeção;1073;489;584;1060;482;578;432;3;317;1051;1051;0;5;1052
236039000;6;70703;                        Mora;2522;1231;1291;2403;1152;1251;996;2;773;1496;1496;0;7;1483
236141000;6;70704;                        Pavia;932;476;456;924;468;456;427;0;286;947;944;3;6;945
236209000;5;1201;                    Alter do Chão;3562;1680;1882;3275;1533;1742;1464;7;1102;3052;3042;10;18;2886
236210000;6;120101;                        Alter do Chão;2373;1120;1253;2100;982;1118;936;4;722;1739;1729;10;10;1591
236353000;6;120102;                        Chancelaria;448;202;246;453;203;250;198;1;137;559;559;0;2;560
236399000;6;120103;                        Seda;352;176;176;335;168;167;162;1;121;400;400;0;4;392
236433000;6;120104;                        Cunheira;389;182;207;387;180;207;168;1;122;354;354;0;2;343
236458000;5;1202;                    Arronches;3165;1535;1630;3107;1484;1623;1246;6;931;2540;2539;1;9;2209
236459000;6;120201;                        Assunção;1970;926;1044;1941;896;1045;759;4;576;1414;1413;1;7;1151
236547000;6;120202;                        Esperança;739;369;370;728;361;367;322;1;219;841;841;0;1;778
236598000;6;120203;                        Mosteiros;456;240;216;438;227;211;165;1;136;285;285;0;1;280
236621000;5;1203;                    Avis;4571;2178;2393;4420;2088;2332;1867;5;1376;3679;3646;33;15;3527
236622000;6;120301;                        Alcôrrego;401;205;196;388;194;194;163;0;131;393;392;1;0;354
236651000;6;120302;                        Aldeia Velha;280;134;146;272;128;144;133;0;89;327;327;0;2;324
236674000;6;120303;                        Avis;1840;861;979;1787;831;956;727;2;549;1168;1151;17;7;1086
236764000;6;120304;                        Benavila;861;396;465;832;380;452;338;2;243;645;632;13;4;628
236811000;6;120305;                        Ervedal;560;272;288;532;259;273;243;0;174;437;436;1;0;429
236858000;6;120306;                        Figueira e Barros;309;147;162;297;139;158;130;0;98;291;291;0;1;288
236892000;6;120307;                        Maranhão;63;30;33;56;25;31;24;0;19;139;138;1;0;138
236904000;6;120308;                        Valongo;257;133;124;256;132;124;109;1;73;279;279;0;1;280
236927000;5;1204;                    Campo Maior;8456;4098;4358;8158;3912;4246;3174;3;2605;4767;4719;48;11;4122
236928000;6;120401;                        Nossa Senhora da Expectação;3974;1898;2076;3802;1798;2004;1468;2;1214;2094;2047;47;7;1761
237035000;6;120402;                        Nossa Senhora da Graça dos Degolados;587;296;291;593;288;305;230;1;186;426;426;0;1;415
237060000;6;120403;                        São João Baptista;3895;1904;1991;3763;1826;1937;1476;0;1205;2247;2246;1;3;1946
237184000;5;1205;                    Castelo de Vide;3407;1629;1778;3365;1598;1767;1416;5;1060;2887;2884;3;22;2646
237185000;6;120501;                        Nossa Senhora da Graça de Póvoa e Meadas;606;294;312;583;280;303;246;2;186;654;653;1;4;654
237225000;6;120502;                        Santa Maria da Devesa;1578;742;836;1534;711;823;669;1;506;1340;1339;1;6;1241
237312000;6;120503;                        Santiago Maior;358;180;178;354;180;174;163;1;114;319;318;1;6;301
237339000;6;120504;                        São João Baptista;865;413;452;894;427;467;338;1;254;574;574;0;6;450
237385000;5;1206;                    Crato;3708;1725;1983;3669;1690;1979;1550;6;1133;3261;3252;9;10;3191
237386000;6;120601;                        Aldeia da Mata;374;159;215;367;155;212;155;1;101;450;449;1;1;451
237416000;6;120602;                        Crato e Mártires;1674;773;901;1670;761;909;655;3;504;1241;1233;8;4;1193
237519000;6;120603;                        Flor da Rosa;263;129;134;260;127;133;115;0;80;245;245;0;3;240
237542000;6;120604;                        Gáfete;856;407;449;843;397;446;376;1;279;688;688;0;1;689
237598000;6;120605;                        Monte da Pedra;280;137;143;282;138;144;139;0;96;293;293;0;0;293
237635000;6;120606;                        Vale do Peso;261;120;141;247;112;135;110;1;73;344;344;0;1;325
237655000;5;1207;                    Elvas;23078;11092;11986;22138;10589;11549;8909;22;6936;13375;13348;27;43;9192
237656000;6;120701;                        Ajuda, Salvador e Santo Ildefonso;986;398;588;945;376;569;381;3;268;794;793;1;4;459
237692000;6;120702;                        Alcáçova;2147;1048;1099;2081;998;1083;854;3;618;1258;1255;3;6;941
237754000;6;120703;                        Assunção;8702;4175;4527;8289;3973;4316;3305;5;2628;4355;4352;3;15;1671
237940000;6;120704;                        Barbacena;663;318;345;646;309;337;280;2;199;587;587;0;2;586
237986000;6;120705;                        Caia e São Pedro;4106;2002;2104;3940;1908;2032;1573;1;1239;2188;2174;14;4;1498
238106000;6;120706;                        Santa Eulália;1198;586;612;1143;562;581;498;1;375;840;839;1;1;833
238161000;6;120707;                        São Brás e São Lourenço;1684;827;857;1610;790;820;645;0;533;903;902;1;3;785
238215000;6;120708;                        São Vicente e Ventosa;801;398;403;796;383;413;293;3;238;497;496;1;4;494
238256000;6;120709;                        Terrugem;1251;602;649;1197;575;622;467;1;383;732;729;3;1;717
238296000;6;120710;                        Vila Boim;1224;594;630;1180;577;603;502;1;369;946;946;0;1;934
238345000;6;120711;                        Vila Fernando;316;144;172;311;138;173;111;2;86;275;275;0;2;274
238369000;5;1208;                    Fronteira;3410;1627;1783;3245;1532;1713;1350;5;1042;2593;2593;0;16;2519
238370000;6;120801;                        Cabeço de Vide;1063;492;571;993;455;538;418;4;311;1021;1021;0;11;979
238487000;6;120802;                        Fronteira;2069;993;1076;1984;944;1040;815;1;636;1354;1354;0;5;1326
238608000;6;120803;                        São Saturnino;278;142;136;268;133;135;117;0;95;218;218;0;0;214
238625000;5;1209;                    Gavião;4132;1951;2181;3982;1865;2117;1743;5;1279;3599;3595;4;14;3431
238626000;6;120901;                        Atalaia;138;61;77;128;57;71;65;0;45;168;168;0;0;168
238647000;6;120902;                        Belver;684;302;382;657;288;369;336;1;226;867;867;0;5;861
238812000;6;120903;                        Comenda;890;418;472;848;393;455;369;1;282;750;749;1;1;746
238900000;6;120904;                        Gavião;1609;770;839;1561;743;818;618;3;457;1200;1197;3;8;1044
239009000;6;120905;                        Margem;811;400;411;788;384;404;355;0;269;614;614;0;0;612
239098000;5;1210;                    Marvão;3512;1720;1792;3558;1724;1834;1474;2;1090;2981;2980;1;25;2799
239099000;6;121001;                        Beirã;498;245;253;500;246;254;220;0;154;507;507;0;1;494
239149000;6;121002;                        Santa Maria de Marvão;486;225;261;655;298;357;176;1;126;519;519;0;6;492
239213000;6;121003;                        Santo António das Areias;1102;546;556;1075;531;544;474;0;363;827;826;1;4;748
239322000;6;121004;                        São Salvador da Aramenha;1426;704;722;1328;649;679;604;1;447;1128;1128;0;14;1065
239435000;5;1211;                    Monforte;3329;1553;1776;3234;1514;1720;1219;6;972;2356;2333;23;10;2322
239436000;6;121101;                        Assumar;651;247;404;639;241;398;197;3;155;431;425;6;3;422
239476000;6;121102;                        Monforte;1384;677;707;1334;656;678;497;2;407;816;808;8;5;795
239549000;6;121103;                        Santo Aleixo;638;319;319;623;313;310;271;0;206;533;533;0;0;528
239587000;6;121104;                        Vaiamonte;656;310;346;638;304;334;254;1;204;576;567;9;2;577
239640000;5;1212;                    Nisa;7450;3537;3913;7183;3401;3782;3218;8;2310;7322;7320;2;15;7166
239641000;6;121201;                        Alpalhão;1238;605;633;1205;588;617;531;1;392;1065;1064;1;5;1026
239698000;6;121202;                        Amieira do Tejo;241;113;128;231;107;124;110;1;72;468;468;0;2;467
239749000;6;121203;                        Arez;256;131;125;255;131;124;126;0;79;337;337;0;0;334
239786000;6;121204;                        Espírito Santo;1861;880;981;1792;847;945;820;1;585;1500;1500;0;3;1408
239868000;6;121205;                        Montalvão;442;199;243;441;198;243;231;1;134;878;878;0;1;879
239927000;6;121206;                        Nossa Senhora da Graça;1590;761;829;1535;734;801;592;2;465;1076;1075;1;2;1059
239996000;6;121207;                        Santana;404;185;219;364;160;204;193;1;124;445;445;0;1;444
240043000;6;121208;                        São Matias;289;129;160;288;129;159;146;0;103;534;534;0;0;534
240113000;6;121209;                        São Simão;118;57;61;115;56;59;67;0;39;280;280;0;0;280
240144000;6;121210;                        Tolosa;1011;477;534;957;451;506;402;1;317;739;739;0;1;735
240198000;5;1213;                    Ponte de Sor;16722;8085;8637;15929;7641;8288;6671;11;5153;10316;10281;35;23;9194
240199000;6;121301;                        Galveias;1061;510;551;1048;508;540;417;3;306;989;989;0;4;976
240267000;6;121302;                        Montargil;2316;1125;1191;2215;1064;1151;953;2;726;1807;1807;0;2;1761
240384000;6;121303;                        Ponte de Sor;8958;4285;4673;8470;4018;4452;3476;5;2729;4674;4648;26;13;3719
240654000;6;121304;                        Foros de Arrão;919;438;481;869;413;456;407;1;303;627;621;6;1;616
240693000;6;121305;                        Longomel;1228;603;625;1181;573;608;522;0;386;845;845;0;3;830
240755000;6;121306;                        Vale de Açor;698;346;352;661;328;333;299;0;216;548;548;0;0;501
240792000;6;121307;                        Tramaga;1542;778;764;1485;737;748;597;0;487;826;823;3;0;791
240837000;5;1214;                    Portalegre;24930;11971;12959;24527;11820;12707;10160;21;7779;14743;14738;5;46;9204
240838000;6;121401;                        Alagoa;669;317;352;644;297;347;276;1;205;377;377;0;2;349
240862000;6;121402;                        Alegrete;1746;862;884;1690;826;864;723;1;567;1063;1063;0;4;997
240922000;6;121403;                        Carreiras;583;298;285;570;290;280;241;0;183;415;415;0;2;380
240953000;6;121404;                        Fortios;2018;965;1053;1951;927;1024;755;1;610;1089;1089;0;3;1021
241011000;6;121405;                        Reguengo;630;311;319;620;308;312;260;0;206;477;477;0;1;455
241033000;6;121406;                        Ribeira de Nisa;1366;681;685;1284;632;652;539;1;427;752;751;1;3;710
241071000;6;121407;                        São Julião;342;173;169;331;168;163;170;1;103;465;464;1;3;420
241099000;6;121408;                        São Lourenço;4987;2334;2653;5254;2631;2623;2092;12;1492;3238;3236;2;19;1500
241195000;6;121409;                        Sé;10655;5074;5581;10318;4833;5485;4339;3;3366;5700;5700;0;7;2245
241399000;6;121410;                        Urra;1934;956;978;1865;908;957;765;1;620;1167;1166;1;2;1127
241474000;4;183;                Alentejo Central;166822;80222;86600;162336;77620;84716;66947;137;51488;98068;97907;161;369;80100
241475000;5;701;                    Alandroal;5843;2833;3010;5616;2699;2917;2381;3;1819;4497;4496;1;18;4377
241476000;6;70101;                        Alandroal (Nossa Senhora da Conceição);1873;897;976;1829;867;962;741;2;558;1259;1259;0;7;1222
241563000;6;70102;                        Juromenha (Nossa Senhora do Loreto);107;60;47;101;58;43;46;0;32;132;131;1;2;133
241578000;6;70103;                        Santiago Maior;2205;1071;1134;2083;997;1086;879;1;700;1455;1455;0;6;1411
241679000;6;70104;                        Capelins (Santo António);527;246;281;511;239;272;244;0;169;614;614;0;1;613
241725000;6;70105;                        Terena (São Pedro);767;379;388;746;367;379;326;0;246;738;738;0;1;735
241788000;6;70106;                        São Brás dos Matos (Mina do Bugalho);364;180;184;346;171;175;145;0;114;299;299;0;1;263
241807000;5;702;                    Arraiolos;7363;3576;3787;7121;3439;3682;3000;4;2268;4738;4732;6;17;4409
241808000;6;70201;                        Arraiolos;3386;1632;1754;3268;1557;1711;1329;1;1034;1910;1906;4;7;1741
241988000;6;70202;                        Igrejinha;932;458;474;911;450;461;372;1;287;577;575;2;2;572
242027000;6;70203;                        Santa Justa;225;118;107;218;114;104;94;0;70;177;177;0;1;178
242050000;6;70204;                        São Gregório;341;167;174;334;164;170;170;0;105;312;312;0;0;299
242081000;6;70205;                        Gafanhoeira (São Pedro);494;234;260;472;222;250;216;0;162;327;327;0;0;299
242114000;6;70206;                        Vimieiro;1589;769;820;1544;746;798;656;2;479;1155;1155;0;7;1047
242178000;6;70207;                        Sabugueiro;396;198;198;374;186;188;163;0;131;280;280;0;0;273
242210000;5;703;                    Borba;7333;3615;3718;7004;3432;3572;2929;5;2330;4165;4162;3;14;3284
242211000;6;70301;                        Borba (Matriz);3779;1878;1901;3605;1782;1823;1451;4;1190;1942;1939;3;8;1446
242324000;6;70302;                        Orada;740;361;379;716;346;370;308;0;236;508;508;0;0;378
242367000;6;70303;                        Rio de Moinhos;2056;1019;1037;1971;972;999;798;0;664;1163;1163;0;2;1091
242459000;6;70304;                        Borba (São Bartolomeu);758;357;401;712;332;380;372;1;240;552;552;0;4;369
242481000;5;704;                    Estremoz;14318;6813;7505;13753;6497;7256;5901;12;4466;9494;9453;41;34;7388
242482000;6;70401;                        Arcos;1152;557;595;1146;542;604;503;1;370;724;721;3;4;698
242535000;6;70402;                        Glória;532;261;271;509;249;260;205;0;171;451;451;0;1;400
242564000;6;70403;                        Estremoz (Santa Maria);6284;3042;3242;6014;2889;3125;2489;4;1961;3331;3295;36;9;2053
242740000;6;70404;                        Évora Monte (Santa Maria);569;261;308;560;257;303;241;1;162;608;608;0;4;488
242776000;6;70405;                        Santa Vitória do Ameixial;362;180;182;333;166;167;157;0;114;314;314;0;0;314
242791000;6;70406;                        Estremoz (Santo André);2378;1066;1312;2267;1008;1259;1064;2;714;1861;1860;1;11;1362
242861000;6;70407;                        Santo Estêvão;74;34;40;73;34;39;34;0;26;138;138;0;0;138
242872000;6;70408;                        São Bento do Ameixial;335;168;167;328;165;163;147;0;106;312;312;0;0;243
242895000;6;70409;                        São Bento de Ana Loura;32;17;15;25;14;11;13;0;11;62;62;0;0;53
242901000;6;70410;                        São Bento do Cortiço;699;322;377;681;314;367;269;1;224;368;368;0;2;369
242931000;6;70411;                        São Domingos de Ana Loura;341;164;177;330;159;171;138;0;111;258;258;0;0;253
242953000;6;70412;                        São Lourenço de Mamporcão;524;252;272;490;234;256;217;1;177;357;357;0;1;355
242982000;6;70413;                        Veiros;1036;489;547;997;466;531;424;2;319;710;709;1;2;662
243035000;5;705;                    Évora;56596;26831;29765;55811;26190;29621;22774;51;17250;29204;29171;33;107;20676
243036000;6;70501;                        Nossa Senhora da Boa Fé;322;156;166;324;153;171;126;1;89;200;200;0;1;178
243068000;6;70502;                        Nossa Senhora da Graça do Divor;486;228;258;480;222;258;185;1;145;296;296;0;1;292
243102000;6;70503;                        Nossa Senhora de Machede;1123;556;567;1115;549;566;434;1;354;653;652;1;2;651
243194000;6;70504;                        Nossa Senhora da Tourega;686;342;344;680;336;344;283;1;209;409;409;0;2;339
243253000;6;70505;                        Évora (Santo Antão);1323;585;738;1558;694;864;717;2;366;1313;1312;1;8;1098
243323000;6;70506;                        São Bento do Mato;1151;564;587;1106;538;568;496;0;361;785;785;0;1;707
243397000;6;70507;                        Évora (São Mamede);1724;695;1029;1765;714;1051;919;4;474;1502;1501;1;6;984
243473000;6;70508;                        São Manços;938;462;476;904;445;459;357;1;308;527;527;0;1;515
243531000;6;70509;                        São Miguel de Machede;794;394;400;826;401;425;317;2;237;509;508;1;2;454
243587000;6;70511;                        São Vicente do Pigeiro;364;181;183;351;175;176;142;0;113;294;294;0;0;280
243627000;6;70513;                        Torre de Coelheiros;715;353;362;657;323;334;269;1;224;469;469;0;1;405
243678000;6;70514;                        São Sebastião da Giesteira;760;381;379;720;359;361;295;1;236;356;356;0;1;327
243718000;6;70515;                        Canaviais;3442;1692;1750;3352;1650;1702;1241;4;1062;1497;1497;0;7;1160
243796000;6;70516;                        Nossa Senhora de Guadalupe;465;219;246;458;213;245;181;0;148;230;230;0;0;205
243832000;6;70517;                        Bacelo;9309;4536;4773;8896;4272;4624;3475;4;2902;4043;4040;3;6;2702
244056000;6;70518;                        Horta das Figueiras;10006;4799;5207;9854;4679;5175;3837;8;2971;4453;4448;5;17;2669
244340000;6;70519;                        Malagueira;12373;5833;6540;11845;5537;6308;4781;8;3834;5444;5431;13;14;3535
244620000;6;70520;                        Sé e São Pedro;1691;710;981;2095;858;1237;852;5;447;1511;1511;0;24;1056
244731000;6;70521;                        Senhora da Saúde;8924;4145;4779;8825;4072;4753;3867;7;2770;4713;4705;8;13;3119
244939000;5;706;                    Montemor-o-Novo;17437;8461;8976;16895;8175;8720;7055;17;5443;10323;10304;19;43;7980
244940000;6;70601;                        Cabrela;649;316;333;665;313;352;274;1;205;427;427;0;2;385
244985000;6;70602;                        Lavre;740;360;380;708;343;365;301;1;231;521;521;0;5;478
245025000;6;70603;                        Nossa Senhora do Bispo;4931;2340;2591;4743;2240;2503;1994;5;1556;2740;2739;1;9;2004
245174000;6;70604;                        Nossa Senhora da Vila;6070;2978;3092;5874;2872;3002;2335;5;1848;3010;2995;15;13;1932
245341000;6;70605;                        Santiago do Escoural;1335;641;694;1261;606;655;594;1;410;940;940;0;2;747
245412000;6;70606;                        São Cristóvão;540;258;282;570;295;275;247;1;163;493;493;0;7;476
245472000;6;70607;                        Ciborro;714;354;360;702;347;355;299;1;224;481;481;0;1;427
245512000;6;70608;                        Cortiçadas;821;402;419;791;380;411;361;0;276;614;613;1;1;564
245561000;6;70609;                        Silveiras;567;287;280;539;272;267;244;0;186;421;420;1;0;315
245593000;6;70610;                        Foros de Vale de Figueira;1070;525;545;1042;507;535;406;2;344;676;675;1;3;652
245637000;5;708;                    Mourão;2663;1315;1348;2617;1288;1329;1003;2;792;1946;1929;17;11;1875
245638000;6;70801;                        Granja;605;304;301;607;304;303;267;0;194;580;577;3;1;568
245701000;6;70802;                        Luz;290;153;137;289;152;137;109;1;85;230;230;0;3;232
245735000;6;70803;                        Mourão;1768;858;910;1721;832;889;627;1;513;1136;1122;14;7;1075
245828000;5;709;                    Portel;6428;3152;3276;6662;3392;3270;2589;4;1949;4262;4257;5;16;4173
245829000;6;70901;                        Alqueva;329;161;168;694;499;195;159;0;96;388;387;1;1;384
245867000;6;70902;                        Amieira;362;186;176;359;186;173;160;0;123;315;315;0;0;308
245904000;6;70903;                        Monte do Trigo;1240;626;614;1211;602;609;454;0;384;627;627;0;0;609
245961000;6;70904;                        Oriola;400;183;217;384;175;209;186;0;123;295;295;0;0;294
246009000;6;70905;                        Portel;2661;1298;1363;2623;1255;1368;1031;4;774;1535;1531;4;15;1491
246162000;6;70906;                        Santana;542;259;283;510;246;264;231;0;176;380;380;0;0;369
246212000;6;70907;                        São Bartolomeu do Outeiro;436;209;227;431;207;224;190;0;140;378;378;0;0;377
246248000;6;70908;                        Vera Cruz;458;230;228;450;222;228;178;0;133;344;344;0;0;341
246292000;5;710;                    Redondo;7031;3434;3597;6810;3317;3493;2809;3;2177;4549;4546;3;12;3882
246293000;6;71001;                        Montoito;1298;636;662;1275;624;651;540;1;402;1008;1007;1;1;980
246385000;6;71002;                        Redondo;5733;2798;2935;5535;2693;2842;2269;2;1775;3541;3539;2;11;2902
246622000;5;711;                    Reguengos de Monsaraz;10828;5274;5554;10338;5011;5327;4172;9;3337;6393;6383;10;36;5989
246623000;6;71101;                        Campo;688;328;360;671;319;352;284;1;216;502;501;1;1;500
246684000;6;71102;                        Corval;1389;668;721;1352;654;698;575;2;441;1023;1023;0;3;1001
246752000;6;71103;                        Monsaraz;782;384;398;759;374;385;347;0;237;783;783;0;15;797
246839000;6;71104;                        Reguengos de Monsaraz;7261;3543;3718;6868;3326;3542;2686;6;2211;3614;3606;8;17;3225
247096000;6;71105;                        Campinho;708;351;357;688;338;350;280;0;232;471;470;1;0;466
247138000;5;712;                    Vendas Novas;11846;5705;6141;11337;5418;5919;4715;11;3801;6416;6402;14;18;5238
247139000;6;71201;                        Vendas Novas;11123;5351;5772;10637;5078;5559;4425;11;3558;6063;6050;13;18;4893
247393000;6;71202;                        Landeira;723;354;369;700;340;360;290;0;243;353;352;1;0;345
247430000;5;713;                    Viana do Alentejo;5743;2780;2963;5530;2643;2887;2214;6;1735;3570;3568;2;15;3446
247431000;6;71301;                        Alcáçovas;2111;1040;1071;2058;1003;1055;833;2;622;1520;1519;1;6;1463
247596000;6;71302;                        Viana do Alentejo;2742;1299;1443;2626;1226;1400;1061;3;839;1626;1625;1;8;1560
247731000;6;71303;                        Aguiar;890;441;449;846;414;432;320;1;274;424;424;0;1;423
247790000;5;714;                    Vila Viçosa;8319;4057;4262;8025;3871;4154;3333;6;2594;4764;4760;4;18;3874
247791000;6;71401;                        Bencatel;1679;858;821;1694;859;835;669;0;543;979;979;0;0;950
247841000;6;71402;                        Ciladas;1071;525;546;1041;502;539;444;1;343;685;685;0;1;647
247881000;6;71403;                        Vila Viçosa (Conceição);4165;2008;2157;3925;1870;2055;1624;3;1280;2127;2123;4;11;1526
248027000;6;71404;                        Pardais;546;281;265;539;276;263;213;0;181;381;381;0;0;355
248059000;6;71405;                        Vila Viçosa (São Bartolomeu);858;385;473;826;364;462;383;2;247;592;592;0;6;396
248085000;5;1215;                    Sousel;5074;2376;2698;4817;2248;2569;2072;4;1527;3747;3744;3;10;3509
248086000;6;121501;                        Cano;1266;602;664;1213;576;637;546;1;384;931;931;0;2;890
248155000;6;121502;                        Casa Branca;1232;574;658;1185;552;633;506;1;369;1090;1089;1;2;983
248217000;6;121503;                        Santo Amaro;644;301;343;618;292;326;255;1;195;406;406;0;1;394
248250000;6;121504;                        Sousel;1932;899;1033;1801;828;973;765;1;579;1320;1318;2;5;1242
248373000;4;184;                Baixo Alentejo;126692;61949;64743;122524;59659;62865;50566;81;38270;84892;84677;215;249;74901
248374000;5;201;                    Aljustrel;9257;4579;4678;8892;4375;4517;3754;5;2874;5807;5801;6;11;5526
248375000;6;20101;                        Aljustrel;5137;2540;2597;4944;2435;2509;2044;2;1613;2975;2974;1;7;2722
248586000;6;20102;                        Ervidel;1005;494;511;971;474;497;416;1;307;774;774;0;1;773
248665000;6;20103;                        Messejana;892;431;461;876;422;454;371;1;261;676;671;5;2;657
248748000;6;20104;                        São João de Negrilhos;1482;736;746;1414;698;716;611;1;466;935;935;0;1;932
248879000;6;20105;                        Rio de Moinhos;741;378;363;687;346;341;312;0;227;447;447;0;0;442
248920000;5;202;                    Almodôvar;7449;3677;3772;7262;3598;3664;3074;7;2271;5428;5424;4;19;5033
248921000;6;20201;                        Almodôvar;3788;1857;1931;3647;1805;1842;1512;2;1147;2387;2387;0;9;2020
249161000;6;20202;                        Gomes Aires;355;196;159;359;202;157;159;0;113;352;352;0;1;353
249214000;6;20203;                        Rosário;608;298;310;607;296;311;237;1;185;415;415;0;1;409
249268000;6;20204;                        Santa Clara-a-Nova;600;305;295;588;296;292;261;0;178;444;444;0;1;441
249325000;6;20205;                        Santa Cruz;651;327;324;640;319;321;294;1;199;718;714;4;4;711
249454000;6;20206;                        São Barnabé;531;257;274;515;250;265;235;1;157;452;452;0;1;453
249498000;6;20207;                        Senhora da Graça de Padrões;380;180;200;381;180;201;147;1;113;238;238;0;1;237
249535000;6;20208;                        Aldeia dos Fernandes;536;257;279;525;250;275;229;1;179;422;422;0;1;409
249575000;5;203;                    Alvito;2504;1199;1305;2402;1138;1264;1025;2;723;1724;1717;7;12;1630
249576000;6;20301;                        Alvito;1259;610;649;1234;593;641;541;1;350;904;897;7;9;844
249662000;6;20302;                        Vila Nova da Baronia;1245;589;656;1168;545;623;484;1;373;820;820;0;3;786
249731000;5;204;                    Barrancos;1834;890;944;1792;868;924;721;1;537;1287;1287;0;10;1227
249732000;6;20401;                        Barrancos;1834;890;944;1792;868;924;721;1;537;1287;1287;0;10;1227
249831000;5;205;                    Beja;35854;17387;18467;34769;16777;17992;14142;27;10741;20101;20060;41;54;13530
249832000;6;20501;                        Albernoa;758;366;392;725;346;379;294;1;220;509;508;1;3;508
249901000;6;20502;                        Baleizão;902;432;470;896;430;466;389;0;270;710;710;0;0;710
249955000;6;20503;                        Beringel;1301;622;679;1276;612;664;544;0;419;868;868;0;1;856
250033000;6;20504;                        Cabeça Gorda;1386;691;695;1330;659;671;559;0;427;810;809;1;0;808
250098000;6;20505;                        Mombeja;386;195;191;381;194;187;160;0;112;285;283;2;0;276
250129000;6;20506;                        Nossa Senhora das Neves;1747;899;848;1681;870;811;686;1;557;989;989;0;1;974
250203000;6;20507;                        Quintos;255;126;129;252;124;128;115;0;84;244;244;0;0;243
250222000;6;20508;                        Salvada;1097;540;557;1058;510;548;437;1;331;694;688;6;1;688
250263000;6;20509;                        Beja (Salvador);6590;3159;3431;6284;2990;3294;2555;4;1952;3293;3293;0;6;1885
250377000;6;20510;                        Santa Clara de Louredo;864;399;465;867;387;480;286;2;232;345;340;5;2;327
250409000;6;20511;                        Beja (Santa Maria da Feira);4543;2195;2348;4438;2124;2314;1579;7;1269;2153;2135;18;12;1549
250508000;6;20512;                        Santa Vitória;595;302;293;588;299;289;259;0;191;487;487;0;1;485
250566000;6;20513;                        Beja (Santiago Maior);7620;3737;3883;7546;3722;3824;3024;7;2306;4129;4123;6;11;1883
250717000;6;20514;                        São Brissos;108;51;57;136;74;62;47;0;31;65;65;0;1;66
250733000;6;20515;                        Beja (São João Baptista);6395;3037;3358;6059;2833;3226;2669;4;1937;3524;3522;2;15;1291
250835000;6;20516;                        São Matias;569;270;299;547;262;285;230;0;177;384;384;0;0;380
250865000;6;20517;                        Trindade;274;134;140;259;125;134;112;0;84;242;242;0;0;233
250884000;6;20518;                        Trigaches;464;232;232;446;216;230;197;0;142;370;370;0;0;368
250913000;5;206;                    Castro Verde;7276;3567;3709;6932;3352;3580;2917;3;2208;4822;4820;2;9;4670
250914000;6;20601;                        Casével;448;222;226;430;213;217;210;0;139;398;398;0;1;399
250966000;6;20602;                        Castro Verde;4898;2402;2496;4653;2247;2406;1872;3;1476;2809;2809;0;8;2664
251217000;6;20603;                        Entradas;649;310;339;612;290;322;280;0;200;479;478;1;0;478
251258000;6;20604;                        Santa Bárbara de Padrões;943;469;474;909;443;466;409;0;290;773;772;1;0;768
251365000;6;20605;                        São Marcos da Ataboeira;338;164;174;328;159;169;146;0;103;363;363;0;0;361
251418000;5;207;                    Cuba;4878;2384;2494;4792;2342;2450;1853;5;1455;3032;3012;20;14;2956
251419000;6;20701;                        Cuba;3306;1616;1690;3250;1587;1663;1253;3;978;1863;1854;9;10;1808
251596000;6;20702;                        Faro do Alentejo;591;308;283;576;299;277;212;0;189;285;282;3;0;273
251631000;6;20703;                        Vila Alva;514;231;283;508;230;278;182;2;143;422;418;4;3;419
251681000;6;20704;                        Vila Ruiva;467;229;238;458;226;232;206;0;145;462;458;4;1;456
251749000;5;208;                    Ferreira do Alentejo;8255;4021;4234;7987;3863;4124;3334;5;2523;5185;5157;28;13;4873
251750000;6;20801;                        Alfundão;863;449;414;844;439;405;374;0;265;570;569;1;0;552
251812000;6;20802;                        Ferreira do Alentejo;4696;2222;2474;4555;2133;2422;1822;5;1396;2788;2765;23;10;2519
252068000;6;20803;                        Figueira dos Cavaleiros;1346;675;671;1289;638;651;558;0;434;786;785;1;0;765
252165000;6;20804;                        Odivelas;542;270;272;519;263;256;235;0;173;427;426;1;1;426
252226000;6;20805;                        Peroguarda;364;184;180;349;175;174;142;0;110;288;287;1;2;286
252256000;6;20806;                        Canhestros;444;221;223;431;215;216;203;0;145;326;325;1;0;325
252299000;5;209;                    Mértola;7274;3593;3681;7051;3463;3588;3137;4;2205;8469;8467;2;26;8354
252300000;6;20901;                        Alcaria Ruiva;849;417;432;820;400;420;363;0;257;881;881;0;1;881
252422000;6;20902;                        Corte do Pinto;857;430;427;843;427;416;387;0;267;1571;1571;0;5;1573
252574000;6;20903;                        Espírito Santo;335;169;166;354;181;173;161;0;107;1122;1122;0;0;1120
252639000;6;20904;                        Mértola;2824;1392;1432;2728;1332;1396;1163;2;841;2189;2188;1;13;2074
252952000;6;20905;                        Santana de Cambas;797;391;406;729;351;378;325;2;223;1062;1062;0;5;1065
253129000;6;20906;                        São João dos Caldeireiros;567;275;292;559;267;292;242;0;176;489;489;0;2;489
253273000;6;20907;                        São Miguel do Pinheiro;596;298;298;579;287;292;291;0;183;696;696;0;0;693
253379000;6;20908;                        São Pedro de Solis;229;109;120;225;109;116;103;0;80;198;198;0;0;198
253436000;6;20909;                        São Sebastião dos Carros;220;112;108;214;109;105;102;0;71;261;260;1;0;261
253509000;5;210;                    Moura;15167;7447;7720;14687;7183;7504;5833;9;4516;10626;10585;41;22;9705
253510000;6;21001;                        Amareleja;2564;1261;1303;2452;1192;1260;945;2;751;1742;1729;13;3;1704
253623000;6;21002;                        Póvoa de São Miguel;888;456;432;858;440;418;346;0;280;874;873;1;0;861
253710000;6;21003;                        Safara;1078;524;554;1074;514;560;415;1;318;764;763;1;2;762
253773000;6;21004;                        Moura (Santo Agostinho);4344;2145;2199;4176;2075;2101;1633;0;1312;2481;2470;11;3;1988
253899000;6;21005;                        Santo Aleixo da Restauração;793;389;404;780;381;399;334;0;240;856;856;0;1;826
253989000;6;21006;                        Santo Amador;412;190;222;418;192;226;180;0;140;386;386;0;0;363
254030000;6;21007;                        Moura (São João Baptista);4075;1967;2108;3924;1881;2043;1583;5;1178;2558;2557;1;11;2251
254138000;6;21008;                        Sobral da Adiça;1013;515;498;1005;508;497;397;1;297;965;951;14;2;950
254238000;5;212;                    Ourique;5389;2656;2733;5223;2573;2650;2308;4;1660;4175;4170;5;12;3967
254239000;6;21201;                        Conceição;86;44;42;85;44;41;48;0;26;186;186;0;1;186
254267000;6;21202;                        Garvão;731;352;379;691;331;360;331;0;234;574;574;0;0;568
254307000;6;21203;                        Ourique;2874;1431;1443;2789;1388;1401;1183;1;885;1956;1954;2;8;1798
254475000;6;21204;                        Panóias;496;248;248;487;245;242;208;1;148;396;396;0;1;390
254520000;6;21205;                        Santa Luzia;352;165;187;347;162;185;147;1;105;299;299;0;1;288
254550000;6;21206;                        Santana da Serra;850;416;434;824;403;421;391;1;262;764;761;3;1;737
254584000;5;213;                    Serpa;15623;7632;7991;14969;7294;7675;6122;7;4754;10356;10319;37;31;9751
254585000;6;21301;                        Aldeia Nova de São Bento;3072;1499;1573;2911;1415;1496;1168;1;920;2080;2076;4;2;2025
254722000;6;21302;                        Brinches;1039;500;539;1012;488;524;439;1;316;870;869;1;1;840
254804000;6;21303;                        Pias;2852;1399;1453;2773;1349;1424;1120;2;846;2029;2012;17;4;1934
254924000;6;21304;                        Serpa (Salvador);4365;2117;2248;4166;2018;2148;1655;3;1318;2549;2539;10;15;2200
255084000;6;21305;                        Serpa (Santa Maria);1868;902;966;1790;871;919;757;0;564;1245;1241;4;5;1215
255164000;6;21306;                        Vale de Vargo;968;477;491;931;460;471;403;0;308;636;635;1;0;633
255233000;6;21307;                        Vila Verde de Ficalho;1459;738;721;1386;693;693;580;0;482;947;947;0;4;904
255302000;5;214;                    Vidigueira;5932;2917;3015;5766;2833;2933;2346;2;1803;3880;3858;22;16;3679
255303000;6;21401;                        Pedrógão;1151;586;565;1128;576;552;507;0;363;939;938;1;4;936
255424000;6;21402;                        Selmes;894;444;450;878;435;443;365;0;274;681;681;0;1;674
255516000;6;21403;                        Vidigueira;2959;1439;1520;2850;1380;1470;1110;2;882;1699;1682;17;9;1511
255651000;6;21404;                        Vila de Frades;928;448;480;910;442;468;364;0;284;561;557;4;2;558
255711000;4;185;                Lezíria do Tejo;247453;119148;128305;238478;113465;125013;97405;159;77035;137441;137204;237;275;107108
255712000;5;1103;                    Azambuja;21814;11031;10783;21097;10587;10510;8197;19;6550;11918;11913;5;19;9489
255713000;6;110301;                        Alcoentre;3448;2172;1276;3347;2105;1242;1003;12;786;1740;1739;1;5;1579
255820000;6;110302;                        Aveiras de Baixo;1317;632;685;1287;615;672;524;1;410;750;749;1;1;646
255867000;6;110303;                        Aveiras de Cima;4762;2282;2480;4612;2190;2422;1794;2;1482;2453;2451;2;5;2189
255964000;6;110304;                        Azambuja;8190;3954;4236;7879;3756;4123;3117;4;2542;4192;4192;0;8;2427
256113000;6;110305;                        Manique do Intendente;1216;592;624;1157;563;594;532;0;402;888;888;0;0;869
256179000;6;110306;                        Vale do Paraíso;880;420;460;852;406;446;367;0;286;512;512;0;0;487
256206000;6;110307;                        Vila Nova da Rainha;926;456;470;911;444;467;372;0;298;474;473;1;0;397
256229000;6;110308;                        Vila Nova de São Pedro;687;345;342;676;336;340;304;0;220;586;586;0;0;574
256273000;6;110309;                        Maçussa;388;178;210;376;172;204;184;0;124;323;323;0;0;321
256309000;5;1403;                    Almeirim;23376;11100;12276;22253;10453;11800;9345;11;7437;12216;12196;20;16;9358
256310000;6;140301;                        Almeirim;12812;6022;6790;12091;5625;6466;5191;6;3998;6894;6888;6;10;4355
256520000;6;140302;                        Benfica do Ribatejo;3067;1490;1577;2954;1421;1533;1189;1;989;1637;1635;2;2;1544
256613000;6;140303;                        Fazendas de Almeirim;6949;3328;3621;6675;3154;3521;2738;4;2270;3326;3314;12;4;3102
256745000;6;140304;                        Raposa;548;260;288;533;253;280;227;0;180;359;359;0;0;357
256775000;5;1404;                    Alpiarça;7702;3699;4003;7389;3497;3892;3003;3;2438;4049;4048;1;7;3473
256776000;6;140401;                        Alpiarça;7702;3699;4003;7389;3497;3892;3003;3;2438;4049;4048;1;7;3473
256949000;5;1405;                    Benavente;29019;14166;14853;27830;13375;14455;10963;9;8993;14728;14707;21;20;9547
256950000;6;140501;                        Benavente;9174;4443;4731;8820;4218;4602;3553;4;2854;4814;4804;10;9;3092
257152000;6;140502;                        Samora Correia;17123;8360;8763;16369;7854;8515;6366;5;5320;8240;8231;9;10;4833
257433000;6;140503;                        Santo Estêvão;1997;992;1005;1934;944;990;767;0;595;1298;1297;1;1;1268
257516000;6;140504;                        Barrosa;725;371;354;707;359;348;277;0;224;376;375;1;0;354
257535000;5;1406;                    Cartaxo;24462;11844;12618;23447;11217;12230;9574;16;7647;13331;13313;18;21;10007
257536000;6;140601;                        Cartaxo;11370;5422;5948;10821;5087;5734;4560;7;3520;6070;6066;4;9;3230
257769000;6;140602;                        Ereira;636;310;326;630;305;325;254;1;200;436;436;0;1;437
257796000;6;140603;                        Lapa;1200;576;624;1158;550;608;465;1;370;616;615;1;2;567
257833000;6;140604;                        Pontével;4614;2249;2365;4452;2158;2294;1724;5;1470;2492;2489;3;6;2331
257963000;6;140605;                        Valada;821;417;404;829;420;409;340;0;260;647;647;0;0;634
258002000;6;140606;                        Vale da Pinta;1295;660;635;1227;610;617;508;0;418;765;764;1;1;734
258049000;6;140607;                        Vila Chã de Ourique;2771;1353;1418;2643;1266;1377;1060;0;870;1394;1390;4;0;1293
258128000;6;140608;                        Vale da Pedra;1755;857;898;1687;821;866;663;2;539;911;906;5;2;781
258171000;5;1407;                    Chamusca;10120;4878;5242;9762;4664;5098;4167;5;3222;6222;6217;5;13;5804
258172000;6;140701;                        Chamusca;3360;1603;1757;3248;1538;1710;1372;3;1050;1926;1925;1;8;1603
258267000;6;140702;                        Chouto;577;288;289;556;275;281;261;0;190;544;543;1;0;542
258304000;6;140703;                        Pinheiro Grande;939;460;479;895;432;463;379;0;290;538;537;1;2;527
258338000;6;140704;                        Ulme;1277;621;656;1250;599;651;518;0;418;757;757;0;0;729
258373000;6;140705;                        Vale de Cavalos;1032;485;547;984;459;525;435;0;345;724;722;2;0;704
258408000;6;140706;                        Parreira;915;448;467;902;441;461;377;1;296;502;502;0;1;500
258438000;6;140707;                        Carregueira;2020;973;1047;1927;920;1007;825;1;633;1231;1231;0;2;1199
258504000;5;1409;                    Coruche;19944;9523;10421;19048;8972;10076;8329;9;6493;12631;12575;56;18;11790
258505000;6;140901;                        Coruche;8913;4165;4748;8468;3893;4575;3685;4;2817;5305;5269;36;7;4555
258720000;6;140902;                        Couço;2765;1323;1442;2661;1268;1393;1200;4;910;2163;2160;3;8;2128
258831000;6;140903;                        São José da Lamarosa;1727;833;894;1663;793;870;738;0;588;996;996;0;1;992
258910000;6;140904;                        Fajarda;1839;888;951;1727;819;908;736;1;590;1117;1109;8;2;1097
258950000;6;140905;                        Branca;1474;729;745;1402;687;715;611;0;501;941;937;4;0;941
259013000;6;140906;                        Erra;1004;491;513;956;457;499;425;0;325;611;611;0;0;600
259061000;6;140907;                        Biscainho;1074;519;555;1030;490;540;433;0;360;773;772;1;0;764
259091000;6;140908;                        Santana do Mato;1148;575;573;1141;565;576;501;0;402;725;721;4;0;713
259136000;5;1412;                    Golegã;5465;2560;2905;5261;2444;2817;2135;6;1689;3115;3114;1;13;2773
259137000;6;141201;                        Azinhaga;1620;790;830;1593;776;817;620;1;509;837;837;0;2;812
259204000;6;141202;                        Golegã;3845;1770;2075;3668;1668;2000;1515;5;1180;2278;2277;1;11;1961
259321000;5;1414;                    Rio Maior;21192;10255;10937;20511;9875;10636;8304;14;6500;12435;12428;7;45;9829
259322000;6;141401;                        Alcobertas;1923;974;949;1858;940;918;703;1;555;1016;1015;1;5;1014
259447000;6;141402;                        Arrouquelas;591;285;306;566;272;294;245;1;176;396;396;0;1;389
259506000;6;141403;                        Arruda dos Pisões;405;186;219;392;180;212;163;0;129;274;274;0;0;270
259541000;6;141404;                        Azambujeira;458;230;228;457;232;225;194;0;141;290;289;1;0;289
259576000;6;141405;                        Fráguas;905;429;476;865;407;458;351;2;279;489;489;0;2;488
259630000;6;141406;                        Marmeleira;437;210;227;433;205;228;168;1;128;368;367;1;1;359
259659000;6;141407;                        Outeiro da Cortiçada;674;327;347;631;304;327;268;0;216;449;449;0;1;441
259711000;6;141408;                        Rio Maior;12005;5779;6226;11671;5595;6076;4683;7;3678;6839;6837;2;31;4289
260060000;6;141409;                        São João da Ribeira;892;439;453;849;409;440;344;1;288;530;529;1;1;526
260111000;6;141410;                        Asseiceira;1017;497;520;987;472;515;405;0;320;629;629;0;1;614
260159000;6;141411;                        São Sebastião;523;244;279;500;232;268;223;0;160;300;299;1;0;296
260194000;6;141412;                        Ribeira de São João;496;241;255;472;229;243;196;0;158;311;311;0;1;311
260221000;6;141413;                        Malaqueijo;438;209;229;427;203;224;194;1;135;297;297;0;1;297
260253000;6;141414;                        Assentiz;428;205;223;403;195;208;167;0;137;247;247;0;0;246
260271000;5;1415;                    Salvaterra de Magos;22159;10645;11514;21160;10020;11140;8447;28;6943;11698;11667;31;38;10713
260272000;6;141501;                        Glória do Ribatejo;3224;1586;1638;3134;1524;1610;1266;0;1089;1546;1546;0;0;1531
260347000;6;141502;                        Marinhais;6336;3072;3264;6071;2890;3181;2441;6;2015;3487;3467;20;7;3253
260475000;6;141503;                        Muge;1270;598;672;1250;587;663;518;1;402;778;777;1;3;753
260533000;6;141504;                        Salvaterra de Magos;5526;2604;2922;5143;2412;2731;2115;9;1638;2977;2971;6;16;2337
260693000;6;141505;                        Foros de Salvaterra;4920;2350;2570;4714;2197;2517;1767;12;1507;2435;2431;4;12;2365
260803000;6;141506;                        Granho;883;435;448;848;410;438;340;0;292;475;475;0;0;474
260831000;5;1416;                    Santarém;62200;29447;32753;60720;28361;32359;24941;39;19123;35098;35026;72;65;24325
260832000;6;141601;                        Abitureiras;972;455;517;932;435;497;385;2;301;585;585;0;2;581
260880000;6;141602;                        Abrã;1122;550;572;1074;516;558;447;0;355;686;686;0;0;664
260941000;6;141603;                        Achete;1918;938;980;1875;905;970;759;2;604;1210;1209;1;2;1202
261043000;6;141604;                        Alcanede;4547;2247;2300;4430;2170;2260;1775;0;1449;2456;2456;0;0;2388
261270000;6;141605;                        Alcanhões;1469;704;765;1421;679;742;558;2;452;794;794;0;2;781
261300000;6;141606;                        Almoster;1818;852;966;1738;783;955;706;2;541;1265;1261;4;2;1257
261374000;6;141607;                        Amiais de Baixo;1851;908;943;1789;867;922;740;1;569;1042;1041;1;1;959
261464000;6;141608;                        Arneiro das Milhariças;835;399;436;798;374;424;363;0;262;575;574;1;1;569
261524000;6;141609;                        Azoia de Baixo;297;124;173;295;120;175;97;1;70;146;146;0;1;139
261542000;6;141610;                        Azoia de Cima;496;239;257;486;228;258;206;0;159;331;330;1;2;322
261576000;6;141611;                        Casével;864;424;440;831;404;427;370;0;267;615;612;3;1;600
261638000;6;141612;                        Santarém (Marvila);9044;4016;5028;9046;3951;5095;3862;13;2647;5327;5306;21;17;1632
261763000;6;141613;                        Moçarria;1136;549;587;1105;527;578;441;0;355;661;660;1;0;653
261791000;6;141614;                        Pernes;1446;688;758;1392;661;731;565;2;422;769;767;2;3;632
261854000;6;141615;                        Pombalinho;448;213;235;439;209;230;204;0;135;304;304;0;0;303
261867000;6;141616;                        Póvoa da Isenta;1127;553;574;1115;539;576;424;2;336;661;659;2;2;655
261899000;6;141617;                        Póvoa de Santarém;708;342;366;689;330;359;246;1;212;353;352;1;1;348
261925000;6;141618;                        Romeira;783;388;395;741;365;376;289;1;246;432;431;1;2;423
261954000;6;141619;                        Santa Iria da Ribeira de Santarém;745;329;416;721;314;407;323;0;230;481;470;11;0;339
261984000;6;141620;                        Santarém (São Nicolau);9627;4501;5126;9546;4413;5133;3922;5;2925;5201;5197;4;9;1727
262112000;6;141621;                        Santarém (São Salvador);10513;4993;5520;10169;4758;5411;4161;3;3251;5304;5300;4;9;2580
262315000;6;141622;                        São Vicente do Paul;1835;880;955;1764;834;930;717;0;593;1168;1165;3;0;1155
262409000;6;141623;                        Tremês;1981;931;1050;1915;891;1024;808;1;631;1156;1155;1;1;1128
262505000;6;141624;                        Vale de Figueira;1082;540;542;1045;512;533;417;0;353;585;585;0;0;551
262539000;6;141625;                        Vale de Santarém;2920;1403;1517;2838;1348;1490;1164;1;925;1597;1587;10;3;1393
262606000;6;141626;                        Vaqueiros;285;137;148;270;130;140;105;0;91;174;174;0;0;166
262625000;6;141627;                        Várzea;1817;897;920;1758;859;899;695;0;582;942;942;0;4;905
262691000;6;141628;                        Gançaria;514;247;267;498;239;259;192;0;160;278;278;0;0;273
