ordem;nivel;cod_dim2;Zona Geográfica;População residente - Total;População residente - H;População residente - M;População presente - Total;População presente - H;População presente - M;Famílias - Clássicas ;Famílias - Institucionais;Núcleos familiares ;Alojamentos familiares - Total ;Alojamentos familiares - Clássicos;Alojamentos familiares - Não clássicos;Alojamentos colectivos;Edifícios clássicos
262716000;3;15;            Algarve;451006;219931;231075;462862;226060;236802;182776;152;139009;378349;377619;730;1777;198924
262717000;4;150;                Algarve;451006;219931;231075;462862;226060;236802;182776;152;139009;378349;377619;730;1777;198924
262718000;5;801;                    Albufeira;40828;20028;20800;49578;24477;25101;16420;13;12395;42631;42548;83;571;19686
262719000;6;80101;                        Albufeira;22781;11113;11668;28606;14060;14546;9272;8;6768;23631;23582;49;446;8737
263425000;6;80102;                        Guia;4376;2148;2228;4891;2439;2452;1749;2;1340;5413;5408;5;46;3213
263581000;6;80103;                        Paderne;3304;1645;1659;3252;1629;1623;1342;2;1022;2284;2278;6;6;2016
263684000;6;80104;                        Ferreiras;6406;3178;3228;6144;3017;3127;2458;1;2011;3442;3426;16;4;2610
263810000;6;80105;                        Olhos de Água;3961;1944;2017;6685;3332;3353;1599;0;1254;7861;7854;7;69;3110
263998000;5;802;                    Alcoutim;2917;1454;1463;2893;1445;1448;1362;1;879;3508;3508;0;9;3461
263999000;6;80201;                        Alcoutim;921;448;473;940;462;478;413;1;253;1242;1242;0;7;1215
264173000;6;80202;                        Giões;256;128;128;248;124;124;130;0;77;311;311;0;0;303
264255000;6;80203;                        Martim Longo;1030;514;516;1013;505;508;459;0;328;1044;1044;0;1;1031
264416000;6;80204;                        Pereiro;213;108;105;214;110;104;116;0;66;396;396;0;1;397
264494000;6;80205;                        Vaqueiros;497;256;241;478;244;234;244;0;155;515;515;0;0;515
264574000;5;803;                    Aljezur;5884;2905;2979;5824;2880;2944;2649;2;1826;5876;5857;19;51;5391
264575000;6;80301;                        Aljezur;3365;1653;1712;3328;1635;1693;1492;1;1041;3434;3421;13;24;3136
264906000;6;80302;                        Bordeira;432;229;203;462;247;215;213;0;130;573;573;0;11;548
265000000;6;80303;                        Odeceixe;961;470;491;931;455;476;418;1;291;949;948;1;12;859
265085000;6;80304;                        Rogil;1126;553;573;1103;543;560;526;0;364;920;915;5;4;848
265157000;5;804;                    Castro Marim;6747;3355;3392;7069;3498;3571;2824;1;2116;8362;8353;9;16;6765
265158000;6;80401;                        Azinhal;522;252;270;503;242;261;255;0;157;657;657;0;0;649
265210000;6;80402;                        Castro Marim;3267;1629;1638;3236;1603;1633;1307;1;1005;2820;2816;4;4;2657
265364000;6;80403;                        Odeleite;763;398;365;766;400;366;380;0;257;1200;1200;0;1;1191
265440000;6;80404;                        Altura;2195;1076;1119;2564;1253;1311;882;0;697;3685;3680;5;11;2268
265576000;5;805;                    Faro;64560;30930;33630;63467;30163;33304;26929;32;19539;37975;37788;187;92;17257
265577000;6;80501;                        Conceição;4524;2267;2257;4365;2189;2176;1726;1;1391;2305;2263;42;1;1779
265705000;6;80502;                        Estoi;3652;1800;1852;3701;1806;1895;1393;3;1135;2292;2283;9;7;1969
265877000;6;80503;                        Santa Bárbara de Nexe;4116;2034;2082;3981;1965;2016;1578;3;1283;2806;2792;14;3;2558
266035000;6;80504;                        Faro (São Pedro);14577;6990;7587;14198;6782;7416;6227;7;4329;8688;8597;91;35;3407
266307000;6;80505;                        Faro (Sé);29542;13796;15746;28961;13374;15587;12728;18;8900;17459;17434;25;38;4894
266707000;6;80506;                        Montenegro;8149;4043;4106;8261;4047;4214;3277;0;2501;4425;4419;6;8;2650
266905000;5;806;                    Lagoa;22975;11299;11676;24202;11977;12225;9071;7;7088;19588;19560;28;381;12772
266906000;6;80601;                        Estômbar;4985;2488;2497;4976;2524;2452;1932;2;1567;3318;3306;12;67;2386
267082000;6;80602;                        Ferragudo;1973;1003;970;2073;1053;1020;861;0;616;1927;1926;1;32;1421
267182000;6;80603;                        Lagoa;7266;3513;3753;7178;3463;3715;2887;3;2200;4412;4408;4;84;2685
267389000;6;80604;                        Porches;2011;996;1015;2311;1174;1137;812;2;620;3300;3299;1;44;1707
267505000;6;80605;                        Carvoeiro;2721;1316;1405;3920;1940;1980;1120;0;856;4643;4642;1;154;3348
267658000;6;80606;                        Parchal;4019;1983;2036;3744;1823;1921;1459;0;1229;1988;1979;9;0;1225
267731000;5;807;                    Lagos;31049;15090;15959;30934;14997;15937;12557;11;9504;27030;26973;57;105;13205
267732000;6;80701;                        Barão de São João;895;448;447;909;457;452;398;1;264;689;676;13;5;666
267773000;6;80702;                        Bensafrim;1530;768;762;1493;743;750;623;1;482;1002;995;7;1;926
267849000;6;80703;                        Luz;3545;1731;1814;3809;1860;1949;1490;1;1120;5300;5295;5;27;3604
268160000;6;80704;                        Odiáxere;2984;1462;1522;2908;1428;1480;1156;2;937;1776;1769;7;8;1396
268273000;6;80705;                        Lagos (Santa Maria);8046;3817;4229;8024;3801;4223;3229;3;2392;6895;6895;0;37;2662
268492000;6;80706;                        Lagos (São Sebastião);14049;6864;7185;13791;6708;7083;5661;3;4309;11368;11343;25;27;3951
268830000;5;808;                    Loulé;70622;34449;36173;71593;35094;36499;28402;13;21986;65662;65565;97;121;34394
268831000;6;80801;                        Almancil;11136;5604;5532;12515;6402;6113;4369;2;3454;10121;10108;13;24;7536
269330000;6;80802;                        Alte;1997;988;1009;2008;996;1012;874;1;636;1565;1560;5;3;1522
269440000;6;80803;                        Ameixial;439;228;211;428;221;207;221;0;131;458;458;0;0;456
269501000;6;80804;                        Boliqueime;4973;2422;2551;4878;2373;2505;1963;1;1571;3189;3180;9;12;2756
269674000;6;80805;                        Quarteira;21798;10523;11275;22820;11087;11733;8899;2;6650;31496;31467;29;53;9383
270317000;6;80806;                        Querença;759;385;374;762;391;371;322;1;251;552;551;1;4;530
270358000;6;80807;                        Salir;2775;1381;1394;2671;1324;1347;1163;0;914;2009;2006;3;7;1935
270520000;6;80808;                        Loulé (São Clemente);17358;8293;9065;16546;7896;8650;6895;6;5417;10255;10246;9;14;5484
270906000;6;80809;                        Loulé (São Sebastião);7433;3656;3777;7155;3515;3640;2882;0;2315;4743;4719;24;2;3559
271148000;6;80810;                        Benafim;1069;516;553;935;443;492;470;0;359;749;749;0;1;722
271220000;6;80811;                        Tôr;885;453;432;875;446;429;344;0;288;525;521;4;1;511
271262000;5;809;                    Monchique;6045;3046;2999;5907;2984;2923;2583;3;1883;4588;4586;2;10;4201
271263000;6;80901;                        Alferce;441;231;210;434;226;208;199;0;142;428;428;0;0;423
271308000;6;80902;                        Marmelete;787;406;381;772;398;374;365;0;241;722;721;1;0;719
271358000;6;80903;                        Monchique;4817;2409;2408;4701;2360;2341;2019;3;1500;3438;3437;1;10;3059
271518000;5;810;                    Olhão;45396;22174;23222;44327;21531;22796;17642;10;14057;26225;26132;93;36;15253
271519000;6;81001;                        Fuseta;1918;930;988;1832;879;953;771;1;602;1393;1393;0;2;873
271592000;6;81002;                        Moncarapacho;7717;3832;3885;7479;3692;3787;3036;2;2445;4977;4959;18;12;4393
271816000;6;81003;                        Olhão;14914;7098;7816;14512;6902;7610;6148;2;4617;8947;8931;16;9;3808
272116000;6;81004;                        Pechão;3601;1773;1828;3460;1698;1762;1393;0;1143;1910;1871;39;1;1263
272227000;6;81005;                        Quelfes;17246;8541;8705;17044;8360;8684;6294;5;5250;8998;8978;20;12;4916
272493000;5;811;                    Portimão;55614;26853;28761;56530;27522;29008;22740;25;17012;46943;46887;56;138;14921
272494000;6;81101;                        Alvor;6154;3011;3143;7371;3768;3603;2462;3;1882;7327;7320;7;24;3234
272771000;6;81102;                        Mexilhoeira Grande;4029;2000;2029;3946;1949;1997;1541;4;1244;2724;2716;8;3;2399
272931000;6;81103;                        Portimão;45431;21842;23589;45213;21805;23408;18737;18;13886;36892;36851;41;111;9288
273888000;5;812;                    São Brás de Alportel;10662;5232;5430;10322;5043;5279;4286;2;3336;6562;6552;10;14;4958
273889000;6;81201;                        São Brás de Alportel;10662;5232;5430;10322;5043;5279;4286;2;3336;6562;6552;10;14;4958
274158000;5;813;                    Silves;37126;18525;18601;36887;18416;18471;14969;15;11599;32558;32522;36;59;18183
274159000;6;81301;                        Alcantarilha;2540;1247;1293;2674;1315;1359;999;2;778;1700;1700;0;7;1398
274276000;6;81302;                        Algoz;3831;1923;1908;3656;1825;1831;1505;1;1214;2347;2345;2;3;1866
274393000;6;81303;                        Armação de Pêra;4867;2397;2470;5033;2473;2560;2007;1;1467;11255;11251;4;9;1651
274546000;6;81304;                        Pêra;2432;1206;1226;2358;1156;1202;976;0;750;2245;2242;3;3;1714
274664000;6;81305;                        São Bartolomeu de Messines;8430;4212;4218;8275;4156;4119;3462;4;2713;5807;5800;7;13;4839
274992000;6;81306;                        São Marcos da Serra;1352;697;655;1346;695;651;642;0;419;1163;1161;2;1;1095
275088000;6;81307;                        Silves;11014;5506;5508;11009;5527;5482;4359;7;3422;6521;6511;10;22;4652
275356000;6;81308;                        Tunes;2660;1337;1323;2536;1269;1267;1019;0;836;1520;1512;8;1;968
275423000;5;814;                    Tavira;26167;12814;13353;27060;13313;13747;10603;11;8294;25313;25292;21;59;15144
275424000;6;81401;                        Cachopo;716;359;357;717;360;357;347;1;222;842;842;0;1;840
275485000;6;81402;                        Conceição;1438;718;720;1431;713;718;632;0;470;2219;2219;0;1;1138
275571000;6;81403;                        Luz;3355;1645;1710;3321;1617;1704;1353;2;1088;2396;2392;4;4;2090
275650000;6;81404;                        Santa Catarina da Fonte do Bispo;1809;911;898;1826;923;903;732;1;584;1429;1429;0;5;1396
275743000;6;81405;                        Tavira (Santa Maria);8836;4266;4570;9319;4497;4822;3543;3;2764;7325;7319;6;21;3733
276046000;6;81406;                        Tavira (Santiago);6297;3054;3243;6235;3076;3159;2470;4;1976;4216;4213;3;16;2126
276177000;6;81407;                        Santo Estêvão;1180;594;586;1174;589;585;494;0;395;963;960;3;3;946
276233000;6;81408;                        Santa Luzia;1455;727;728;1387;697;690;582;0;459;2274;2271;3;1;1229
276301000;6;81409;                        Cabanas de Tavira;1081;540;541;1650;841;809;450;0;336;3649;3647;2;7;1646
276405000;5;815;                    Vila do Bispo;5258;2624;2634;5673;2843;2830;2286;1;1595;5903;5887;16;76;5184
276406000;6;81501;                        Barão de São Miguel;451;231;220;485;244;241;201;0;137;488;484;4;18;476
276455000;6;81502;                        Budens;1520;763;757;1588;800;788;683;0;476;2614;2612;2;24;2275
276655000;6;81503;                        Raposeira;460;232;228;496;255;241;222;0;135;528;524;4;2;480
276730000;6;81504;                        Sagres;1909;943;966;2162;1075;1087;787;1;568;1580;1577;3;25;1349
276827000;6;81505;                        Vila do Bispo;918;455;463;942;469;473;393;0;279;693;690;3;7;604
276919000;5;816;                    Vila Real de Santo António;19156;9153;10003;20596;9877;10719;7453;5;5900;19625;19609;16;39;8149
276920000;6;81601;                        Vila Nova de Cacela;3902;1877;2025;4327;2111;2216;1598;1;1257;5570;5569;1;9;3780
277102000;6;81602;                        Vila Real de Santo António;11946;5687;6259;11519;5463;6056;4656;4;3641;8026;8013;13;14;2720
277394000;6;81603;                        Monte Gordo;3308;1589;1719;4750;2303;2447;1199;0;1002;6029;6027;2;16;1649
