ordem;nivel;cod_dim2;Zona Geográfica;População residente - Total;População residente - H;População residente - M;População presente - Total;População presente - H;População presente - M;Famílias - Clássicas ;Famílias - Institucionais;Núcleos familiares ;Alojamentos familiares - Total ;Alojamentos familiares - Clássicos;Alojamentos familiares - Não clássicos;Alojamentos colectivos;Edifícios clássicos
96346000;3;16;            Centro;2327755;1111263;1216492;2258474;1066340;1192134;904770;1477;720204;1445343;1443886;1457;3301;1111952
96347000;4;161;                Baixo Vouga;390822;187078;203744;380026;180181;199845;145258;167;121961;202111;201757;354;360;149921
96348000;5;101;                    Águeda;47729;22891;24838;46021;21876;24145;17453;20;15193;22821;22801;20;37;18572
96349000;6;10101;                        Agadão;373;173;200;368;169;199;146;0;123;207;207;0;0;204
96374000;6;10102;                        Aguada de Baixo;1373;643;730;1322;611;711;478;1;431;622;622;0;3;574
96430000;6;10103;                        Aguada de Cima;4013;1943;2070;3806;1820;1986;1455;1;1265;2018;2014;4;2;1653
96580000;6;10104;                        Águeda;11346;5393;5953;11106;5217;5889;4382;5;3566;5860;5855;5;12;3485
96888000;6;10105;                        Barrô;1836;873;963;1792;851;941;653;1;596;842;840;2;1;784
96944000;6;10106;                        Belazaima do Chão;599;277;322;587;270;317;216;1;194;265;263;2;1;258
96984000;6;10107;                        Castanheira do Vouga;639;292;347;621;283;338;229;0;197;313;313;0;0;308
97035000;6;10108;                        Espinhel;2482;1204;1278;2368;1149;1219;869;0;788;1067;1065;2;1;1026
97139000;6;10109;                        Fermentelos;3258;1599;1659;3148;1542;1606;1169;1;1043;1463;1463;0;3;1308
97204000;6;10110;                        Lamas do Vouga;729;352;377;691;327;364;250;0;226;318;316;2;0;302
97229000;6;10111;                        Macieira de Alcoba;84;38;46;82;38;44;39;0;29;83;83;0;1;84
97248000;6;10112;                        Macinhata do Vouga;3406;1634;1772;3310;1578;1732;1279;1;1094;1727;1727;0;2;1644
97421000;6;10113;                        Óis da Ribeira;716;347;369;691;335;356;251;0;227;309;309;0;0;287
97440000;6;10114;                        Préstimo;724;350;374;710;341;369;264;0;234;412;411;1;0;410
97507000;6;10115;                        Recardães;3554;1720;1834;3354;1603;1751;1321;3;1158;1686;1686;0;3;1282
97611000;6;10116;                        Segadães;1169;567;602;1120;540;580;404;0;375;500;500;0;0;440
97646000;6;10117;                        Travassô;1589;754;835;1502;706;796;561;2;507;726;725;1;2;682
97702000;6;10118;                        Trofa;2732;1314;1418;2678;1263;1415;996;1;867;1202;1202;0;3;947
97775000;6;10119;                        Valongo do Vouga;4877;2351;2526;4615;2208;2407;1685;2;1560;2156;2155;1;2;2051
97937000;6;10120;                        Borralha;2230;1067;1163;2150;1025;1125;806;1;713;1045;1045;0;1;843
98021000;5;102;                    Albergaria-a-Velha;25252;12230;13022;24261;11620;12641;9241;12;7922;12315;12294;21;16;10140
98022000;6;10201;                        Albergaria-a-Velha;8528;4093;4435;8046;3793;4253;3210;3;2648;4414;4412;2;6;2615
98277000;6;10202;                        Alquerubim;2381;1142;1239;2362;1122;1240;866;1;744;1082;1074;8;1;1041
98380000;6;10203;                        Angeja;2073;1003;1070;2011;966;1045;756;0;649;979;979;0;0;944
98456000;6;10204;                        Branca;5621;2753;2868;5456;2658;2798;1965;6;1762;2559;2558;1;6;2417
98658000;6;10205;                        Frossos;887;434;453;848;415;433;333;0;286;483;481;2;1;444
98692000;6;10206;                        Ribeira de Fráguas;1713;832;881;1633;779;854;613;1;532;753;753;0;1;746
98790000;6;10207;                        São João de Loure;2009;973;1036;1964;941;1023;734;1;642;970;962;8;1;934
98880000;6;10208;                        Valmaior;2040;1000;1040;1941;946;995;764;0;659;1075;1075;0;0;999
98976000;5;103;                    Anadia;29150;13967;15183;28164;13402;14762;10853;27;9164;15011;14996;15;42;12977
98977000;6;10301;                        Amoreira da Gândara;1057;513;544;1023;494;529;409;1;351;578;577;1;1;572
99034000;6;10302;                        Ancas;624;296;328;606;285;321;241;0;204;327;326;1;0;315
99057000;6;10303;                        Arcos;5511;2609;2902;5361;2529;2832;2034;9;1684;2776;2775;1;12;1784
99180000;6;10304;                        Avelãs de Caminho;1252;631;621;1227;621;606;451;1;401;621;621;0;1;555
99215000;6;10305;                        Avelãs de Cima;2185;1080;1105;2113;1041;1072;764;3;657;978;977;1;3;957
99324000;6;10306;                        Mogofores;820;398;422;808;393;415;322;2;256;461;461;0;3;392
99348000;6;10307;                        Moita;2484;1200;1284;2409;1159;1250;899;1;792;1216;1215;1;1;1168
99471000;6;10308;                        Óis do Bairro;491;233;258;476;229;247;210;0;155;434;434;0;1;219
99492000;6;10309;                        Sangalhos;4068;1928;2140;3909;1835;2074;1509;4;1270;1963;1959;4;8;1644
99610000;6;10310;                        São Lourenço do Bairro;2414;1155;1259;2292;1083;1209;906;0;769;1253;1252;1;0;1231
99710000;6;10311;                        Tamengos;1602;755;847;1534;713;821;603;1;515;882;881;1;5;710
99760000;6;10312;                        Vila Nova de Monsarros;1713;827;886;1643;776;867;641;1;555;859;857;2;1;824
99826000;6;10313;                        Vilarinho do Bairro;2764;1322;1442;2682;1271;1411;1049;3;882;1583;1582;1;3;1566
99974000;6;10314;                        Paredes do Bairro;994;466;528;966;449;517;372;0;318;491;491;0;0;485
100008000;6;10315;                        Aguim;1171;554;617;1115;524;591;443;1;355;589;588;1;3;555
100054000;5;105;                    Aveiro;78450;37120;41330;79542;37448;42094;31142;45;24205;40570;40475;95;104;22817
100055000;6;10501;                        Aradas;9157;4359;4798;9521;4540;4981;3791;4;2857;4888;4887;1;7;2917
100242000;6;10502;                        Cacia;7354;3599;3755;7059;3424;3635;2630;0;2345;3180;3139;41;2;2744
100353000;6;10503;                        Eirol;753;375;378;724;359;365;272;0;240;342;341;1;0;337
100379000;6;10504;                        Eixo;5571;2669;2902;5284;2489;2795;2045;3;1748;2523;2519;4;3;1778
100473000;6;10505;                        Esgueira;13431;6405;7026;12772;6023;6749;5216;6;4165;6422;6414;8;7;3258
100646000;6;10506;                        Glória;9099;4212;4887;12561;5925;6636;4135;12;2660;6219;6207;12;45;1630
100810000;6;10507;                        Nariz;1418;677;741;1356;640;716;501;0;442;656;656;0;0;632
100849000;6;10508;                        Oliveirinha;4817;2247;2570;4633;2137;2496;1714;5;1468;2132;2127;5;4;1937
100954000;6;10509;                        Requeixo;1222;610;612;1150;577;573;445;0;386;563;560;3;0;542
100992000;6;10510;                        São Bernardo;4960;2352;2608;4715;2206;2509;1875;7;1553;2273;2268;5;7;1503
101053000;6;10511;                        São Jacinto;993;486;507;896;438;458;388;0;323;637;637;0;1;520
101112000;6;10512;                        Vera Cruz;9657;4370;5287;9271;4158;5113;4434;3;2859;6394;6390;4;23;1758
101284000;6;10513;                        Santa Joana;8094;3863;4231;7756;3679;4077;3007;5;2553;3505;3495;10;5;2473
101395000;6;10514;                        Nossa Senhora de Fátima;1924;896;1028;1844;853;991;689;0;606;836;835;1;0;788
101448000;5;108;                    Estarreja;26997;13012;13985;25995;12410;13585;9612;11;8370;12828;12798;30;20;11181
101449000;6;10801;                        Avanca;6189;2984;3205;5968;2867;3101;2122;4;1915;2535;2517;18;6;2274
101669000;6;10802;                        Beduído;7544;3605;3939;7179;3399;3780;2752;1;2376;3632;3632;0;7;2502
101852000;6;10803;                        Canelas;1438;689;749;1394;661;733;505;0;439;694;694;0;0;675
101933000;6;10804;                        Fermelã;1332;651;681;1270;607;663;501;0;416;682;682;0;0;677
101993000;6;10805;                        Pardilhó;4176;2039;2137;4073;1969;2104;1473;3;1289;2125;2121;4;3;2012
102123000;6;10806;                        Salreu;3815;1820;1995;3709;1752;1957;1390;2;1178;1873;1871;2;3;1780
102277000;6;10807;                        Veiros;2503;1224;1279;2402;1155;1247;869;1;757;1287;1281;6;1;1261
102362000;5;110;                    Ílhavo;38598;18407;20191;36779;17249;19530;14597;12;12063;21955;21910;45;26;15036
102363000;6;11001;                        Gafanha do Carmo;1758;874;884;1718;841;877;605;1;546;921;915;6;1;881
102408000;6;11002;                        Gafanha da Encarnação;5487;2654;2833;5267;2503;2764;2022;1;1710;3837;3823;14;4;2514
102551000;6;11003;                        Gafanha da Nazaré;14756;7088;7668;13934;6548;7386;5629;2;4655;8828;8813;15;9;5152
102824000;6;11004;                        Ílhavo (São Salvador);16597;7791;8806;15860;7357;8503;6341;8;5152;8369;8359;10;12;6489
103089000;5;111;                    Mealhada;20428;9823;10605;19801;9421;10380;7742;6;6509;10137;10125;12;32;8434
103090000;6;11101;                        Antes;933;435;498;891;411;480;326;1;287;434;434;0;2;429
103116000;6;11102;                        Barcouço;2152;1052;1100;2068;999;1069;803;0;681;1011;1010;1;0;956
103172000;6;11103;                        Casal Comba;3183;1535;1648;3110;1483;1627;1218;1;1048;1611;1610;1;6;1540
103260000;6;11104;                        Luso;2593;1267;1326;2646;1286;1360;1004;1;818;1365;1364;1;14;1179
103335000;6;11105;                        Mealhada;4522;2125;2397;4317;2012;2305;1726;2;1386;2309;2307;2;7;1327
103424000;6;11106;                        Pampilhosa;4098;1967;2131;3937;1871;2066;1530;1;1320;1987;1982;5;1;1613
103511000;6;11107;                        Vacariça;1945;942;1003;1874;889;985;713;0;639;865;863;2;1;842
103576000;6;11108;                        Ventosa do Bairro;1002;500;502;958;470;488;422;0;330;555;555;0;1;548
103620000;5;112;                    Murtosa;10585;5096;5489;10092;4754;5338;3837;4;3191;7653;7635;18;9;5845
103621000;6;11201;                        Bunheiro;2682;1287;1395;2571;1216;1355;926;0;824;1354;1352;2;0;1321
103750000;6;11202;                        Monte;1459;687;772;1377;633;744;521;1;438;878;878;0;1;819
103826000;6;11203;                        Murtosa;3699;1746;1953;3608;1691;1917;1421;3;1110;2093;2093;0;3;1868
103958000;6;11204;                        Torreira;2745;1376;1369;2536;1214;1322;969;0;819;3328;3312;16;5;1837
104093000;5;114;                    Oliveira do Bairro;23028;10915;12113;22230;10446;11784;8433;8;7179;11307;11283;24;17;9042
104094000;6;11401;                        Bustos;2652;1253;1399;2549;1199;1350;973;1;813;1395;1395;0;2;1224
104188000;6;11402;                        Mamarrosa;1406;654;752;1398;649;749;511;1;436;703;701;2;2;635
104244000;6;11403;                        Oiã;7722;3680;4042;7494;3518;3976;2787;3;2395;3619;3610;9;5;2802
104423000;6;11404;                        Oliveira do Bairro;6250;2951;3299;5968;2798;3170;2347;1;1943;3141;3130;11;6;2142
104571000;6;11405;                        Palhaça;2627;1251;1376;2548;1204;1344;944;2;816;1234;1232;2;2;1052
104642000;6;11406;                        Troviscal;2371;1126;1245;2273;1078;1195;871;0;776;1215;1215;0;0;1187
104736000;5;115;                    Ovar;55398;26671;28727;53334;25453;27881;19510;12;17293;27765;27718;47;34;19089
104737000;6;11501;                        Arada;3318;1601;1717;3178;1522;1656;1085;0;1020;1367;1367;0;2;1282
104798000;6;11502;                        Cortegaça;3837;1841;1996;3713;1756;1957;1336;1;1195;1841;1834;7;3;1331
104876000;6;11503;                        Esmoriz;11448;5544;5904;11023;5303;5720;4143;1;3578;6124;6115;9;9;3426
105081000;6;11504;                        Maceda;3521;1727;1794;3456;1687;1769;1172;1;1097;1480;1477;3;2;1338
105147000;6;11505;                        Ovar;17855;8519;9336;17084;8057;9027;6587;5;5581;10409;10389;20;14;5878
105420000;6;11506;                        São Vicente de Pereira Jusã;2316;1114;1202;2233;1066;1167;730;4;712;911;910;1;4;866
105489000;6;11507;                        Válega;6827;3302;3525;6634;3191;3443;2266;0;2120;2881;2878;3;0;2590
105622000;6;11508;                        São João;6276;3023;3253;6013;2871;3142;2191;0;1990;2752;2748;4;0;2378
105721000;5;117;                    Sever do Vouga;12356;5962;6394;11699;5569;6130;4596;3;3859;7060;7056;4;11;6485
105722000;6;11701;                        Cedrim;834;404;430;797;380;417;305;0;259;454;453;1;0;450
105787000;6;11702;                        Couto de Esteves;890;430;460;825;399;426;348;0;283;567;567;0;0;557
105860000;6;11703;                        Paradela;720;352;368;679;329;350;244;0;218;402;402;0;0;388
105894000;6;11704;                        Pessegueiro do Vouga;1852;917;935;1791;867;924;666;1;576;1023;1023;0;1;998
105976000;6;11705;                        Rocas do Vouga;1778;851;927;1667;788;879;668;1;553;921;919;2;1;904
106034000;6;11706;                        Sever do Vouga;2777;1299;1478;2633;1217;1416;1063;1;868;1606;1605;1;7;1143
106130000;6;11707;                        Silva Escura;1592;757;835;1512;708;804;607;0;511;1012;1012;0;2;985
106222000;6;11708;                        Talhadas;1187;591;596;1110;549;561;417;0;366;701;701;0;0;695
106318000;6;11709;                        Dornelas;726;361;365;685;332;353;278;0;225;374;374;0;0;365
106357000;5;118;                    Vagos;22851;10984;11867;22108;10533;11575;8242;7;7013;12689;12666;23;12;10303
106358000;6;11801;                        Calvão;2014;1011;1003;1965;977;988;720;0;605;941;941;0;1;892
106430000;6;11802;                        Covão do Lobo;986;454;532;944;432;512;341;1;314;490;490;0;1;491
106497000;6;11803;                        Fonte de Angeão;1179;562;617;1143;537;606;442;0;347;727;727;0;0;724
106552000;6;11804;                        Gafanha da Boa Hora;2625;1264;1361;2542;1214;1328;1028;0;803;3018;3018;0;2;1490
106637000;6;11805;                        Ouca;1805;861;944;1743;820;923;641;1;547;831;831;0;2;820
106701000;6;11806;                        Ponte de Vagos;1790;869;921;1742;839;903;583;1;547;797;797;0;1;774
106760000;6;11807;                        Sosa;3069;1495;1574;3023;1461;1562;1097;0;958;1429;1410;19;0;1385
106845000;6;11808;                        Vagos;4606;2196;2410;4369;2063;2306;1739;2;1420;2310;2307;3;3;1672
106936000;6;11809;                        Santo António de Vagos;1753;816;937;1704;783;921;614;1;528;759;759;0;1;694
106984000;6;11810;                        Santo André de Vagos;2033;978;1055;1975;952;1023;706;0;644;948;947;1;0;923
107051000;6;11811;                        Santa Catarina;991;478;513;958;455;503;331;1;300;439;439;0;1;438
107096000;4;162;                Baixo Mondego;332326;156603;175723;329384;152554;176830;130747;186;103192;193390;193267;123;387;128139
107097000;5;602;                    Cantanhede;36595;17394;19201;35171;16557;18614;13811;16;11478;20542;20523;19;27;18695
107098000;6;60201;                        Ançã;2625;1278;1347;2550;1231;1319;980;0;837;1352;1351;1;0;1315
107152000;6;60202;                        Bolho;848;397;451;815;378;437;318;0;271;423;423;0;0;422
107186000;6;60203;                        Cadima;2963;1455;1508;2802;1344;1458;1059;0;937;1450;1447;3;0;1430
107335000;6;60204;                        Cantanhede;7738;3636;4102;7380;3442;3938;2997;4;2387;4110;4102;8;7;3017
107548000;6;60205;                        Cordinhã;1034;500;534;993;472;521;402;0;330;559;559;0;0;550
107590000;6;60206;                        Covões;2155;993;1162;2099;968;1131;853;1;687;1310;1310;0;1;1299
107711000;6;60207;                        Febres;3352;1563;1789;3236;1492;1744;1269;1;1029;2006;2006;0;1;1921
107873000;6;60208;                        Murtede;1431;683;748;1378;652;726;559;1;455;873;873;0;1;856
107929000;6;60209;                        Ourentã;1208;595;613;1153;567;586;460;0;397;700;700;0;0;687
107988000;6;60210;                        Outil;858;420;438;828;401;427;320;0;277;430;430;0;0;424
108023000;6;60211;                        Pocariça;1101;530;571;1030;481;549;391;0;342;588;588;0;0;577
108080000;6;60212;                        Portunhos;1187;558;629;1149;538;611;412;1;352;552;551;1;1;543
108124000;6;60213;                        Sepins;1076;525;551;1052;510;542;422;0;354;600;598;2;0;592
108171000;6;60214;                        Tocha;3992;1886;2106;3895;1847;2048;1504;4;1276;2907;2905;2;12;2401
108393000;6;60215;                        São Caetano;801;394;407;789;381;408;317;1;241;480;480;0;1;477
108454000;6;60216;                        Corticeiro de Cima;721;329;392;684;311;373;269;1;216;381;380;1;1;381
108492000;6;60217;                        Vilamar;780;361;419;724;326;398;272;1;220;407;407;0;1;397
108522000;6;60218;                        Sanguinheira;1901;899;1002;1827;850;977;675;0;600;893;892;1;0;886
108644000;6;60219;                        Camarneira;824;392;432;787;366;421;332;1;270;521;521;0;1;520
108697000;5;603;                    Coimbra;143396;66941;76455;149425;68691;80734;58101;93;43674;79249;79193;56;206;40641
108698000;6;60301;                        Almalaguês;3111;1452;1659;3004;1385;1619;1166;0;995;1528;1528;0;0;1501
108817000;6;60302;                        Coimbra (Almedina);904;405;499;1219;563;656;431;9;207;866;865;1;19;444
108851000;6;60303;                        Ameal;1682;800;882;1628;757;871;611;0;535;712;712;0;0;694
108905000;6;60304;                        Antanhol;2556;1259;1297;2428;1183;1245;947;0;822;1128;1128;0;0;904
108953000;6;60305;                        Antuzede;2276;1098;1178;2150;1025;1125;840;0;736;976;975;1;0;905
109023000;6;60306;                        Arzila;655;319;336;629;308;321;253;0;211;296;296;0;0;274
109048000;6;60307;                        Assafarge;2746;1336;1410;2631;1262;1369;962;0;868;1185;1185;0;0;1119
109130000;6;60308;                        Botão;1588;750;838;1549;719;830;566;0;527;730;727;3;0;720
109201000;6;60309;                        Brasfemes;1969;949;1020;1864;896;968;702;0;637;859;859;0;0;792
109269000;6;60310;                        Castelo Viegas;1695;818;877;1746;845;901;593;2;512;728;728;0;3;659
109311000;6;60311;                        Ceira;3701;1792;1909;3543;1702;1841;1451;0;1226;1944;1943;1;0;1656
109423000;6;60312;                        Cernache;4048;1922;2126;3879;1807;2072;1471;5;1242;1944;1942;2;5;1752
109574000;6;60313;                        Eiras;12097;5578;6519;11524;5256;6268;5041;5;3637;6462;6455;7;6;1867
109691000;6;60314;                        Lamarosa;2069;1003;1066;1987;949;1038;715;0;666;975;975;0;0;957
109744000;6;60315;                        Ribeira de Frades;1902;908;994;1852;881;971;731;1;614;890;889;1;1;785
109785000;6;60316;                        Santa Clara;9929;4583;5346;9739;4472;5267;4179;2;3102;5558;5556;2;7;2460
109929000;6;60317;                        Coimbra (Santa Cruz);5699;2544;3155;6071;2658;3413;2634;4;1604;4031;4030;1;17;1328
110022000;6;60318;                        Santo António dos Olivais;38936;17659;21277;43377;19646;23731;17145;22;11461;24497;24476;21;41;6525
110535000;6;60319;                        Coimbra (São Bartolomeu);627;252;375;812;335;477;321;3;140;620;619;1;24;299
110567000;6;60320;                        São João do Campo;2073;1010;1063;1970;936;1034;744;0;669;844;844;0;0;808
110604000;6;60321;                        São Martinho de Árvore;1033;512;521;995;487;508;345;0;334;421;420;1;0;414
110631000;6;60322;                        São Martinho do Bispo;14147;6618;7529;14562;6568;7994;5454;7;4440;7148;7144;4;11;4445
110829000;6;60323;                        São Paulo de Frades;5824;2744;3080;5601;2612;2989;2185;0;1850;2627;2625;2;0;1595
110936000;6;60324;                        São Silvestre;3122;1564;1558;2986;1480;1506;1074;1;1006;1271;1270;1;2;1083
111004000;6;60325;                        Coimbra (Sé Nova);6741;3133;3608;9870;4317;5553;3008;27;1695;5437;5435;2;62;1538
111105000;6;60326;                        Souselas;3092;1514;1578;2948;1420;1528;1115;2;1000;1411;1408;3;3;1313
111195000;6;60327;                        Taveiro;1948;923;1025;1857;866;991;734;0;621;874;872;2;0;752
111245000;6;60328;                        Torre de Vilela;1242;607;635;1179;567;612;437;1;387;491;491;0;1;466
111273000;6;60329;                        Torres do Mondego;2402;1142;1260;2337;1106;1231;952;0;793;1246;1246;0;1;1149
111362000;6;60330;                        Trouxemil;2712;1324;1388;2648;1276;1372;989;2;850;1178;1178;0;3;1071
111431000;6;60331;                        Vil de Matos;870;423;447;840;407;433;305;0;287;372;372;0;0;366
111472000;5;604;                    Condeixa-a-Nova;17078;8001;9077;16404;7544;8860;6266;9;5242;8488;8482;6;10;6637
111473000;6;60401;                        Anobra;1316;645;671;1258;612;646;502;0;428;658;657;1;0;637
111528000;6;60402;                        Belide;245;116;129;237;111;126;102;0;73;134;134;0;0;121
111537000;6;60403;                        Bem da Fé;112;59;53;102;51;51;45;0;39;60;60;0;0;59
111547000;6;60404;                        Condeixa-a-Nova;5136;2262;2874;4940;2138;2802;1785;7;1474;2300;2297;3;7;1127
111646000;6;60405;                        Condeixa-a-Velha;3472;1670;1802;3331;1563;1768;1282;0;1094;1712;1712;0;0;1296
111751000;6;60406;                        Ega;2835;1335;1500;2728;1265;1463;1056;1;873;1439;1438;1;2;1392
111851000;6;60407;                        Furadouro;206;96;110;200;92;108;82;0;69;132;132;0;0;132
111873000;6;60408;                        Sebal;2478;1233;1245;2381;1162;1219;919;0;794;1184;1184;0;0;1007
111955000;6;60409;                        Vila Seca;876;396;480;850;375;475;332;1;269;527;526;1;1;527
111994000;6;60410;                        Zambujal;402;189;213;377;175;202;161;0;129;342;342;0;0;339
112019000;5;605;                    Figueira da Foz;62125;29375;32750;58498;27056;31442;24448;32;19501;43220;43198;22;80;24893
112020000;6;60501;                        Alhadas;4082;1942;2140;3920;1842;2078;1540;1;1276;2107;2104;3;1;1953
112134000;6;60502;                        Alqueidão;1752;843;909;1679;794;885;701;1;559;971;970;1;1;958
112192000;6;60503;                        Brenha;912;425;487;887;405;482;349;0;293;469;469;0;0;439
112230000;6;60504;                        Buarcos;8602;3999;4603;7960;3632;4328;3507;4;2681;9542;9541;1;12;3493
112456000;6;60505;                        Ferreira-a-Nova;1488;716;772;1391;645;746;536;0;487;650;650;0;0;631
112536000;6;60506;                        Lavos;3999;1882;2117;3702;1674;2028;1468;5;1257;2131;2128;3;5;2061
112674000;6;60507;                        Maiorca;2634;1289;1345;2523;1210;1313;999;1;835;1317;1316;1;1;1297
112764000;6;60508;                        Marinha das Ondas;3179;1551;1628;2965;1401;1564;1161;1;998;1605;1605;0;1;1477
112867000;6;60509;                        Paião;2268;1047;1221;2136;972;1164;834;4;712;1148;1148;0;5;1068
112946000;6;60510;                        Quiaios;2901;1413;1488;2781;1354;1427;1118;1;911;2370;2370;0;7;1922
113061000;6;60511;                        São Julião da Figueira da Foz;9686;4329;5357;9061;3961;5100;4356;6;2939;9160;9156;4;33;2719
113271000;6;60512;                        Tavarede;9441;4576;4865;8769;4175;4594;3668;1;3012;5390;5385;5;2;2010
113392000;6;60513;                        Vila Verde;2968;1440;1528;2797;1332;1465;1155;1;955;1595;1594;1;1;1310
113457000;6;60514;                        São Pedro;2910;1421;1489;2906;1353;1553;1151;2;898;2051;2049;2;7;934
113548000;6;60515;                        Bom Sucesso;2133;999;1134;2032;925;1107;747;3;668;1077;1077;0;3;1020
113635000;6;60516;                        Santana;1058;503;555;969;442;527;384;0;341;623;623;0;0;588
113669000;6;60517;                        Borda do Campo;847;406;441;815;384;431;313;1;273;402;402;0;1;403
113700000;6;60518;                        Moinhos da Gândara;1265;594;671;1205;555;650;461;0;406;612;611;1;0;610
113761000;5;608;                    Mira;12465;5902;6563;11954;5568;6386;4721;7;3928;8609;8603;6;19;7003
113762000;6;60801;                        Mira;7367;3450;3917;7045;3256;3789;2828;4;2336;4240;4237;3;9;3888
114064000;6;60802;                        Seixo;1234;568;666;1218;551;667;471;1;366;828;828;0;1;814
114120000;6;60803;                        Carapelhos;717;358;359;708;352;356;260;0;212;421;421;0;0;419
114164000;6;60804;                        Praia de Mira;3147;1526;1621;2983;1409;1574;1162;2;1014;3120;3117;3;9;1882
114271000;5;610;                    Montemor-o-Velho;26171;12616;13555;24908;11716;13192;9873;8;8421;13214;13207;7;11;11697
114272000;6;61001;                        Abrunheira;637;291;346;639;281;358;262;1;210;445;445;0;1;437
114297000;6;61002;                        Arazede;5508;2680;2828;5170;2466;2704;1992;1;1776;2645;2642;3;1;2573
114512000;6;61003;                        Carapinheira;2898;1370;1528;2757;1267;1490;1086;1;924;1473;1471;2;1;1345
114615000;6;61004;                        Gatões;516;263;253;495;248;247;202;0;162;272;272;0;0;271
114641000;6;61005;                        Liceia;1254;608;646;1149;526;623;475;0;417;562;561;1;0;553
114691000;6;61006;                        Meãs do Campo;1853;889;964;1778;837;941;683;1;583;868;868;0;1;766
114745000;6;61007;                        Montemor-o-Velho;3154;1501;1653;3048;1420;1628;1191;2;973;1695;1695;0;5;1297
114870000;6;61008;                        Pereira;3265;1612;1653;3124;1510;1614;1309;0;1109;1669;1668;1;0;1165
114941000;6;61009;                        Santo Varão;1969;936;1033;1914;892;1022;740;0;624;927;927;0;0;723
114991000;6;61010;                        Seixo de Gatões;1449;685;764;1357;619;738;514;0;480;618;618;0;0;605
115047000;6;61011;                        Tentúgal;2141;1056;1085;2031;984;1047;797;1;671;1101;1101;0;1;1048
115141000;6;61012;                        Verride;587;275;312;545;246;299;227;1;184;420;420;0;1;413
115171000;6;61013;                        Vila Nova da Barca;291;135;156;280;124;156;129;0;91;178;178;0;0;168
115191000;6;61014;                        Ereira;649;315;334;621;296;325;266;0;217;341;341;0;0;333
115207000;5;613;                    Penacova;15251;7208;8043;14579;6763;7816;5841;8;4830;8343;8340;3;14;7876
115208000;6;61301;                        Carvalho;846;399;447;834;397;437;335;0;278;583;583;0;0;579
115306000;6;61302;                        Figueira de Lorvão;2737;1307;1430;2647;1223;1424;1003;2;868;1207;1206;1;2;1164
115415000;6;61303;                        Friúmes;645;303;342;613;281;332;235;1;194;438;437;1;1;436
115469000;6;61304;                        Lorvão;3898;1851;2047;3769;1771;1998;1497;1;1232;1993;1993;0;1;1869
115625000;6;61305;                        Oliveira do Mondego;658;304;354;567;240;327;266;0;205;399;399;0;0;379
115671000;6;61306;                        Paradela;225;108;117;216;101;115;83;0;70;163;163;0;0;163
115685000;6;61307;                        Penacova;3254;1532;1722;3111;1449;1662;1261;3;1033;1781;1781;0;9;1567
115865000;6;61308;                        São Paio de Mondego;211;92;119;202;89;113;80;0;65;144;144;0;0;142
115879000;6;61309;                        São Pedro de Alva;1607;748;859;1520;698;822;636;1;504;1025;1025;0;1;990
115967000;6;61310;                        Sazes do Lorvão;749;365;384;702;330;372;285;0;243;375;374;1;0;368
116028000;6;61311;                        Travanca do Mondego;421;199;222;398;184;214;160;0;138;235;235;0;0;219
116064000;5;615;                    Soure;19245;9166;10079;18445;8659;9786;7686;13;6118;11725;11721;4;20;10697
116065000;6;61501;                        Alfarelos;1439;699;740;1388;657;731;559;3;435;816;816;0;3;768
116144000;6;61502;                        Brunhós;180;83;97;177;82;95;76;0;62;103;103;0;0;97
116162000;6;61503;                        Degracias;453;211;242;424;199;225;197;0;140;278;278;0;1;272
116234000;6;61504;                        Figueiró do Campo;1507;718;789;1453;678;775;597;0;485;770;770;0;0;734
116305000;6;61505;                        Gesteira;974;464;510;913;419;494;398;1;301;617;617;0;1;609
116349000;6;61506;                        Granja do Ulmeiro;1866;866;1000;1764;800;964;736;1;599;1055;1055;0;1;717
116408000;6;61507;                        Pombalinho;807;386;421;802;382;420;345;0;281;650;650;0;1;647
116492000;6;61508;                        Samuel;1254;611;643;1208;577;631;535;0;406;823;822;1;0;817
116604000;6;61509;                        Soure;7917;3778;4139;7595;3586;4009;3056;6;2502;4787;4785;2;10;4240
116993000;6;61510;                        Tapéus;338;165;173;329;158;171;140;0;111;216;215;1;0;214
117044000;6;61511;                        Vila Nova de Anços;1113;525;588;1063;501;562;445;1;357;669;669;0;1;653
117101000;6;61512;                        Vinha da Rainha;1397;660;737;1329;620;709;602;1;439;941;941;0;2;929
117204000;4;163;                Pinhal Litoral;260942;125876;135066;250798;119821;130977;100577;124;80372;144680;144570;110;241;109618
117205000;5;1004;                    Batalha;15805;7648;8157;15209;7329;7880;6025;3;4904;8336;8332;4;18;7438
117206000;6;100401;                        Batalha;8548;4202;4346;8248;4037;4211;3241;2;2643;4260;4259;1;15;3477
117506000;6;100402;                        Reguengo do Fetal;2169;1018;1151;2062;961;1101;803;1;667;1257;1257;0;2;1241
117626000;6;100403;                        São Mamede;3560;1695;1865;3432;1621;1811;1413;0;1128;2087;2084;3;1;2009
117939000;6;100404;                        Golpilheira;1528;733;795;1467;710;757;568;0;466;732;732;0;0;711
117999000;5;1009;                    Leiria;126897;61319;65578;122673;58727;63946;48523;60;38712;67301;67236;65;110;46451
118000000;6;100901;                        Amor;4747;2384;2363;4545;2261;2284;1681;4;1451;2119;2115;4;4;2055
118142000;6;100902;                        Arrabal;2684;1328;1356;2541;1253;1288;966;1;804;1318;1317;1;2;1277
118258000;6;100903;                        Azoia;2276;1094;1182;2192;1051;1141;870;0;717;1082;1082;0;0;906
118331000;6;100904;                        Barosa;2156;1066;1090;2071;1018;1053;801;1;694;1020;1018;2;1;955
118399000;6;100905;                        Barreira;4102;1996;2106;3857;1866;1991;1623;0;1283;2066;2064;2;1;1330
118511000;6;100906;                        Boa Vista;1745;838;907;1645;779;866;662;1;538;934;933;1;1;845
118589000;6;100907;                        Caranguejeira;4691;2282;2409;4477;2165;2312;1706;1;1460;2482;2480;2;1;2440
118749000;6;100908;                        Carvide;2820;1357;1463;2726;1320;1406;1066;2;890;1441;1441;0;2;1410
118842000;6;100909;                        Coimbrão;1735;853;882;1643;806;837;670;2;525;2794;2794;0;7;1396
118974000;6;100910;                        Colmeias;3278;1556;1722;3118;1458;1660;1245;2;1000;2010;2008;2;2;1979
119097000;6;100911;                        Cortes;3001;1492;1509;2833;1392;1441;1090;1;936;1492;1491;1;2;1424
119201000;6;100912;                        Leiria;14909;6828;8081;15854;7231;8623;6619;16;4267;9436;9426;10;37;2190
119497000;6;100913;                        Maceira;9914;4840;5074;9400;4549;4851;3708;3;3145;4395;4390;5;4;4273
119769000;6;100914;                        Marrazes;22528;10746;11782;21164;9972;11192;8881;6;6883;11856;11849;7;8;4597
120111000;6;100915;                        Milagres;3071;1522;1549;2915;1437;1478;1123;0;934;1486;1480;6;0;1448
120215000;6;100916;                        Monte Real;2936;1397;1539;3014;1432;1582;1084;3;888;1613;1612;1;11;1243
120311000;6;100917;                        Monte Redondo;4398;2178;2220;4210;2065;2145;1584;1;1347;2172;2172;0;3;2048
120536000;6;100918;                        Ortigosa;1971;944;1027;1855;874;981;704;0;620;905;905;0;1;891
120610000;6;100919;                        Parceiros;4664;2271;2393;4550;2196;2354;1790;1;1456;2367;2365;2;1;1482
120708000;6;100920;                        Pousos;9763;4724;5039;9535;4565;4970;3719;5;2983;4821;4817;4;7;2960
120890000;6;100921;                        Regueira de Pontes;2221;1097;1124;2160;1051;1109;787;1;692;956;951;5;1;927
120984000;6;100922;                        Santa Catarina da Serra;4098;2006;2092;3854;1863;1991;1411;3;1203;1878;1876;2;7;1838
121143000;6;100923;                        Santa Eufémia;2327;1148;1179;2191;1081;1110;841;0;708;1187;1186;1;1;1155
121243000;6;100924;                        Souto da Carpalhosa;3863;1905;1958;3670;1801;1869;1362;2;1172;1835;1832;3;2;1801
121408000;6;100925;                        Bajouca;2004;1021;983;1898;952;946;697;0;593;924;924;0;0;920
121480000;6;100926;                        Bidoeira de Cima;2250;1113;1137;2139;1042;1097;814;1;700;1096;1094;2;1;1076
121570000;6;100927;                        Memória;807;367;440;770;344;426;325;1;235;658;658;0;1;658
121619000;6;100930;                        Carreira;1166;563;603;1098;521;577;411;2;359;575;573;2;2;557
121669000;6;100931;                        Chainça;772;403;369;748;382;366;283;0;229;383;383;0;0;370
121704000;5;1010;                    Marinha Grande;38681;18623;20058;36943;17650;19293;15455;14;12305;21944;21929;15;35;14612
121705000;6;101001;                        Marinha Grande;31413;15147;16266;30007;14359;15648;12639;9;10020;16940;16927;13;24;10835
122458000;6;101002;                        Vieira de Leiria;5845;2774;3071;5568;2624;2944;2310;5;1831;4399;4397;2;11;3204
122706000;6;101003;                        Moita;1423;702;721;1368;667;701;506;0;454;605;605;0;0;573
122752000;5;1015;                    Pombal;55217;26422;28795;52817;24940;27877;21223;37;16994;34076;34055;21;54;29897
122753000;6;101501;                        Abiul;2729;1220;1509;2627;1153;1474;1159;2;814;2160;2158;2;2;2152
123034000;6;101502;                        Albergaria dos Doze;1765;846;919;1717;815;902;703;3;525;1318;1318;0;4;1222
123157000;6;101503;                        Almagreira;3076;1467;1609;2940;1389;1551;1185;2;994;1880;1880;0;2;1871
123372000;6;101504;                        Carnide;1647;795;852;1571;742;829;578;1;496;862;862;0;1;849
123504000;6;101505;                        Carriço;3653;1799;1854;3486;1703;1783;1346;1;1153;1900;1897;3;3;1855
123689000;6;101506;                        Louriçal;4720;2264;2456;4453;2106;2347;1777;3;1493;2655;2653;2;4;2502
123957000;6;101507;                        Mata Mourisca;1835;920;915;1763;868;895;707;0;582;1047;1047;0;1;1046
124111000;6;101508;                        Pelariga;2176;1047;1129;2089;989;1100;834;1;686;1268;1261;7;2;1250
124250000;6;101509;                        Pombal;17187;8195;8992;16400;7697;8703;6585;12;5241;10052;10048;4;20;6732
125035000;6;101510;                        Redinha;2117;1002;1115;2052;962;1090;840;0;665;1383;1382;1;0;1366
125200000;6;101511;                        Santiago de Litém;2237;1040;1197;2132;969;1163;901;3;681;2006;2006;0;3;1983
125376000;6;101512;                        São Simão de Litém;1382;656;726;1344;639;705;575;1;423;1261;1260;1;1;1247
125549000;6;101513;                        Vermoil;2656;1273;1383;2517;1200;1317;1014;2;804;1794;1793;1;3;1751
125769000;6;101514;                        Vila Cã;1659;758;901;1634;740;894;665;3;516;1094;1094;0;3;1092
125951000;6;101515;                        Meirinhas;1775;870;905;1687;820;867;662;0;538;955;955;0;0;821
126045000;6;101516;                        Guia;2672;1320;1352;2556;1248;1308;1008;2;806;1487;1487;0;4;1275
126211000;6;101517;                        Ilha;1931;950;981;1849;900;949;684;1;577;954;954;0;1;883
126340000;5;1016;                    Porto de Mós;24342;11864;12478;23156;11175;11981;9351;10;7457;13023;13018;5;24;11220
126341000;6;101601;                        Alcaria;244;110;134;247;111;136;106;0;74;226;226;0;1;227
126367000;6;101602;                        Alqueidão da Serra;1755;873;882;1676;827;849;669;2;526;973;973;0;2;965
126423000;6;101603;                        Alvados;497;235;262;491;227;264;210;0;150;301;301;0;3;302
126445000;6;101604;                        Arrimal;774;396;378;751;384;367;262;0;224;377;377;0;0;376
126487000;6;101605;                        Calvaria de Cima;2462;1203;1259;2342;1131;1211;940;1;787;1237;1236;1;1;1083
126537000;6;101606;                        Juncal;3316;1622;1694;3195;1553;1642;1191;3;1025;1640;1640;0;4;1575
126609000;6;101607;                        Mendiga;930;464;466;904;452;452;351;0;282;498;498;0;2;480
126649000;6;101608;                        Mira de Aire;3775;1802;1973;3564;1671;1893;1568;1;1186;2179;2179;0;3;1469
126780000;6;101609;                        Pedreiras;2705;1322;1383;2568;1237;1331;983;1;810;1278;1274;4;1;1250
126889000;6;101610;                        São Bento;835;393;442;805;384;421;340;0;263;540;540;0;1;539
126960000;6;101611;                        Porto de Mós (São João Baptista);3144;1536;1608;2979;1435;1544;1251;1;934;1598;1598;0;2;1311
127056000;6;101612;                        Porto de Mós (São Pedro);2879;1400;1479;2704;1306;1398;1112;0;878;1660;1660;0;3;1129
127126000;6;101613;                        Serro Ventoso;1026;508;518;930;457;473;368;1;318;516;516;0;1;514
127170000;4;164;                Pinhal Interior Norte;131468;62617;68851;126300;59417;66883;51964;96;40566;96738;96654;84;200;85699
127171000;5;601;                    Arganil;12145;5788;6357;11732;5519;6213;4984;7;3806;10919;10892;27;18;10075
127172000;6;60101;                        Anceriz;146;64;82;145;62;83;68;0;46;160;160;0;0;160
127185000;6;60102;                        Arganil;4002;1883;2119;3838;1779;2059;1538;3;1223;2450;2444;6;4;1791
127333000;6;60103;                        Barril de Alva;281;149;132;284;152;132;139;0;90;258;258;0;0;255
127350000;6;60104;                        Benfeita;394;182;212;379;177;202;202;0;126;697;695;2;1;691
127395000;6;60105;                        Celavisa;182;83;99;176;83;93;85;0;59;339;339;0;0;330
127420000;6;60106;                        Cepos;135;62;73;133;62;71;67;0;45;217;217;0;1;213
127441000;6;60107;                        Cerdeira;324;156;168;315;145;170;126;1;100;286;284;2;2;277
127465000;6;60108;                        Coja;1427;680;747;1370;646;724;564;1;453;1098;1098;0;3;1047
127540000;6;60109;                        Folques;356;166;190;351;157;194;152;1;94;468;468;0;1;467
127581000;6;60110;                        Moura da Serra;115;58;57;109;55;54;63;0;39;308;308;0;0;307
127605000;6;60111;                        Piódão;178;93;85;222;112;110;92;0;51;459;458;1;2;457
127641000;6;60112;                        Pomares;513;248;265;524;255;269;226;0;175;826;824;2;2;811
127708000;6;60113;                        Pombeiro da Beira;1010;478;532;965;449;516;424;0;322;902;899;3;0;893
127799000;6;60114;                        São Martinho da Cortiça;1319;645;674;1243;592;651;510;0;422;930;930;0;0;923
127883000;6;60115;                        Sarzedo;685;318;367;663;301;362;264;1;211;545;542;3;2;497
127913000;6;60116;                        Secarias;430;200;230;403;185;218;169;0;141;283;278;5;0;277
127933000;6;60117;                        Teixeira;135;71;64;127;70;57;68;0;43;249;249;0;0;249
127956000;6;60118;                        Vila Cova de Alva;513;252;261;485;237;248;227;0;166;444;441;3;0;430
128002000;5;606;                    Góis;4260;2003;2257;4105;1921;2184;1787;5;1299;5168;5165;3;8;4934
128003000;6;60601;                        Alvares;812;364;448;769;344;425;351;2;234;1673;1673;0;3;1662
128147000;6;60602;                        Cadafaz;190;94;96;179;88;91;97;0;57;382;382;0;0;382
128182000;6;60603;                        Colmeal;158;71;87;161;70;91;92;0;41;494;494;0;0;480
128224000;6;60604;                        Góis;2171;1034;1137;2069;981;1088;857;2;685;1812;1811;1;4;1624
128386000;6;60605;                        Vila Nova de Ceira;929;440;489;927;438;489;390;1;282;807;805;2;1;786
128479000;5;607;                    Lousã;17604;8518;9086;16858;8069;8789;6879;9;5520;10574;10568;6;13;7268
128480000;6;60701;                        Casal de Ermio;376;187;189;373;187;186;135;1;109;213;212;1;2;214
128504000;6;60702;                        Foz de Arouce;1062;520;542;1006;487;519;411;0;341;670;670;0;0;649
128568000;6;60703;                        Lousã;10163;4886;5277;9684;4596;5088;4022;8;3154;6030;6028;2;11;3353
128832000;6;60704;                        Serpins;1802;864;938;1729;814;915;703;0;586;1197;1197;0;0;1039
128976000;6;60705;                        Vilarinho;2893;1421;1472;2804;1370;1434;1109;0;927;1688;1687;1;0;1276
129061000;6;60706;                        Gândaras;1308;640;668;1262;615;647;499;0;403;776;774;2;0;737
129097000;5;609;                    Miranda do Corvo;13098;6311;6787;12483;5938;6545;4887;10;3997;7365;7362;3;15;6201
129098000;6;60901;                        Lamas;838;396;442;801;374;427;342;0;267;479;479;0;0;467
129138000;6;60902;                        Miranda do Corvo;7614;3642;3972;7231;3416;3815;2797;8;2290;4078;4076;2;11;2960
129399000;6;60903;                        Rio Vide;813;383;430;781;371;410;332;0;259;508;508;0;0;506
129456000;6;60904;                        Semide;2863;1417;1446;2741;1330;1411;1030;2;862;1517;1516;1;2;1487
129620000;6;60905;                        Vila Nova;970;473;497;929;447;482;386;0;319;783;783;0;2;781
129697000;5;611;                    Oliveira do Hospital;20855;10007;10848;19970;9438;10532;7980;13;6488;13684;13678;6;31;11726
129698000;6;61101;                        Aldeia das Dez;531;245;286;518;238;280;215;1;155;569;569;0;4;568
129760000;6;61102;                        Alvoco das Várzeas;320;138;182;311;132;179;130;1;97;328;326;2;2;311
129789000;6;61103;                        Avô;595;289;306;568;272;296;223;1;167;422;422;0;3;401
129822000;6;61104;                        Bobadela;759;371;388;717;344;373;278;1;244;420;420;0;2;364
129859000;6;61105;                        Ervedal;929;443;486;894;422;472;362;1;282;729;729;0;3;721
129928000;6;61106;                        Lagares;1398;648;750;1340;617;723;523;1;426;822;821;1;1;712
129983000;6;61107;                        Lagos da Beira;782;374;408;744;352;392;302;0;250;452;451;1;0;432
130030000;6;61108;                        Lajeosa;553;261;292;533;246;287;214;1;168;336;336;0;1;324
130060000;6;61109;                        Lourosa;555;268;287;547;262;285;232;0;175;527;526;1;0;514
130117000;6;61110;                        Meruge;555;258;297;550;253;297;244;0;172;423;423;0;0;409
130151000;6;61111;                        Nogueira do Cravo;2309;1120;1189;2200;1045;1155;823;2;721;1256;1256;0;3;1173
130254000;6;61112;                        Oliveira do Hospital;4717;2275;2442;4559;2158;2401;1774;1;1470;2660;2660;0;4;1242
130381000;6;61113;                        Penalva de Alva;926;438;488;885;418;467;364;0;302;607;606;1;1;602
130447000;6;61114;                        Santa Ovaia;597;291;306;562;266;296;205;1;173;361;361;0;1;331
130475000;6;61115;                        São Gião;425;206;219;409;193;216;180;0;135;508;508;0;2;500
130520000;6;61116;                        São Paio de Gramaços;991;489;502;933;455;478;357;1;309;517;517;0;1;440
130559000;6;61117;                        São Sebastião da Feira;197;84;113;186;77;109;87;0;66;162;162;0;0;155
130580000;6;61118;                        Seixo da Beira;1600;780;820;1511;725;786;629;0;507;1045;1045;0;0;1026
130676000;6;61119;                        Travanca de Lagos;1296;637;659;1220;596;624;495;1;411;860;860;0;1;830
130754000;6;61120;                        Vila Pouca da Beira;355;165;190;335;155;180;140;0;111;334;334;0;1;334
130776000;6;61121;                        Vila Franca da Beira;465;227;238;448;212;236;203;0;147;346;346;0;1;337
130801000;5;612;                    Pampilhosa da Serra;4481;2065;2416;4346;2001;2345;2029;6;1420;5659;5658;1;22;5455
130802000;6;61201;                        Cabril;231;110;121;225;107;118;119;0;73;452;451;1;0;442
130838000;6;61202;                        Dornelas do Zêzere;682;323;359;621;285;336;275;3;196;452;452;0;4;450
130863000;6;61203;                        Fajão;233;106;127;215;100;115;118;1;69;544;544;0;3;525
130892000;6;61204;                        Janeiro de Baixo;669;332;337;620;305;315;326;0;226;675;675;0;2;669
130924000;6;61205;                        Machio;126;59;67;118;55;63;63;0;50;227;227;0;1;228
130938000;6;61206;                        Pampilhosa da Serra;1389;602;787;1396;614;782;573;2;409;1764;1764;0;5;1608
131035000;6;61207;                        Pessegueiro;228;99;129;240;108;132;114;0;82;370;370;0;5;372
131058000;6;61208;                        Portela do Fojo;381;174;207;372;171;201;180;0;130;539;539;0;0;538
131083000;6;61209;                        Unhais-o-Velho;458;224;234;455;220;235;215;0;160;486;486;0;2;486
131109000;6;61210;                        Vidual;84;36;48;84;36;48;46;0;25;150;150;0;0;137
131115000;5;614;                    Penela;5983;2841;3142;5794;2715;3079;2361;9;1802;4698;4697;1;13;4551
131116000;6;61401;                        Cumeeira;1072;503;569;995;466;529;421;0;328;827;827;0;1;820
131166000;6;61402;                        Espinhal;775;357;418;747;337;410;314;4;220;788;788;0;4;782
131248000;6;61403;                        Podentes;485;235;250;469;228;241;198;0;160;343;343;0;0;342
131294000;6;61404;                        Rabaçal;291;145;146;274;135;139;127;0;98;232;232;0;1;233
131336000;6;61405;                        Penela (Santa Eufémia);1760;813;947;1755;798;957;644;5;509;1222;1221;1;6;1116
131486000;6;61406;                        Penela (São Miguel);1600;788;812;1554;751;803;657;0;487;1286;1286;0;1;1258
131650000;5;616;                    Tábua;12071;5743;6328;11643;5474;6169;4554;6;3705;8729;8722;7;14;7856
131651000;6;61601;                        Ázere;686;320;366;662;303;359;231;1;187;532;532;0;1;527
131705000;6;61602;                        Candosa;689;330;359;668;319;349;267;1;220;429;428;1;1;424
131766000;6;61603;                        Carapinha;402;190;212;389;184;205;147;0;122;265;265;0;1;262
131792000;6;61604;                        Covas;1085;529;556;1043;499;544;414;0;341;912;910;2;1;893
131877000;6;61605;                        Covelo;247;120;127;233;110;123;85;0;76;172;172;0;0;170
131894000;6;61606;                        Espariz;633;314;319;613;314;299;241;0;204;454;454;0;0;433
131938000;6;61607;                        Meda de Mouros;213;106;107;201;97;104;81;0;66;169;169;0;0;168
131956000;6;61608;                        Midões;1725;832;893;1660;791;869;673;0;539;1211;1211;0;1;1181
132060000;6;61609;                        Mouronho;840;405;435;780;377;403;313;0;263;676;676;0;0;674
132141000;6;61610;                        Pinheiro de Coja;308;142;166;306;143;163;133;0;95;270;268;2;0;263
132162000;6;61611;                        Póvoa de Midões;582;274;308;553;258;295;210;0;182;393;393;0;0;391
132188000;6;61612;                        São João da Boa Vista;453;229;224;443;221;222;182;0;143;329;329;0;0;325
132227000;6;61613;                        Sinde;373;173;200;370;168;202;166;0;116;302;302;0;0;301
132271000;6;61614;                        Tábua;3542;1641;1901;3444;1565;1879;1285;4;1057;2318;2318;0;8;1551
132428000;6;61615;                        Vila Nova de Oliveirinha;293;138;155;278;125;153;126;0;94;297;295;2;1;293
132455000;5;617;                    Vila Nova de Poiares;7281;3485;3796;6946;3257;3689;2751;6;2211;4556;4549;7;8;3926
132456000;6;61701;                        Arrifana;1440;683;757;1348;633;715;570;0;457;960;960;0;0;958
132548000;6;61702;                        Lavegadas;204;93;111;198;91;107;90;0;65;196;196;0;0;196
132566000;6;61703;                        Poiares (Santo André);4306;2062;2244;4120;1918;2202;1591;4;1284;2570;2564;6;6;1972
132746000;6;61704;                        São Miguel de Poiares;1331;647;684;1280;615;665;500;2;405;830;829;1;2;800
132837000;5;1002;                    Alvaiázere;7287;3406;3881;6979;3229;3750;3017;6;2190;5722;5715;7;8;5472
132838000;6;100201;                        Almoster;674;309;365;646;295;351;316;0;202;574;574;0;0;571
132936000;6;100202;                        Alvaiázere;1693;780;913;1581;708;873;662;3;490;1141;1136;5;4;954
133086000;6;100203;                        Maçãs de Caminho;356;176;180;342;169;173;149;0;105;317;317;0;0;314
133142000;6;100204;                        Maçãs de Dona Maria;1835;859;976;1766;828;938;746;3;539;1362;1362;0;3;1354
133330000;6;100205;                        Pelmá;736;356;380;712;338;374;334;0;228;852;850;2;0;847
133456000;6;100206;                        Pussos;1139;520;619;1093;495;598;467;0;353;819;819;0;0;788
133586000;6;100207;                        Rego da Murta;854;406;448;839;396;443;343;0;273;657;657;0;1;644
133684000;5;1003;                    Ansião;13128;6187;6941;12592;5860;6732;5154;9;4040;8433;8427;6;18;7718
133685000;6;100301;                        Alvorge;1227;566;661;1164;530;634;459;2;374;731;731;0;2;730
133816000;6;100302;                        Ansião;2728;1296;1432;2554;1199;1355;1038;1;835;1573;1572;1;7;1267
133985000;6;100303;                        Avelar;2169;1028;1141;2084;980;1104;846;3;683;1306;1304;2;5;985
134068000;6;100304;                        Chão de Couce;1992;921;1071;1975;883;1092;768;2;602;1257;1256;1;2;1227
134242000;6;100305;                        Lagarteira;504;228;276;488;216;272;187;0;153;247;246;1;0;246
134288000;6;100306;                        Pousaflores;950;439;511;916;418;498;402;0;303;823;822;1;0;819
134395000;6;100307;                        Santiago da Guarda;3147;1516;1631;3007;1447;1560;1295;1;966;2296;2296;0;2;2244
134639000;6;100308;                        Torre de Vale de Todos;411;193;218;404;187;217;159;0;124;200;200;0;0;200
134685000;5;1007;                    Castanheira de Pêra;3191;1520;1671;3099;1460;1639;1332;4;1001;2717;2716;1;13;2521
134686000;6;100701;                        Castanheira de Pêra;3091;1467;1624;3001;1409;1592;1288;4;970;2501;2501;0;12;2306
134993000;6;100702;                        Coentral;100;53;47;98;51;47;44;0;31;216;215;1;1;215
135032000;5;1008;                    Figueiró dos Vinhos;6169;2892;3277;5933;2751;3182;2581;5;1898;4858;4856;2;13;4560
135033000;6;100801;                        Aguda;1106;517;589;1067;499;568;470;0;343;972;971;1;0;956
135155000;6;100802;                        Arega;870;408;462;850;393;457;358;1;254;632;632;0;2;632
135234000;6;100803;                        Campelo;278;128;150;267;120;147;140;0;85;693;692;1;0;689
135302000;6;100804;                        Figueiró dos Vinhos;3428;1615;1813;3285;1528;1757;1394;4;1066;2184;2184;0;11;1910
135537000;6;100805;                        Bairradas;487;224;263;464;211;253;219;0;150;377;377;0;0;373
135609000;5;1013;                    Pedrógão Grande;3915;1851;2064;3820;1785;2035;1668;1;1189;3656;3649;7;6;3436
135610000;6;101301;                        Graça;786;381;405;771;373;398;353;0;246;792;791;1;0;780
135773000;6;101302;                        Pedrógão Grande;2550;1196;1354;2486;1149;1337;1054;1;763;2266;2260;6;6;2066
136010000;6;101303;                        Vila Facaia;579;274;305;563;263;300;261;0;180;598;598;0;0;590
136132000;4;165;                Dão-Lafões;277240;131554;145686;268129;125514;142615;104725;125;85605;173850;173681;169;348;145974
136133000;5;901;                    Aguiar da Beira;5473;2580;2893;5314;2498;2816;2111;8;1659;4878;4874;4;14;4704
136134000;6;90101;                        Aguiar da Beira;1473;702;771;1427;675;752;515;5;437;998;998;0;6;834
136240000;6;90102;                        Carapito;442;206;236;423;195;228;162;0;133;320;320;0;0;319
136283000;6;90103;                        Cortiçada;341;157;184;340;157;183;146;0;107;470;470;0;0;466
136315000;6;90104;                        Coruche;158;74;84;156;72;84;71;0;57;307;307;0;0;307
136329000;6;90105;                        Dornelas;690;329;361;668;317;351;245;2;189;573;573;0;1;574
136378000;6;90106;                        Eirado;230;106;124;217;100;117;89;0;69;198;198;0;0;198
136404000;6;90107;                        Forninhos;222;101;121;223;101;122;99;0;76;228;228;0;2;230
136434000;6;90108;                        Gradiz;159;78;81;157;79;78;66;0;49;188;188;0;0;187
136448000;6;90109;                        Pena Verde;813;379;434;791;370;421;306;1;242;578;575;3;1;573
136499000;6;90110;                        Pinheiro;232;113;119;224;108;116;102;0;77;254;254;0;1;253
136532000;6;90111;                        Sequeiros;262;123;139;246;115;131;113;0;84;266;265;1;3;266
136551000;6;90112;                        Souto de Aguiar da Beira;297;139;158;294;138;156;138;0;90;291;291;0;0;291
136576000;6;90113;                        Valverde;154;73;81;148;71;77;59;0;49;207;207;0;0;206
136594000;5;1802;                    Carregal do Sal;9835;4664;5171;9428;4399;5029;3772;8;3069;6672;6671;1;10;6105
136595000;6;180201;                        Beijós;975;477;498;903;434;469;394;0;307;710;710;0;0;701
136641000;6;180202;                        Cabanas de Viriato;1533;710;823;1448;661;787;589;1;490;1129;1129;0;1;1100
136698000;6;180203;                        Currelos;2447;1168;1279;2377;1121;1256;903;4;734;1510;1510;0;5;1070
136765000;6;180204;                        Oliveira do Conde;3122;1469;1653;3024;1390;1634;1204;2;976;2062;2061;1;3;1979
136889000;6;180205;                        Papízios;679;325;354;645;301;344;262;0;219;508;508;0;0;506
136935000;6;180206;                        Parada;806;387;419;767;367;400;312;1;251;574;574;0;1;574
136975000;6;180207;                        Sobral;273;128;145;264;125;139;108;0;92;179;179;0;0;175
137000000;5;1803;                    Castro Daire;15339;7370;7969;14773;7014;7759;5971;4;4676;12540;12530;10;17;11617
137001000;6;180301;                        Almofala;228;111;117;210;100;110;104;0;71;265;265;0;0;261
137037000;6;180302;                        Alva;479;231;248;463;219;244;196;0;153;348;348;0;2;347
137070000;6;180303;                        Cabril;414;204;210;392;193;199;171;0;125;442;442;0;0;439
137097000;6;180304;                        Castro Daire;4674;2210;2464;4425;2072;2353;1649;3;1390;3044;3035;9;7;2197
137297000;6;180305;                        Cujó;299;136;163;288;131;157;126;0;92;279;279;0;0;277
137347000;6;180306;                        Ermida;257;124;133;256;124;132;116;0;81;292;292;0;0;285
137382000;6;180307;                        Ester;220;108;112;222;111;111;98;0;65;250;250;0;0;248
137412000;6;180308;                        Gafanhão;128;59;69;130;60;70;63;0;39;207;207;0;0;206
137432000;6;180309;                        Gosende;426;200;226;423;195;228;189;0;125;599;599;0;2;601
137481000;6;180310;                        Mamouros;679;327;352;729;334;395;243;0;208;456;456;0;3;422
137535000;6;180311;                        Mezio;484;259;225;428;216;212;165;0;129;349;349;0;0;348
137587000;6;180312;                        Mões;1844;891;953;1794;857;937;709;0;584;1525;1525;0;2;1525
137696000;6;180313;                        Moledo;1215;585;630;1183;567;616;515;0;408;1092;1092;0;0;1088
137774000;6;180314;                        Monteiras;481;239;242;450;222;228;189;0;142;455;455;0;0;455
137835000;6;180315;                        Moura Morta;134;64;70;122;57;65;56;0;39;129;129;0;0;127
137856000;6;180316;                        Parada de Ester;654;327;327;614;305;309;276;0;197;600;600;0;0;600
137913000;6;180317;                        Pepim;334;163;171;320;157;163;145;0;105;260;260;0;0;255
137936000;6;180318;                        Picão;278;132;146;278;129;149;98;0;76;234;234;0;0;232
137956000;6;180319;                        Pinheiro;730;340;390;722;333;389;350;1;230;700;700;0;1;693
138008000;6;180320;                        Reriz;755;365;390;739;356;383;278;0;226;537;537;0;0;535
138062000;6;180321;                        Ribolhos;266;123;143;253;114;139;103;0;85;170;170;0;0;169
138081000;6;180322;                        São Joaninho;360;172;188;332;162;170;132;0;106;307;306;1;0;307
138110000;5;1806;                    Mangualde;19880;9559;10321;18863;8913;9950;7666;5;6229;13127;13113;14;17;11589
138111000;6;180601;                        Abrunhosa-a-Velha;563;266;297;550;260;290;237;0;180;396;396;0;1;395
138147000;6;180602;                        Alcafache;921;441;480;857;405;452;337;0;303;607;607;0;3;603
138183000;6;180603;                        Chãs de Tavares;1040;493;547;1003;472;531;427;0;315;831;831;0;1;829
138237000;6;180604;                        Cunha Alta;139;57;82;134;55;79;59;0;47;115;115;0;0;114
138250000;6;180605;                        Cunha Baixa;884;423;461;842;399;443;371;0;288;711;711;0;0;706
138313000;6;180606;                        Espinho;984;478;506;943;452;491;377;0;325;752;751;1;0;748
138370000;6;180607;                        Fornos de Maceira Dão;1459;718;741;1395;683;712;541;0;480;898;897;1;0;888
138446000;6;180608;                        Freixiosa;257;114;143;253;113;140;97;1;77;263;263;0;1;264
138465000;6;180609;                        Lobelhe do Mato;259;126;133;251;121;130;98;0;84;181;181;0;0;180
138477000;6;180610;                        Mangualde;9389;4534;4855;8830;4165;4665;3608;3;2903;5378;5368;10;8;3914
138767000;6;180611;                        Mesquitela;879;436;443;817;399;418;308;0;253;527;527;0;0;511
138811000;6;180612;                        Moimenta de Maceira Dão;514;255;259;507;252;255;188;0;161;268;268;0;0;264
138830000;6;180613;                        Póvoa de Cervães;188;96;92;169;85;84;81;0;59;156;156;0;0;156
138849000;6;180614;                        Quintela de Azurara;542;256;286;503;232;271;206;0;178;360;360;0;1;351
138882000;6;180615;                        Santiago de Cassurrães;1226;564;662;1177;528;649;461;1;376;978;976;2;2;965
138958000;6;180616;                        São João da Fresta;208;99;109;227;106;121;95;0;62;225;225;0;0;225
138983000;6;180617;                        Travanca de Tavares;114;53;61;106;48;58;50;0;36;185;185;0;0;181
138997000;6;180618;                        Várzea de Tavares;314;150;164;299;138;161;125;0;102;296;296;0;0;295
139023000;5;1808;                    Mortágua;9607;4621;4986;9210;4392;4818;3773;4;3063;6012;6007;5;7;5542
139024000;6;180801;                        Almaça;84;37;47;120;56;64;39;0;29;227;227;0;1;152
139036000;6;180802;                        Cercosa;303;148;155;282;136;146;113;0;100;203;203;0;0;203
139060000;6;180803;                        Cortegaça;437;208;229;430;205;225;182;0;145;264;264;0;0;259
139104000;6;180804;                        Espinho;1105;528;577;1061;502;559;451;0;366;746;746;0;0;742
139231000;6;180805;                        Marmeleira;503;233;270;484;222;262;186;1;153;323;323;0;1;323
139277000;6;180806;                        Mortágua;2793;1333;1460;2622;1233;1389;1130;2;869;1636;1634;2;3;1290
139400000;6;180807;                        Pala;1016;508;508;968;480;488;386;0;319;567;567;0;0;561
139486000;6;180808;                        Sobral;2311;1117;1194;2237;1072;1165;847;1;732;1331;1329;2;2;1298
139598000;6;180809;                        Trezói;377;188;189;356;174;182;157;0;122;269;269;0;0;269
139641000;6;180810;                        Vale de Remígio;678;321;357;650;312;338;282;0;228;446;445;1;0;445
139692000;5;1809;                    Nelas;14037;6676;7361;13675;6438;7237;5419;7;4426;8753;8732;21;25;7398
139693000;6;180901;                        Canas de Senhorim;3509;1681;1828;3301;1555;1746;1329;2;1112;2021;2021;0;8;1728
139805000;6;180902;                        Carvalhal Redondo;974;468;506;953;456;497;384;0;319;642;642;0;0;642
139845000;6;180903;                        Nelas;4702;2264;2438;4686;2242;2444;1787;4;1456;2816;2795;21;15;1799
139986000;6;180904;                        Santar;1042;496;546;1028;486;542;405;0;327;701;701;0;1;670
140042000;6;180905;                        Senhorim;1156;515;641;1132;500;632;458;0;370;837;837;0;0;836
140140000;6;180906;                        Vilar Seco;745;371;374;732;362;370;317;0;244;514;514;0;0;507
140191000;6;180907;                        Aguieira;558;258;300;542;249;293;229;0;183;356;356;0;0;355
140219000;6;180908;                        Lapa do Lobo;756;349;407;729;329;400;281;1;226;408;408;0;1;404
140243000;6;180909;                        Moreira;595;274;321;572;259;313;229;0;189;458;458;0;0;457
140282000;5;1810;                    Oliveira de Frades;10261;4868;5393;9861;4609;5252;3628;3;3115;5669;5666;3;10;4898
140283000;6;181001;                        Arca;359;177;182;335;167;168;130;0;112;204;204;0;0;204
140326000;6;181002;                        Arcozelo das Maias;1364;659;705;1316;621;695;466;0;434;671;671;0;0;653
140446000;6;181003;                        Destriz;347;161;186;325;147;178;118;0;106;214;214;0;0;214
140486000;6;181004;                        Oliveira de Frades;2882;1367;1515;2743;1287;1456;1040;3;871;1610;1608;2;5;962
140598000;6;181005;                        Pinheiro;1277;609;668;1222;576;646;445;0;381;702;702;0;1;650
140712000;6;181006;                        Reigoso;341;156;185;331;153;178;118;0;99;186;186;0;0;184
140749000;6;181007;                        Ribeiradio;1011;470;541;976;450;526;362;0;301;633;633;0;0;630
140845000;6;181008;                        São João da Serra;524;236;288;487;215;272;196;0;165;308;308;0;0;308
140890000;6;181009;                        São Vicente de Lafões;756;355;401;718;337;381;265;0;236;387;387;0;1;388
140955000;6;181010;                        Sejães;200;103;97;182;96;86;66;0;52;131;131;0;2;132
140980000;6;181011;                        Souto de Lafões;841;401;440;876;393;483;284;0;250;375;374;1;1;330
141032000;6;181012;                        Varzielas;359;174;185;350;167;183;138;0;108;248;248;0;0;243
141085000;5;1811;                    Penalva do Castelo;7956;3815;4141;7607;3599;4008;3054;5;2472;5443;5441;2;9;5132
141086000;6;181101;                        Antas;284;134;150;257;120;137;118;0;80;276;276;0;0;274
141118000;6;181102;                        Castelo de Penalva;914;440;474;910;434;476;353;1;288;630;630;0;2;622
141208000;6;181103;                        Esmolfe;417;200;217;407;194;213;167;0;131;313;313;0;0;306
141239000;6;181104;                        Germil;427;207;220;403;188;215;146;1;125;260;260;0;1;261
141271000;6;181105;                        Ínsua;2045;968;1077;1944;904;1040;757;3;631;1238;1238;0;6;971
141356000;6;181106;                        Lusinde;189;88;101;175;80;95;79;0;62;162;162;0;0;161
141387000;6;181107;                        Mareco;106;45;61;104;44;60;51;0;34;111;111;0;0;111
141408000;6;181108;                        Matela;189;93;96;177;85;92;79;0;64;229;229;0;0;229
141424000;6;181109;                        Pindo;1916;949;967;1814;889;925;707;0;590;1101;1099;2;0;1086
141505000;6;181110;                        Real;263;123;140;253;117;136;111;0;91;179;179;0;0;176
141524000;6;181111;                        Sezures;726;345;381;706;334;372;279;0;217;570;570;0;0;565
141574000;6;181112;                        Trancozelos;269;121;148;264;120;144;103;0;85;157;157;0;0;155
141596000;6;181113;                        Vila Cova do Covelo;211;102;109;193;90;103;104;0;74;217;217;0;0;215
141623000;5;1814;                    Santa Comba Dão;11597;5466;6131;11089;5112;5977;4451;6;3659;7086;7080;6;10;6434
141624000;6;181401;                        Couto do Mosteiro;1186;565;621;1145;539;606;464;0;382;713;713;0;0;683
141705000;6;181402;                        Ovoa;837;392;445;797;367;430;319;0;276;513;511;2;0;506
141754000;6;181403;                        Pinheiro de Ázere;937;444;493;869;391;478;359;0;299;593;593;0;0;585
141800000;6;181404;                        Santa Comba Dão;3386;1597;1789;3253;1500;1753;1256;3;1052;1892;1892;0;4;1316
141894000;6;181405;                        São Joaninho;1075;497;578;1025;465;560;409;1;326;624;624;0;1;622
141968000;6;181406;                        São João de Areias;1939;915;1024;1856;857;999;755;1;601;1245;1242;3;3;1233
142061000;6;181407;                        Treixedo;987;471;516;946;444;502;391;0;328;705;704;1;0;701
142097000;6;181408;                        Vimieiro;803;376;427;768;348;420;318;1;245;495;495;0;2;482
142147000;6;181409;                        Nagozela;447;209;238;430;201;229;180;0;150;306;306;0;0;306
142170000;5;1816;                    São Pedro do Sul;16851;7891;8960;16601;7609;8992;6407;3;5204;11574;11564;10;88;10374
142171000;6;181601;                        Baiões;286;145;141;266;136;130;102;0;83;157;157;0;2;158
142194000;6;181602;                        Bordonhos;547;269;278;517;253;264;184;0;165;295;295;0;0;290
142238000;6;181603;                        Candal;118;52;66;118;54;64;55;0;38;123;123;0;0;123
142254000;6;181604;                        Carvalhais;1436;694;742;1412;648;764;548;0;456;1011;1007;4;4;988
142352000;6;181605;                        Covas do Rio;120;55;65;120;56;64;54;0;41;122;122;0;0;122
142370000;6;181606;                        Figueiredo de Alva;816;395;421;744;347;397;306;0;258;488;488;0;0;486
142439000;6;181607;                        Manhouce;647;279;368;613;256;357;232;0;196;377;377;0;3;378
142495000;6;181608;                        Pindelo dos Milagres;659;291;368;633;281;352;275;0;213;473;473;0;0;465
142533000;6;181609;                        Pinho;777;362;415;753;353;400;302;0;248;434;432;2;0;431
142592000;6;181610;                        Santa Cruz da Trapa;1313;608;705;1240;560;680;500;0;408;869;868;1;4;808
142674000;6;181611;                        São Cristóvão de Lafões;191;93;98;178;89;89;70;0;57;134;134;0;0;134
142697000;6;181612;                        São Félix;390;186;204;379;180;199;147;0;122;231;231;0;1;228
142733000;6;181613;                        São Martinho das Moitas;251;118;133;248;115;133;112;0;86;389;389;0;0;386
142775000;6;181614;                        São Pedro do Sul;3697;1724;1973;3567;1673;1894;1337;2;1104;2173;2172;1;8;1554
142915000;6;181615;                        Serrazes;1001;463;538;984;446;538;378;0;310;679;679;0;3;680
142998000;6;181616;                        Sul;1090;507;583;1038;479;559;489;0;348;1092;1091;1;1;1082
143113000;6;181617;                        Valadares;805;357;448;722;307;415;323;0;247;635;635;0;0;628
143181000;6;181618;                        Várzea;1745;827;918;2165;946;1219;657;0;519;1328;1327;1;61;876
143263000;6;181619;                        Vila Maior;962;466;496;904;430;474;336;1;305;564;564;0;1;557
143355000;5;1817;                    Sátão;12444;5905;6539;11879;5554;6325;4557;6;3759;9281;9261;20;12;8424
143356000;6;181701;                        Águas Boas;172;87;85;167;81;86;73;0;55;170;170;0;0;170
143373000;6;181702;                        Avelal;529;228;301;503;215;288;145;2;127;272;272;0;2;271
143398000;6;181703;                        Decermilo;205;91;114;196;86;110;68;1;57;167;167;0;1;168
143413000;6;181704;                        Ferreira de Aves;2464;1166;1298;2316;1075;1241;990;0;759;1740;1736;4;3;1725
143574000;6;181705;                        Forles;65;35;30;62;32;30;33;0;22;76;76;0;0;76
143583000;6;181706;                        Mioma;1217;586;631;1150;547;603;420;1;360;793;778;15;1;751
143654000;6;181707;                        Rio de Moinhos;942;430;512;901;407;494;379;1;290;752;752;0;1;752
143723000;6;181708;                        Romãs;868;406;462;809;376;433;346;0;275;1062;1062;0;0;1059
143797000;6;181709;                        São Miguel de Vila Boa;1334;651;683;1281;614;667;452;0;408;938;938;0;0;936
143860000;6;181710;                        Sátão;4007;1896;2111;3855;1794;2061;1388;1;1194;2638;2638;0;3;1848
144038000;6;181711;                        Silvã de Cima;455;241;214;449;236;213;183;0;146;431;430;1;1;429
144078000;6;181712;                        Vila Longa;186;88;98;190;91;99;80;0;66;242;242;0;0;239
144097000;5;1821;                    Tondela;28946;13730;15216;27746;13043;14703;11038;14;9028;17673;17666;7;26;16328
144098000;6;182101;                        Barreiro de Besteiros;975;460;515;937;439;498;376;0;318;562;562;0;0;561
144151000;6;182102;                        Campo de Besteiros;1474;723;751;1398;680;718;570;2;465;841;841;0;6;695
144212000;6;182103;                        Canas de Santa Maria;1806;857;949;1745;821;924;665;1;565;1095;1094;1;1;1085
144280000;6;182104;                        Caparrosa;805;381;424;765;355;410;310;1;243;514;514;0;1;515
144325000;6;182105;                        Castelões;1542;703;839;1479;665;814;611;1;469;1049;1049;0;1;1044
144416000;6;182106;                        Dardavaz;782;374;408;729;342;387;311;0;255;493;493;0;1;488
144462000;6;182107;                        Ferreirós do Dão;441;210;231;371;174;197;182;0;136;328;328;0;0;328
144481000;6;182108;                        Guardão;1490;706;784;1492;702;790;466;5;372;775;775;0;7;709
144538000;6;182109;                        Lajeosa;1940;942;998;1877;901;976;754;0;615;1237;1236;1;2;1236
144606000;6;182110;                        Lobão da Beira;1124;547;577;1079;518;561;441;0;352;636;635;1;0;631
144649000;6;182111;                        Molelos;2346;1098;1248;2222;1039;1183;897;0;763;1458;1458;0;0;1424
144754000;6;182112;                        Mosteirinho;217;108;109;200;98;102;81;0;70;98;98;0;0;98
144773000;6;182113;                        Mosteiro de Fráguas;590;273;317;563;259;304;232;0;185;348;347;1;0;343
144789000;6;182114;                        Mouraz;878;408;470;862;394;468;352;0;290;620;620;0;0;613
144838000;6;182115;                        Nandufe;622;294;328;585;277;308;242;0;208;330;330;0;0;318
144864000;6;182116;                        Parada de Gonta;754;358;396;711;336;375;287;0;250;514;514;0;0;514
144887000;6;182117;                        Sabugosa;545;265;280;526;251;275;215;0;175;377;377;0;0;377
144899000;6;182118;                        Santiago de Besteiros;1331;657;674;1287;632;655;489;1;414;830;827;3;1;822
144958000;6;182119;                        São João do Monte;862;429;433;805;395;410;337;0;269;576;576;0;0;575
145003000;6;182120;                        São Miguel do Outeiro;913;435;478;867;411;456;329;0;293;511;511;0;0;508
145030000;6;182121;                        Silvares;136;63;73;131;61;70;60;0;43;208;208;0;0;208
145042000;6;182122;                        Tonda;984;459;525;926;426;500;381;0;301;631;631;0;0;607
145088000;6;182123;                        Tondela;4508;2087;2421;4360;2008;2352;1741;3;1379;2515;2515;0;6;1517
145194000;6;182124;                        Vila Nova da Rainha;476;226;250;465;219;246;186;0;149;314;314;0;0;312
145217000;6;182125;                        Vilar de Besteiros;893;421;472;868;402;466;338;0;288;539;539;0;0;527
145251000;6;182126;                        Tourigo;512;246;266;496;238;258;185;0;161;274;274;0;0;273
145277000;5;1822;                    Vila Nova de Paiva;5176;2463;2713;4824;2250;2574;1944;3;1534;4378;4378;0;7;4152
145278000;6;182201;                        Alhais;522;246;276;503;236;267;200;0;162;430;430;0;0;425
145324000;6;182202;                        Fráguas;217;105;112;232;111;121;91;0;69;315;315;0;0;310
145357000;6;182203;                        Pendilhe;546;282;264;510;257;253;201;0;159;422;422;0;1;416
145409000;6;182204;                        Queiriga;575;266;309;551;254;297;245;1;183;790;790;0;1;787
145460000;6;182205;                        Touro;918;425;493;863;389;474;341;0;276;701;701;0;0;698
145521000;6;182206;                        Vila Cova à Coelheira;1109;533;576;916;419;497;401;1;314;805;805;0;1;803
145595000;6;182207;                        Vila Nova de Paiva;1289;606;683;1249;584;665;465;1;371;915;915;0;4;713
145660000;5;1823;                    Viseu;99274;46915;52359;97245;45389;51856;37052;45;30448;54060;54008;52;84;36820
145661000;6;182301;                        Abraveses;8539;4083;4456;8110;3817;4293;3100;2;2628;4133;4133;0;3;2393
145780000;6;182302;                        Barreiros;300;142;158;294;138;156;121;0;95;240;240;0;0;240
145814000;6;182303;                        Boa Aldeia;518;248;270;506;241;265;205;1;156;332;332;0;1;333
145845000;6;182304;                        Bodiosa;3047;1474;1573;2913;1399;1514;1097;0;946;1604;1603;1;0;1556
145957000;6;182305;                        Calde;1469;699;770;1438;672;766;555;1;473;1032;1032;0;1;1026
146045000;6;182306;                        Campo;5025;2480;2545;4752;2321;2431;1784;2;1555;2603;2601;2;4;2257
146160000;6;182307;                        Cavernães;1348;650;698;1303;625;678;475;0;434;784;784;0;1;771
146209000;6;182308;                        Cepões;1284;599;685;1235;574;661;502;0;416;919;919;0;0;917
146309000;6;182309;                        Viseu (Coração de Jesus);11245;5094;6151;11249;5074;6175;4725;8;3325;7008;7006;2;16;1222
146410000;6;182310;                        Cota;974;447;527;963;443;520;379;1;306;833;833;0;1;832
146510000;6;182311;                        Couto de Baixo;756;347;409;727;332;395;275;1;230;436;436;0;1;434
146549000;6;182312;                        Couto de Cima;851;420;431;793;386;407;315;1;273;506;506;0;1;503
146596000;6;182313;                        Fail;664;340;324;634;322;312;239;0;215;363;363;0;0;359
146611000;6;182314;                        Farminhão;750;339;411;726;324;402;271;1;235;429;429;0;1;427
146647000;6;182315;                        Fragosela;2662;1299;1363;2561;1247;1314;925;0;834;1142;1142;0;0;1047
146699000;6;182316;                        Lordosa;1791;804;987;1771;788;983;662;1;565;1052;1052;0;2;1047
146801000;6;182317;                        Silgueiros;3250;1521;1729;3153;1453;1700;1184;1;1051;1904;1902;2;3;1890
146904000;6;182318;                        Mundão;2385;1190;1195;2298;1138;1160;828;0;739;1103;1103;0;0;873
146975000;6;182319;                        Orgens;3489;1675;1814;3308;1571;1737;1220;0;1084;1542;1541;1;1;1409
147055000;6;182320;                        Povolide;1747;836;911;1692;807;885;642;1;554;1091;1091;0;3;1064
147123000;6;182321;                        Ranhados;4949;2332;2617;5038;2328;2710;1882;2;1496;2555;2549;6;4;1039
147213000;6;182322;                        Ribafeita;1227;587;640;1146;541;605;467;0;401;861;860;1;0;853
147273000;6;182323;                        Rio de Loba;9348;4526;4822;8836;4229;4607;3214;3;2870;4245;4242;3;6;3379
147434000;6;182324;                        Viseu (Santa Maria de Viseu);6790;3088;3702;7468;3298;4170;2708;11;1904;4210;4208;2;20;1422
147535000;6;182325;                        Santos Evos;1569;711;858;1524;685;839;584;0;512;873;873;0;0;853
147587000;6;182326;                        São Cipriano;1283;611;672;1225;572;653;440;0;395;648;648;0;1;642
147639000;6;182327;                        São João de Lourosa;4702;2281;2421;4494;2162;2332;1605;0;1465;2217;2197;20;1;2166
147746000;6;182328;                        Viseu (São José);5395;2459;2936;5302;2349;2953;2251;3;1676;3285;3284;1;4;1410
147826000;6;182329;                        São Pedro de France;1370;637;733;1326;611;715;516;1;414;808;808;0;2;807
147899000;6;182330;                        São Salvador;3807;1789;2018;3706;1727;1979;1408;1;1156;1777;1777;0;1;964
147941000;6;182331;                        Torredeita;1555;715;840;1476;666;810;602;1;451;994;983;11;1;960
148002000;6;182332;                        Vil de Souto;667;308;359;646;298;348;237;0;207;335;335;0;0;325
148039000;6;182333;                        Vila Chã de Sá;2009;982;1027;1891;916;975;669;0;630;880;880;0;1;806
148080000;6;182334;                        Repeses;2509;1202;1307;2741;1335;1406;965;2;757;1316;1316;0;4;594
148118000;5;1824;                    Vouzela;10564;5031;5533;10014;4695;5319;3882;4;3264;6704;6690;14;12;6457
148119000;6;182401;                        Alcofra;1025;495;530;959;457;502;371;0;328;732;732;0;0;727
148193000;6;182402;                        Cambra;1244;588;656;1170;545;625;474;1;356;837;833;4;3;834
148255000;6;182403;                        Campia;1542;748;794;1421;682;739;550;0;468;842;840;2;1;840
148323000;6;182404;                        Carvalhal de Vermilhas;215;105;110;202;99;103;73;0;69;227;227;0;0;227
148338000;6;182405;                        Fataunços;751;354;397;700;320;380;269;0;238;444;443;1;0;438
148376000;6;182406;                        Figueiredo das Donas;352;173;179;342;163;179;136;0;115;210;210;0;0;209
148397000;6;182407;                        Fornelo do Monte;288;137;151;288;137;151;113;0;91;278;278;0;0;277
148422000;6;182408;                        Paços de Vilharigues;647;315;332;603;292;311;230;0;206;336;336;0;0;336
148459000;6;182409;                        Queirã;1432;680;752;1350;623;727;521;0;445;880;878;2;0;877
148546000;6;182410;                        São Miguel do Mato;924;457;467;880;428;452;349;0;297;611;610;1;1;600
148601000;6;182411;                        Ventosa;794;376;418;753;358;395;310;0;249;568;568;0;0;567
148661000;6;182412;                        Vouzela;1350;603;747;1346;591;755;486;3;402;739;735;4;7;525
148694000;4;166;                Pinhal Interior Sul;40705;19321;21384;38497;18083;20414;16806;35;12372;33162;33150;12;64;30618
148695000;5;506;                    Oleiros;5721;2721;3000;5205;2438;2767;2481;4;1793;4975;4974;1;15;4699
148696000;6;50601;                        Álvaro;237;110;127;222;103;119;117;0;79;296;296;0;2;298
148723000;6;50602;                        Amieira;116;55;61;118;56;62;58;0;41;202;202;0;0;201
148741000;6;50603;                        Cambas;309;143;166;292;132;160;158;0;111;454;454;0;0;454
148784000;6;50604;                        Estreito;897;439;458;845;405;440;400;1;302;730;730;0;2;725
148863000;6;50605;                        Isna;209;102;107;163;76;87;89;0;68;145;145;0;0;145
148887000;6;50606;                        Madeirã;171;77;94;164;72;92;80;0;50;194;193;1;1;194
148906000;6;50607;                        Mosteiro;307;152;155;278;137;141;148;0;88;308;308;0;0;308
148939000;6;50608;                        Oleiros;2306;1102;1204;1995;945;1050;919;2;715;1577;1577;0;9;1322
149100000;6;50609;                        Orvalho;678;298;380;643;275;368;276;1;186;533;533;0;1;518
149137000;6;50610;                        Sarnadas de São Simão;217;100;117;215;98;117;111;0;66;259;259;0;0;259
149160000;6;50611;                        Sobral;160;82;78;156;78;78;73;0;50;129;129;0;0;128
149179000;6;50612;                        Vilar Barroco;114;61;53;114;61;53;52;0;37;148;148;0;0;147
149197000;5;508;                    Proença-a-Nova;8314;3985;4329;7788;3674;4114;3382;6;2531;6267;6266;1;12;5702
149198000;6;50801;                        Alvito da Beira;362;173;189;343;163;180;189;0;116;440;440;0;0;436
149258000;6;50802;                        Montes da Senhora;748;335;413;726;319;407;361;0;228;814;814;0;0;809
149366000;6;50803;                        Peral;674;337;337;624;303;321;264;0;221;387;387;0;1;384
149431000;6;50804;                        Proença-a-Nova;4295;2060;2235;3999;1881;2118;1583;5;1254;2615;2614;1;7;2087
149663000;6;50805;                        São Pedro do Esteval;527;262;265;493;246;247;222;0;173;324;324;0;0;324
149736000;6;50806;                        Sobreira Formosa;1708;818;890;1603;762;841;763;1;539;1687;1687;0;4;1662
149942000;5;509;                    Sertã;15880;7546;8334;15042;7099;7943;6498;6;4858;11961;11953;8;9;10725
149943000;6;50901;                        Cabeçudo;957;452;505;910;432;478;384;0;285;653;653;0;0;641
149998000;6;50902;                        Carvalhal;465;203;262;451;196;255;203;0;140;342;342;0;0;335
150038000;6;50903;                        Castelo;1046;505;541;896;418;478;420;0;316;786;786;0;0;780
150112000;6;50904;                        Cernache do Bonjardim;3052;1451;1601;2886;1359;1527;1234;3;937;2496;2494;2;3;2224
150289000;6;50905;                        Cumeada;503;247;256;479;233;246;217;0;160;410;410;0;0;410
150327000;6;50906;                        Ermida;218;112;106;199;99;100;95;0;77;162;161;1;0;161
150354000;6;50907;                        Figueiredo;205;90;115;205;92;113;98;0;71;210;210;0;0;210
150369000;6;50908;                        Marmeleiro;228;101;127;205;90;115;105;0;72;215;215;0;0;214
150392000;6;50909;                        Nesperal;305;146;159;286;134;152;121;0;96;261;261;0;1;260
150421000;6;50910;                        Palhais;268;122;146;263;120;143;132;0;87;452;452;0;0;449
150463000;6;50911;                        Pedrógão Pequeno;753;359;394;723;352;371;348;0;239;645;645;0;1;643
150555000;6;50912;                        Sertã;6196;2946;3250;5899;2784;3115;2376;3;1865;4007;4003;4;4;3085
150799000;6;50913;                        Troviscal;864;422;442;857;422;435;373;0;259;686;685;1;0;679
150872000;6;50914;                        Várzea dos Cavaleiros;820;390;430;783;368;415;392;0;254;636;636;0;0;634
150932000;5;510;                    Vila de Rei;3452;1582;1870;3356;1525;1831;1330;8;950;2956;2956;0;13;2844
150933000;6;51001;                        Fundada;638;311;327;612;296;316;286;1;181;636;636;0;1;634
151053000;6;51002;                        São João do Peso;204;79;125;187;69;118;63;1;40;178;178;0;1;172
151086000;6;51003;                        Vila de Rei;2610;1192;1418;2557;1160;1397;981;6;729;2142;2142;0;11;2038
151480000;5;1413;                    Mação;7338;3487;3851;7106;3347;3759;3115;11;2240;7003;7001;2;15;6648
151481000;6;141301;                        Aboboreira;513;251;262;504;247;257;209;0;164;435;435;0;0;430
151546000;6;141302;                        Amêndoa;515;251;264;483;236;247;244;2;151;611;611;0;2;608
151657000;6;141303;                        Cardigos;1086;499;587;1089;491;598;481;3;328;1161;1161;0;4;1149
151846000;6;141304;                        Carvoeiro;620;303;317;588;282;306;252;1;192;498;498;0;1;497
151960000;6;141305;                        Envendos;984;468;516;953;453;500;426;2;297;1107;1106;1;2;1099
152149000;6;141306;                        Mação;2228;1055;1173;2151;1012;1139;895;1;691;1847;1847;0;2;1532
152341000;6;141307;                        Ortiga;590;278;312;579;271;308;246;1;183;455;454;1;3;453
152383000;6;141308;                        Penhascoso;802;382;420;759;355;404;362;1;234;889;889;0;1;880
152472000;4;167;                Serra da Estrela;43737;20609;23128;42082;19631;22451;17337;53;13553;32940;32919;21;211;28969
152473000;5;905;                    Fornos de Algodres;4989;2353;2636;4763;2227;2536;1995;6;1526;4045;4042;3;13;3787
152474000;6;90501;                        Algodres;349;168;181;334;163;171;148;0;107;308;308;0;0;306
152498000;6;90502;                        Casal Vasco;227;106;121;222;103;119;88;1;63;198;198;0;1;198
152519000;6;90503;                        Cortiçô;144;72;72;146;72;74;57;0;45;121;121;0;0;119
152529000;6;90504;                        Figueiró da Granja;414;206;208;401;191;210;165;0;124;355;355;0;3;343
152554000;6;90505;                        Fornos de Algodres;1627;742;885;1541;697;844;616;2;497;961;961;0;4;733
152622000;6;90506;                        Fuinhas;92;46;46;88;43;45;41;0;31;109;109;0;0;107
152634000;6;90507;                        Infias;242;119;123;228;111;117;83;0;73;171;171;0;0;168
152654000;6;90508;                        Juncais;284;137;147;272;132;140;121;0;87;253;253;0;1;246
152674000;6;90509;                        Maceira;229;112;117;216;109;107;100;0;73;263;263;0;0;263
152691000;6;90510;                        Matança;243;109;134;225;98;127;112;0;72;219;218;1;0;215
152708000;6;90511;                        Muxagata;241;114;127;231;109;122;87;1;71;240;240;0;1;241
152721000;6;90512;                        Queiriz;260;118;142;250;112;138;107;1;75;193;193;0;1;194
152743000;6;90513;                        Sobral Pichorro;208;109;99;191;99;92;90;0;68;207;207;0;0;207
152761000;6;90514;                        Vila Chã;82;38;44;79;37;42;33;0;25;79;78;1;0;78
152772000;6;90515;                        Vila Ruiva;168;72;96;167;71;96;70;1;52;189;189;0;2;190
152795000;6;90516;                        Vila Soeiro do Chão;179;85;94;172;80;92;77;0;63;179;178;1;0;179
152811000;5;906;                    Gouveia;14046;6500;7546;13551;6215;7336;5681;24;4341;11187;11184;3;70;10205
152812000;6;90601;                        Aldeias;328;145;183;297;132;165;136;1;97;270;269;1;5;269
152841000;6;90602;                        Arcozelo;717;316;401;708;308;400;300;1;202;643;643;0;1;635
152883000;6;90603;                        Cativelos;724;331;393;720;322;398;319;1;239;683;683;0;4;687
152939000;6;90604;                        Figueiró da Serra;263;116;147;248;110;138;109;0;89;366;366;0;1;367
152961000;6;90605;                        Folgosinho;499;234;265;490;229;261;209;1;139;541;541;0;12;550
153028000;6;90606;                        Freixo da Serra;99;47;52;88;41;47;39;1;24;144;144;0;2;146
153043000;6;90607;                        Lagarinhos;443;204;239;427;199;228;180;0;138;366;366;0;0;365
153084000;6;90608;                        Mangualde da Serra;164;78;86;161;75;86;71;0;53;162;162;0;2;160
153106000;6;90609;                        Melo;498;242;256;472;229;243;212;2;163;494;494;0;3;493
153143000;6;90610;                        Moimenta da Serra;652;292;360;637;283;354;241;3;180;384;384;0;3;377
153176000;6;90611;                        Nabais;405;188;217;391;183;208;154;1;125;339;339;0;1;338
153200000;6;90612;                        Nespereira;758;364;394;726;345;381;297;1;246;562;562;0;1;539
153251000;6;90613;                        Paços da Serra;601;293;308;567;272;295;250;0;193;459;459;0;6;447
153287000;6;90614;                        Ribamondego;317;143;174;303;134;169;122;1;97;245;245;0;1;246
153310000;6;90615;                        Rio Torto;463;204;259;439;195;244;178;1;139;421;421;0;2;421
153334000;6;90616;                        Gouveia (São Julião);1622;767;855;1687;787;900;622;4;502;947;946;1;7;660
153399000;6;90617;                        São Paio;828;386;442;799;366;433;341;1;263;673;673;0;1;652
153438000;6;90618;                        Gouveia (São Pedro);1850;834;1016;1751;781;970;786;3;587;1349;1349;0;13;788
153515000;6;90619;                        Vila Cortês da Serra;267;125;142;244;114;130;117;0;85;260;260;0;0;257
153543000;6;90620;                        Vila Franca da Serra;262;119;143;254;114;140;105;0;87;192;191;1;1;191
153564000;6;90621;                        Vila Nova de Tazem;1708;811;897;1587;743;844;665;1;512;1275;1275;0;2;1208
153651000;6;90622;                        Vinhó;578;261;317;555;253;302;228;1;181;412;412;0;2;409
153679000;5;912;                    Seia;24702;11756;12946;23768;11189;12579;9661;23;7686;17708;17693;15;128;14977
153680000;6;91201;                        Alvoco da Serra;466;214;252;415;190;225;204;0;144;562;562;0;4;539
153712000;6;91202;                        Cabeça;178;80;98;166;75;91;89;0;48;213;212;1;0;209
153721000;6;91203;                        Carragozela;380;172;208;353;155;198;137;0;118;190;190;0;2;192
153740000;6;91204;                        Folhadosa;327;139;188;277;124;153;109;1;86;214;214;0;1;214
153762000;6;91205;                        Girabolhos;317;151;166;307;143;164;153;0;106;389;389;0;0;389
153786000;6;91206;                        Lajes;273;124;149;261;116;145;116;0;90;210;210;0;0;209
153803000;6;91207;                        Loriga;1053;521;532;1004;493;511;431;1;309;910;910;0;4;639
153851000;6;91208;                        Paranhos;1503;706;797;1504;696;808;573;2;466;979;979;0;3;947
153909000;6;91209;                        Pinhanços;716;352;364;696;345;351;291;0;234;501;500;1;1;463
153938000;6;91210;                        Sabugueiro;478;247;231;458;232;226;178;1;141;333;333;0;34;363
153969000;6;91211;                        Sameice;367;176;191;350;168;182;146;0;120;271;271;0;0;266
153992000;6;91212;                        Sandomil;917;433;484;892;415;477;381;1;276;704;702;2;1;693
154056000;6;91213;                        Santa Comba;834;392;442;792;371;421;300;1;257;488;482;6;3;472
154098000;6;91214;                        Santa Eulália;271;125;146;265;122;143;109;0;82;198;198;0;1;198
154122000;6;91215;                        Santa Marinha;991;490;501;916;442;474;360;2;299;647;646;1;2;639
154166000;6;91216;                        Santiago;1205;575;630;1193;563;630;445;1;372;687;687;0;2;652
154224000;6;91217;                        São Martinho;638;311;327;609;294;315;255;0;208;437;437;0;0;436
154255000;6;91218;                        São Romão;2743;1324;1419;2574;1227;1347;1014;4;837;1599;1596;3;9;1181
154339000;6;91219;                        Sazes da Beira;283;131;152;288;130;158;107;1;73;298;298;0;3;301
154357000;6;91220;                        Seia;6342;2993;3349;6217;2896;3321;2436;5;2032;3869;3869;0;43;2082
154519000;6;91221;                        Teixeira;187;90;97;177;84;93;87;0;57;240;240;0;2;227
154543000;6;91222;                        Torrozelo;481;228;253;445;206;239;200;1;154;399;399;0;3;371
154577000;6;91223;                        Tourais;1440;678;762;1372;642;730;551;1;455;989;988;1;2;957
154652000;6;91224;                        Travancinha;472;219;253;457;212;245;189;0;144;400;400;0;0;400
154680000;6;91225;                        Valezim;310;150;160;302;145;157;135;0;101;263;263;0;3;249
154698000;6;91226;                        Várzea de Meruge;249;122;127;246;118;128;96;0;82;194;194;0;0;194
154717000;6;91227;                        Vide;583;283;300;567;274;293;266;1;171;986;986;0;2;975
154782000;6;91228;                        Vila Cova à Coelheira;404;195;209;384;183;201;176;0;127;304;304;0;1;287
154799000;6;91229;                        Lapa dos Dinheiros;294;135;159;281;128;153;127;0;97;234;234;0;2;233
154815000;4;168;                Beira Interior Norte;104417;49558;54859;100782;47540;53242;41845;125;31782;85515;85468;47;283;74429
154816000;5;902;                    Almeida;7242;3395;3847;6958;3229;3729;3044;14;2220;6664;6663;1;35;6418
154817000;6;90201;                        Ade;73;33;40;72;31;41;34;0;25;108;108;0;0;108
154834000;6;90202;                        Aldeia Nova;33;14;19;34;15;19;18;0;8;52;52;0;0;52
154860000;6;90203;                        Almeida;1314;613;701;1257;585;672;508;2;405;824;823;1;8;771
154923000;6;90204;                        Amoreira;178;81;97;172;81;91;78;0;59;129;129;0;1;129
154967000;6;90205;                        Azinhal;63;31;32;63;31;32;26;0;19;61;61;0;0;61
154985000;6;90206;                        Cabreira;91;41;50;94;41;53;31;4;25;112;112;0;5;117
155000000;6;90207;                        Castelo Bom;216;93;123;213;90;123;80;1;52;208;208;0;1;209
155022000;6;90208;                        Castelo Mendo;87;36;51;85;34;51;47;0;24;111;111;0;1;111
155037000;6;90209;                        Freineda;238;110;128;234;109;125;111;1;71;229;229;0;1;230
155069000;6;90210;                        Freixo;182;88;94;180;86;94;72;0;51;147;147;0;2;147
155092000;6;90211;                        Junça;124;65;59;118;62;56;55;0;44;131;131;0;0;131
155113000;6;90212;                        Leomil;104;52;52;103;52;51;55;0;36;118;118;0;0;118
155137000;6;90213;                        Malhada Sorda;334;138;196;334;136;198;132;2;88;552;552;0;2;554
155180000;6;90214;                        Malpartida;172;87;85;174;87;87;79;1;52;172;172;0;1;172
155221000;6;90215;                        Mesquitela;45;22;23;46;22;24;18;0;15;80;80;0;0;80
155237000;6;90216;                        Mido;46;20;26;52;23;29;29;0;14;71;71;0;0;71
155252000;6;90217;                        Miuzela;368;187;181;351;177;174;169;0;111;446;446;0;0;445
155308000;6;90218;                        Monte Perobolço;61;27;34;59;27;32;38;0;18;140;140;0;0;140
155324000;6;90219;                        Nave de Haver;358;158;200;347;152;195;158;1;108;514;514;0;1;512
155395000;6;90220;                        Naves;68;36;32;69;37;32;33;0;21;55;55;0;0;55
155418000;6;90221;                        Parada;114;58;56;111;56;55;55;0;38;193;193;0;0;193
155444000;6;90222;                        Peva;168;69;99;157;66;91;49;1;35;110;110;0;1;111
155465000;6;90223;                        Porto de Ovelha;47;21;26;47;21;26;28;0;17;198;198;0;0;195
155489000;6;90224;                        São Pedro de Rio Seco;181;80;101;177;78;99;87;0;59;188;188;0;0;188
155516000;6;90225;                        Senouras;38;18;20;38;18;20;23;0;14;58;58;0;0;58
155530000;6;90226;                        Vale de Coelha;43;22;21;40;19;21;18;0;13;49;49;0;0;49
155550000;6;90227;                        Vale da Mula;182;97;85;181;96;85;85;0;62;185;185;0;0;181
155584000;6;90228;                        Vale Verde;95;45;50;90;41;49;46;0;28;118;118;0;0;117
155614000;6;90229;                        Vilar Formoso;2219;1053;1166;2060;956;1104;882;1;708;1305;1305;0;11;1113
155738000;5;903;                    Celorico da Beira;7693;3611;4082;7470;3490;3980;3066;14;2371;6300;6290;10;36;5870
155739000;6;90301;                        Açores;352;151;201;337;143;194;134;1;106;264;264;0;1;265
155766000;6;90302;                        Baraçal;227;110;117;229;111;118;95;1;64;214;213;1;1;207
155791000;6;90303;                        Cadafaz;140;65;75;136;63;73;64;1;41;153;153;0;4;156
155809000;6;90304;                        Carrapichana;216;99;117;208;95;113;102;0;69;220;219;1;0;219
155832000;6;90305;                        Cortiçô da Serra;171;73;98;160;69;91;79;0;50;172;172;0;0;171
155849000;6;90306;                        Forno Telheiro;735;347;388;714;330;384;278;2;219;502;502;0;3;490
155892000;6;90307;                        Lajeosa do Mondego;698;327;371;665;303;362;264;2;218;441;441;0;5;426
155927000;6;90308;                        Linhares;259;114;145;261;119;142;118;0;79;312;312;0;6;318
155971000;6;90309;                        Maçal do Chão;160;81;79;163;83;80;62;0;47;152;152;0;0;152
155990000;6;90310;                        Mesquitela;238;111;127;238;110;128;104;0;75;280;280;0;2;282
156021000;6;90311;                        Minhocal;175;82;93;167;75;92;69;0;55;157;157;0;0;157
156036000;6;90312;                        Prados;180;86;94;174;85;89;72;1;56;240;240;0;1;240
156059000;6;90313;                        Rapa;162;77;85;166;81;85;66;1;48;146;146;0;3;149
156074000;6;90314;                        Ratoeira;303;139;164;292;132;160;113;1;87;217;217;0;1;218
156093000;6;90315;                        Salgueirais;114;56;58;112;54;58;47;0;35;146;146;0;0;146
156109000;6;90316;                        Celorico (Santa Maria);895;424;471;868;410;458;373;0;296;701;701;0;2;495
156152000;6;90317;                        Celorico (São Pedro);1383;645;738;1345;632;713;510;2;422;869;861;8;4;672
156216000;6;90318;                        Vale de Azares;400;191;209;385;182;203;169;1;124;360;360;0;1;361
156248000;6;90319;                        Velosa;114;53;61;114;53;61;44;0;32;95;95;0;0;94
156264000;6;90320;                        Vide entre Vinhas;165;77;88;150;68;82;79;0;50;180;180;0;0;180
156281000;6;90321;                        Vila Boa do Mondego;107;47;60;109;49;60;48;1;33;136;136;0;1;136
156296000;6;90322;                        Casas do Soeiro;499;256;243;477;243;234;176;0;165;343;343;0;1;336
156321000;5;904;                    Figueira de Castelo Rodrigo;6260;2996;3264;6030;2877;3153;2513;6;1910;5404;5396;8;20;5146
156322000;6;90401;                        Algodres;294;132;162;276;123;153;120;1;86;319;319;0;1;319
156363000;6;90402;                        Almofala;181;80;101;178;79;99;95;0;60;273;273;0;0;273
156408000;6;90403;                        Castelo Rodrigo;517;253;264;515;253;262;153;2;133;252;252;0;5;249
156445000;6;90404;                        Cinco Vilas;94;45;49;89;43;46;45;0;28;95;95;0;0;95
156463000;6;90405;                        Colmeal;42;23;19;44;24;20;25;0;11;90;90;0;0;89
156480000;6;90406;                        Escalhão;770;355;415;751;343;408;307;1;228;706;706;0;2;696
156533000;6;90407;                        Escarigo;99;39;60;99;39;60;47;0;34;108;108;0;0;108
156557000;6;90408;                        Figueira de Castelo Rodrigo;2211;1095;1116;2109;1041;1068;850;0;703;1408;1406;2;6;1172
156660000;6;90409;                        Freixeda do Torrão;262;120;142;253;114;139;113;1;73;248;248;0;1;246
156686000;6;90410;                        Mata de Lobos;383;174;209;361;164;197;145;1;97;394;394;0;1;392
156748000;6;90411;                        Penha de Águia;111;48;63;106;44;62;59;0;40;131;131;0;0;131
156766000;6;90412;                        Quintã de Pêro Martins;145;70;75;145;72;73;66;0;51;179;179;0;1;180
156792000;6;90413;                        Reigada;303;146;157;287;135;152;118;0;100;257;257;0;0;257
156824000;6;90414;                        Vale de Afonsinho;83;41;42;82;40;42;38;0;31;100;100;0;0;100
156839000;6;90415;                        Vermiosa;394;189;205;371;180;191;165;0;128;340;335;5;0;335
156887000;6;90416;                        Vilar de Amargo;158;80;78;152;78;74;76;0;48;215;215;0;1;215
156908000;6;90417;                        Vilar Torpim;213;106;107;212;105;107;91;0;59;289;288;1;2;289
156954000;5;907;                    Guarda;42541;20319;22222;40726;19337;21389;16402;42;12921;27808;27796;12;86;19376
156955000;6;90701;                        Adão;233;110;123;229;107;122;100;1;76;248;248;0;1;249
156988000;6;90702;                        Albardo;143;71;72;133;64;69;61;0;43;190;190;0;0;188
157006000;6;90703;                        Aldeia do Bispo;220;104;116;207;102;105;82;0;65;113;112;1;1;113
157037000;6;90704;                        Aldeia Viçosa;341;166;175;330;159;171;137;1;103;421;421;0;2;417
157060000;6;90705;                        Alvendre;210;102;108;206;100;106;84;0;68;166;166;0;1;165
157083000;6;90706;                        Arrifana;661;326;335;654;325;329;221;1;185;311;311;0;5;302
157132000;6;90707;                        Avelãs de Ambom;69;24;45;72;24;48;32;0;18;81;81;0;0;81
157145000;6;90708;                        Avelãs da Ribeira;196;96;100;197;94;103;81;0;62;164;164;0;0;164
157182000;6;90709;                        Benespera;297;137;160;284;131;153;134;1;87;255;255;0;1;254
157212000;6;90710;                        Carvalhal Meão;51;24;27;51;24;27;26;0;19;117;117;0;0;117
157228000;6;90711;                        Casal de Cinza;561;274;287;506;249;257;215;0;174;369;369;0;0;368
157274000;6;90712;                        Castanheira;345;161;184;329;152;177;173;0;108;378;378;0;0;376
157330000;6;90713;                        Cavadoude;324;172;152;314;168;146;113;1;93;239;239;0;1;240
157352000;6;90714;                        Codesseiro;205;95;110;188;90;98;81;0;60;165;165;0;0;165
157384000;6;90715;                        Corujeira;118;59;59;117;59;58;48;0;36;100;100;0;0;100
157397000;6;90716;                        Faia;227;95;132;225;94;131;107;0;76;326;326;0;8;326
157420000;6;90717;                        Famalicão;615;294;321;608;290;318;273;0;199;475;475;0;1;446
157458000;6;90718;                        Fernão Joanes;269;123;146;261;119;142;105;1;80;272;272;0;2;269
157487000;6;90719;                        Gagos;127;64;63;124;61;63;59;0;37;145;145;0;0;144
157510000;6;90720;                        Gonçalo;1083;518;565;1062;510;552;472;0;363;797;797;0;2;686
157562000;6;90721;                        Gonçalo Bocas;227;109;118;212;102;110;96;0;69;144;144;0;0;141
157580000;6;90722;                        João Antão;160;78;82;152;75;77;69;0;52;151;151;0;0;151
157602000;6;90723;                        Maçainhas;1081;531;550;1028;498;530;401;0;345;588;588;0;0;558
157670000;6;90724;                        Marmeleiro;361;187;174;342;176;166;177;0;114;503;503;0;0;500
157729000;6;90725;                        Meios;197;101;96;195;101;94;80;0;58;130;130;0;0;129
157745000;6;90726;                        Mizarela;135;66;69;131;65;66;61;0;47;190;190;0;1;191
157759000;6;90727;                        Monte Margarida;36;18;18;36;18;18;21;0;13;64;63;1;0;64
157773000;6;90728;                        Panoias de Cima;608;305;303;579;285;294;237;0;182;447;447;0;0;437
157820000;6;90729;                        Pega;161;79;82;163;79;84;77;1;48;350;350;0;1;351
157861000;6;90730;                        Pêra do Moço;831;400;431;798;385;413;323;1;247;575;575;0;1;569
157925000;6;90731;                        Pêro Soares;70;35;35;69;35;34;31;0;20;61;61;0;0;61
157939000;6;90732;                        Porto da Carne;385;175;210;353;157;196;117;2;96;187;186;1;2;169
157958000;6;90733;                        Pousada;118;52;66;113;49;64;63;0;33;202;201;1;0;201
157979000;6;90734;                        Ramela;218;105;113;211;102;109;99;0;73;206;206;0;0;206
158005000;6;90735;                        Ribeira dos Carinhos;108;51;57;106;52;54;45;0;34;105;105;0;0;103
158022000;6;90736;                        Rocamondo;89;46;43;83;41;42;31;0;26;70;70;0;0;70
158035000;6;90737;                        Rochoso;264;107;157;263;105;158;106;1;61;281;281;0;2;283
158084000;6;90738;                        Santana da Azinha;459;230;229;453;226;227;164;2;134;424;424;0;2;424
158122000;6;90739;                        Jarmelo (São Miguel);187;86;101;204;100;104;73;0;59;158;158;0;0;158
158145000;6;90740;                        Jarmelo (São Pedro);184;91;93;176;86;90;90;0;55;197;197;0;0;197
158185000;6;90741;                        Guarda (São Vicente);11679;5444;6235;10857;5007;5850;4486;11;3577;6584;6579;5;12;2633
158412000;6;90742;                        Guarda (Sé);6958;3345;3613;6893;3331;3562;2574;10;2051;3835;3835;0;22;1746
158606000;6;90743;                        Seixo Amarelo;84;42;42;79;39;40;47;0;27;119;119;0;0;119
158617000;6;90744;                        Sobral da Serra;242;117;125;241;115;126;111;0;71;265;265;0;0;265
158644000;6;90745;                        Trinta;406;201;205;394;195;199;179;0;129;375;375;0;2;349
158674000;6;90746;                        Vale de Estrela;394;186;208;380;174;206;147;1;123;205;205;0;1;203
158699000;6;90747;                        Valhelhas;396;201;195;366;179;187;170;0;125;388;388;0;2;356
158729000;6;90748;                        Vela;490;226;264;471;213;258;174;1;133;423;423;0;1;418
158759000;6;90749;                        Videmonte;478;214;264;449;200;249;176;1;135;350;350;0;3;350
158783000;6;90750;                        Vila Cortês do Mondego;298;141;157;291;137;154;106;1;88;169;169;0;1;156
158797000;6;90751;                        Vila Fernando;500;245;255;479;238;241;196;0;150;436;434;2;0;432
158854000;6;90752;                        Vila Franca do Deão;153;76;77;154;77;77;64;0;47;104;104;0;0;103
158882000;6;90753;                        Vila Garcia;320;153;167;305;145;160;126;0;102;243;243;0;0;240
158910000;6;90754;                        Vila Soeiro;41;18;23;39;17;22;25;0;12;65;65;0;1;66
158921000;6;90755;                        São Miguel da Guarda;7928;3843;4085;7564;3611;3953;2856;4;2433;3882;3881;1;7;1807
159078000;5;908;                    Manteigas;3430;1622;1808;3534;1653;1881;1391;3;1063;2603;2603;0;18;2236
159079000;6;90801;                        Sameiro;343;162;181;335;156;179;151;0;118;289;289;0;1;283
159109000;6;90802;                        Manteigas (Santa Maria);1418;680;738;1344;640;704;582;0;448;956;956;0;7;753
159173000;6;90803;                        Manteigas (São Pedro);1446;670;776;1637;754;883;563;2;422;1056;1056;0;8;908
159236000;6;90804;                        Vale de Amoreira;223;110;113;218;103;115;95;1;75;302;302;0;2;292
159261000;5;909;                    Meda;5202;2460;2742;5044;2374;2670;2236;4;1614;4946;4943;3;15;4722
159262000;6;90901;                        Aveloso;207;107;100;200;103;97;85;0;57;162;162;0;0;160
159278000;6;90902;                        Barreira;177;77;100;172;76;96;89;0;60;247;247;0;0;247
159302000;6;90903;                        Carvalhal;109;49;60;103;46;57;50;0;32;115;115;0;0;113
159321000;6;90904;                        Casteição;119;56;63;113;53;60;58;0;38;204;204;0;0;203
159346000;6;90905;                        Coriscada;208;95;113;203;88;115;97;1;66;282;282;0;1;283
159393000;6;90906;                        Fonte Longa;130;54;76;130;54;76;72;0;40;174;174;0;0;174
159415000;6;90907;                        Longroiva;286;124;162;286;123;163;139;0;95;304;304;0;3;302
159460000;6;90908;                        Marialva;255;121;134;238;110;128;127;0;88;270;270;0;3;272
159487000;6;90909;                        Meda;1987;949;1038;1906;909;997;738;3;596;1328;1326;2;6;1127
159594000;6;90910;                        Outeiro de Gatos;347;174;173;333;166;167;143;0;100;331;331;0;0;318
159643000;6;90911;                        Pai Penela;67;27;40;61;24;37;33;0;22;88;87;1;0;88
159658000;6;90912;                        Poço do Canto;443;213;230;424;199;225;203;0;138;416;416;0;0;413
159696000;6;90913;                        Prova;187;83;104;189;84;105;86;0;57;212;212;0;0;208
159733000;6;90914;                        Rabaçal;278;126;152;286;135;151;124;0;92;267;267;0;2;269
159762000;6;90915;                        Ranhados;252;131;121;250;130;120;114;0;89;335;335;0;0;334
159803000;6;90916;                        Vale Flor;150;74;76;150;74;76;78;0;44;211;211;0;0;211
159832000;5;910;                    Pinhel;9627;4584;5043;9266;4397;4869;3935;7;2997;8133;8130;3;9;7679
159833000;6;91001;                        Alverca da Beira;463;212;251;446;204;242;203;0;152;446;445;1;0;445
159864000;6;91002;                        Atalaia;99;51;48;99;51;48;52;0;36;187;187;0;0;187
159878000;6;91003;                        Azevo;195;89;106;193;88;105;104;1;60;276;276;0;1;277
159897000;6;91004;                        Bogalhal;37;16;21;36;16;20;19;0;11;65;65;0;0;65
159904000;6;91005;                        Bouça Cova;104;53;51;94;45;49;46;0;34;93;93;0;0;93
159921000;6;91006;                        Cerejo;132;67;65;131;69;62;71;0;45;186;186;0;0;186
159935000;6;91007;                        Cidadelhe;40;20;20;39;20;19;23;0;14;62;61;1;0;61
159946000;6;91008;                        Ervas Tenras;142;69;73;131;64;67;53;0;40;93;93;0;0;92
159960000;6;91009;                        Ervedosa;190;83;107;189;84;105;84;0;62;126;126;0;0;125
159983000;6;91010;                        Freixedas;905;421;484;891;413;478;365;1;279;914;914;0;1;909
160063000;6;91011;                        Gouveia;314;155;159;319;157;162;135;0;99;265;265;0;0;264
160122000;6;91012;                        Lamegal;253;128;125;223;112;111;118;0;75;253;253;0;0;252
160153000;6;91013;                        Lameiras;290;136;154;277;131;146;122;0;84;240;240;0;0;240
160171000;6;91014;                        Manigoto;186;88;98;168;79;89;82;1;56;166;166;0;1;166
160219000;6;91015;                        Pala;543;247;296;523;236;287;221;1;167;430;430;0;1;426
160237000;6;91016;                        Pereiro;150;74;76;151;74;77;69;0;49;180;180;0;0;180
160255000;6;91017;                        Pinhel;3518;1688;1830;3331;1594;1737;1289;2;1078;2117;2116;1;4;1691
160429000;6;91018;                        Pínzio;453;200;253;450;199;251;192;1;136;471;471;0;1;465
160491000;6;91019;                        Pomares;120;58;62;119;57;62;58;0;40;144;144;0;0;144
160506000;6;91020;                        Póvoa d' El-Rei;53;28;25;53;27;26;23;0;19;49;49;0;0;49
160516000;6;91021;                        Safurdão;108;55;53;103;53;50;50;0;34;121;121;0;0;121
160536000;6;91022;                        Santa Eufémia;172;83;89;156;72;84;79;0;56;229;229;0;0;229
160565000;6;91023;                        Sorval;80;36;44;79;35;44;41;0;23;93;93;0;0;93
160580000;6;91024;                        Souro Pires;588;286;302;588;286;302;224;0;184;465;465;0;0;457
160615000;6;91025;                        Valbom;214;103;111;204;96;108;92;0;73;174;174;0;0;174
160631000;6;91026;                        Vale de Madeira;92;47;45;91;46;45;42;0;30;109;109;0;0;109
160651000;6;91027;                        Vascoveiro;186;91;95;182;89;93;78;0;61;179;179;0;0;179
160668000;5;911;                    Sabugal;12544;5885;6659;12107;5655;6452;5323;25;3692;15330;15321;9;44;15099
160669000;6;91101;                        Águas Belas;175;81;94;175;82;93;77;0;57;283;283;0;0;283
160695000;6;91102;                        Aldeia do Bispo;286;125;161;286;124;162;111;1;75;350;350;0;1;350
160722000;6;91103;                        Aldeia da Ponte;317;152;165;302;143;159;127;1;95;500;500;0;1;501
160759000;6;91104;                        Aldeia da Ribeira;131;67;64;127;65;62;69;0;47;275;275;0;0;275
160784000;6;91105;                        Aldeia de Santo António;798;384;414;764;363;401;287;1;245;599;599;0;1;596
160825000;6;91106;                        Aldeia Velha;431;205;226;417;192;225;194;1;122;539;539;0;2;537
160878000;6;91107;                        Alfaiates;331;163;168;326;158;168;133;1;97;709;709;0;2;710
160925000;6;91108;                        Badamalos;96;53;43;90;48;42;45;0;27;140;140;0;0;140
160940000;6;91109;                        Baraçal;190;88;102;169;78;91;83;0;55;251;249;2;0;251
160966000;6;91110;                        Bendada;580;268;312;551;255;296;244;1;180;613;613;0;1;604
161000000;6;91111;                        Bismula;193;86;107;190;83;107;73;1;46;208;208;0;1;209
161019000;6;91112;                        Casteleiro;365;167;198;366;166;200;176;1;108;486;486;0;1;487
161053000;6;91113;                        Cerdeira;229;105;124;231;99;132;91;1;57;229;229;0;1;226
161081000;6;91114;                        Fóios;362;162;200;358;159;199;157;1;115;323;323;0;1;323
161114000;6;91115;                        Forcalhos;88;44;44;86;42;44;43;0;31;212;212;0;0;212
161132000;6;91116;                        Lajeosa;201;84;117;203;85;118;88;1;51;333;333;0;1;334
161163000;6;91117;                        Lomba;57;29;28;57;29;28;28;0;18;104;104;0;0;104
161177000;6;91118;                        Malcata;332;149;183;324;146;178;147;1;94;482;481;1;1;483
161198000;6;91119;                        Moita;103;54;49;103;55;48;58;0;34;173;173;0;0;168
161218000;6;91120;                        Nave;230;105;125;233;103;130;111;1;58;385;385;0;1;386
161255000;6;91121;                        Pena Lobo;141;72;69;133;67;66;65;0;47;143;143;0;0;143
161268000;6;91122;                        Pousafoles do Bispo;277;120;157;266;114;152;117;1;85;261;261;0;1;259
161310000;6;91123;                        Quadrazais;457;220;237;458;220;238;216;1;132;750;750;0;2;750
161375000;6;91124;                        Quinta de São Bartolomeu;180;89;91;166;86;80;75;0;50;269;269;0;0;268
161392000;6;91125;                        Rapoula do Côa;195;101;94;193;104;89;77;1;52;254;254;0;1;253
161407000;6;91126;                        Rebolosa;222;110;112;215;101;114;97;1;58;249;249;0;1;249
161429000;6;91127;                        Rendo;278;130;148;262;119;143;126;0;83;462;462;0;0;462
161460000;6;91128;                        Ruivós;70;27;43;89;41;48;27;0;22;98;98;0;0;97
161472000;6;91129;                        Ruvina;112;46;66;102;45;57;41;1;26;142;140;2;1;142
161486000;6;91130;                        Sabugal;1943;908;1035;1812;843;969;771;1;598;1603;1599;4;6;1417
161618000;6;91131;                        Santo Estêvão;310;147;163;303;146;157;139;1;91;429;429;0;1;430
161646000;6;91132;                        Seixo do Côa;171;85;86;153;78;75;83;0;54;276;276;0;0;276
161672000;6;91133;                        Sortelha;444;211;233;428;207;221;200;1;137;548;548;0;10;556
161709000;6;91134;                        Souto;1224;577;647;1159;541;618;464;2;351;1057;1057;0;2;1022
161787000;6;91135;                        Vale das Éguas;39;17;22;38;17;21;25;0;12;78;78;0;0;78
161794000;6;91136;                        Vale de Espinho;393;173;220;390;172;218;180;1;116;598;598;0;1;599
161822000;6;91137;                        Vale Longo;47;23;24;55;27;28;28;0;9;102;102;0;0;102
161834000;6;91138;                        Vila Boa;243;120;123;233;118;115;103;0;76;308;308;0;0;307
161848000;6;91139;                        Vila do Touro;183;84;99;177;81;96;76;1;51;269;269;0;1;270
161870000;6;91140;                        Vilar Maior;120;54;66;117;53;64;71;0;30;240;240;0;2;240
161893000;5;913;                    Trancoso;9878;4686;5192;9647;4528;5119;3935;10;2994;8327;8326;1;20;7883
161894000;6;91301;                        Aldeia Nova;332;153;179;325;149;176;131;1;93;323;323;0;1;324
161930000;6;91302;                        Carnicães;153;64;89;149;63;86;65;0;50;142;141;1;0;141
161947000;6;91303;                        Castanheira;194;105;89;244;117;127;73;0;62;105;105;0;0;105
161963000;6;91304;                        Cogula;195;94;101;194;93;101;77;1;51;204;204;0;1;204
161982000;6;91305;                        Cótimos;220;107;113;224;105;119;90;0;76;212;212;0;0;211
162011000;6;91306;                        Feital;65;31;34;64;30;34;27;0;19;99;99;0;2;101
162024000;6;91307;                        Fiães;273;135;138;272;134;138;114;0;90;239;239;0;0;237
162053000;6;91308;                        Freches;456;213;243;439;209;230;191;0;141;420;420;0;0;418
162083000;6;91309;                        Granja;151;75;76;141;68;73;65;0;45;204;204;0;0;204
162109000;6;91310;                        Guilheiro;184;91;93;184;91;93;77;0;56;207;207;0;0;201
162129000;6;91311;                        Moimentinha;229;106;123;209;96;113;98;0;74;184;184;0;0;184
162147000;6;91312;                        Moreira de Rei;508;233;275;501;231;270;231;0;168;466;466;0;0;466
162205000;6;91313;                        Palhais;196;90;106;171;77;94;75;0;67;152;152;0;1;151
162224000;6;91314;                        Póvoa do Concelho;276;132;144;265;131;134;110;0;82;238;238;0;0;237
162246000;6;91315;                        Reboleiro;324;146;178;289;123;166;90;3;61;150;150;0;2;150
162261000;6;91316;                        Rio de Mel;323;164;159;323;163;160;132;0;105;221;221;0;0;217
162287000;6;91317;                        Trancoso (Santa Maria);1577;771;806;1529;741;788;605;1;470;1101;1101;0;4;941
162391000;6;91318;                        Trancoso (São Pedro);1712;780;932;1684;759;925;582;4;488;1106;1106;0;5;886
162498000;6;91319;                        Sebadelhe da Serra;130;66;64;130;66;64;63;0;47;140;140;0;0;140
162517000;6;91320;                        Souto Maior;131;62;69;131;62;69;66;0;42;175;175;0;0;175
162535000;6;91321;                        Tamanhos;250;120;130;237;108;129;107;0;83;274;274;0;0;273
162561000;6;91322;                        Terrenho;113;55;58;110;52;58;47;0;37;119;119;0;2;120
162582000;6;91323;                        Torre do Terrenho;158;68;90;158;68;90;66;0;47;169;169;0;0;169
162610000;6;91324;                        Torres;137;62;75;135;60;75;63;0;40;168;168;0;0;168
162632000;6;91325;                        Valdujo;185;84;101;182;82;100;92;0;61;297;297;0;0;297
162660000;6;91326;                        Vale do Seixo;127;56;71;127;56;71;57;0;42;147;147;0;0;146
162678000;6;91327;                        Vila Franca das Naves;965;475;490;921;450;471;394;0;292;689;689;0;2;643
162721000;6;91328;                        Vila Garcia;118;61;57;116;59;57;60;0;41;168;168;0;0;168
162742000;6;91329;                        Vilares;196;87;109;193;85;108;87;0;64;208;208;0;0;206
162768000;4;169;                Beira Interior Sul;75028;35686;39342;73077;34410;38667;31840;51;23534;60086;60038;48;118;46039
162769000;5;502;                    Castelo Branco;56109;26661;29448;54436;25579;28857;23244;33;17557;38316;38282;34;66;24669
162770000;6;50201;                        Alcains;5022;2463;2559;4777;2331;2446;1984;3;1582;3110;3109;1;5;2373
162893000;6;50202;                        Almaceda;677;310;367;614;274;340;332;1;201;576;575;1;1;576
162979000;6;50203;                        Benquerenças;720;357;363;692;341;351;322;1;239;651;651;0;1;643
163015000;6;50204;                        Cafede;263;122;141;257;118;139;116;0;88;211;211;0;0;210
163036000;6;50205;                        Castelo Branco;35242;16645;18597;34318;15998;18320;14023;19;10899;19711;19692;19;39;7020
163605000;6;50206;                        Cebolais de Cima;1026;485;541;993;467;526;457;1;329;733;733;0;2;698
163647000;6;50207;                        Escalos de Baixo;746;350;396;734;342;392;334;0;244;692;692;0;1;676
163688000;6;50208;                        Escalos de Cima;938;462;476;883;428;455;397;0;298;681;677;4;0;659
163708000;6;50209;                        Freixial do Campo;468;226;242;441;213;228;196;1;151;342;342;0;1;335
163735000;6;50210;                        Juncal do Campo;355;158;197;338;147;191;175;0;119;476;475;1;0;473
163768000;6;50211;                        Lardosa;961;446;515;968;447;521;408;2;307;851;851;0;3;829
163791000;6;50212;                        Louriçal do Campo;636;313;323;607;292;315;280;1;188;587;586;1;1;574
163833000;6;50213;                        Lousa;621;304;317;612;295;317;294;0;209;498;498;0;0;484
163847000;6;50214;                        Malpica do Tejo;517;242;275;526;246;280;273;0;157;742;742;0;2;743
163886000;6;50215;                        Mata;470;226;244;451;215;236;224;0;159;492;491;1;1;490
163910000;6;50216;                        Monforte da Beira;378;184;194;381;185;196;201;0;117;634;631;3;0;631
163936000;6;50217;                        Ninho do Açor;380;194;186;392;200;192;166;0;129;327;327;0;0;321
163950000;6;50218;                        Póvoa de Rio de Moinhos;663;330;333;623;306;317;294;0;217;597;597;0;0;584
163973000;6;50219;                        Retaxo;843;402;441;803;376;427;372;0;284;605;605;0;1;583
164021000;6;50220;                        Salgueiro do Campo;891;411;480;864;397;467;376;2;266;745;744;1;2;741
164078000;6;50221;                        Santo André das Tojeiras;747;345;402;725;336;389;400;0;255;968;968;0;0;968
164178000;6;50222;                        São Vicente da Beira;1259;609;650;1191;575;616;521;1;372;1389;1388;1;4;1365
164257000;6;50223;                        Sarzedas;1335;613;722;1317;602;715;671;1;437;1664;1663;1;1;1664
164457000;6;50224;                        Sobral do Campo;366;174;192;353;168;185;165;0;117;447;447;0;0;443
164479000;6;50225;                        Tinalhas;585;290;295;576;280;296;263;0;193;587;587;0;1;586
164506000;5;505;                    Idanha-a-Nova;9716;4621;5095;9776;4616;5160;4387;8;3067;11835;11824;11;29;11630
164507000;6;50501;                        Alcafozes;202;94;108;215;99;116;106;0;64;347;347;0;1;348
164531000;6;50502;                        Aldeia de Santa Margarida;292;144;148;289;142;147;139;0;98;427;426;1;1;427
164546000;6;50503;                        Idanha-a-Nova;2352;1125;1227;2419;1135;1284;906;3;679;1881;1881;0;9;1733
164647000;6;50504;                        Idanha-a-Velha;63;30;33;61;28;33;33;0;23;93;93;0;1;94
164654000;6;50505;                        Ladoeiro;1290;622;668;1291;614;677;551;1;415;1100;1098;2;2;1097
164726000;6;50506;                        Medelim;272;126;146;263;121;142;135;0;85;379;379;0;1;373
164749000;6;50507;                        Monfortinho;536;251;285;494;232;262;267;0;180;631;631;0;6;609
164792000;6;50508;                        Monsanto;829;369;460;884;389;495;412;1;250;1260;1260;0;1;1253
164877000;6;50509;                        Oledo;355;162;193;352;160;192;176;0;109;422;422;0;0;419
164898000;6;50510;                        Penha Garcia;748;361;387;726;347;379;363;1;242;1069;1069;0;1;1059
164961000;6;50511;                        Proença-a-Velha;224;104;120;228;108;120;103;1;74;370;370;0;1;371
164988000;6;50512;                        Rosmaninhal;537;261;276;531;265;266;268;0;184;982;982;0;3;985
165082000;6;50513;                        Salvaterra do Extremo;170;79;91;169;80;89;91;0;58;455;455;0;0;454
165116000;6;50514;                        São Miguel de Acha;560;272;288;584;286;298;266;0;185;582;582;0;1;579
165146000;6;50515;                        Segura;176;87;89;171;85;86;95;0;62;312;312;0;0;312
165173000;6;50516;                        Toulões;237;113;124;231;108;123;132;0;88;454;454;0;0;454
165203000;6;50517;                        Zebreira;873;421;452;868;417;451;344;1;271;1071;1063;8;1;1063
165280000;5;507;                    Penamacor;5682;2760;2922;5354;2596;2758;2649;3;1811;6525;6525;0;10;6373
165281000;6;50701;                        Águas;300;148;152;290;145;145;154;0;100;395;395;0;0;395
165302000;6;50702;                        Aldeia do Bispo;676;333;343;583;291;292;307;0;220;783;783;0;0;778
165330000;6;50703;                        Aldeia de João Pires;195;97;98;184;89;95;102;0;70;329;329;0;0;329
165357000;6;50704;                        Aranhas;353;180;173;346;177;169;184;0;106;450;450;0;0;450
165375000;6;50705;                        Bemposta;120;59;61;111;54;57;59;0;42;199;199;0;0;197
165394000;6;50706;                        Benquerença;575;277;298;548;262;286;285;0;186;820;820;0;0;819
165428000;6;50707;                        Meimão;280;139;141;267;131;136;141;0;97;300;300;0;0;299
165448000;6;50708;                        Meimoa;373;179;194;351;170;181;178;0;122;417;417;0;0;415
165474000;6;50709;                        Pedrógão de São Pedro;500;243;257;484;236;248;242;0;165;498;498;0;0;498
165517000;6;50710;                        Penamacor;1577;752;825;1474;695;779;630;3;472;1412;1412;0;10;1272
165601000;6;50711;                        Salvador;476;237;239;466;231;235;231;0;150;557;557;0;0;556
165627000;6;50712;                        Vale da Senhora da Póvoa;257;116;141;250;115;135;136;0;81;365;365;0;0;365
165644000;5;511;                    Vila Velha de Ródão;3521;1644;1877;3511;1619;1892;1560;7;1099;3410;3407;3;13;3367
165645000;6;51101;                        Fratel;608;284;324;586;272;314;289;2;185;848;848;0;3;849
165751000;6;51102;                        Perais;510;247;263;508;244;264;250;0;177;488;487;1;0;474
165810000;6;51103;                        Sarnadas de Ródão;637;289;348;620;281;339;254;2;179;559;557;2;2;555
165879000;6;51104;                        Vila Velha de Ródão;1766;824;942;1797;822;975;767;3;558;1515;1515;0;8;1489
166029000;4;16A;                Cova da Beira;87869;42025;45844;87679;41730;45949;35964;55;27356;62159;62120;39;139;44461
166030000;5;501;                    Belmonte;6859;3294;3565;6631;3160;3471;2749;3;2167;4928;4926;2;9;4210
166031000;6;50101;                        Belmonte;3183;1497;1686;3067;1436;1631;1193;3;963;2063;2062;1;6;1512
166160000;6;50102;                        Caria;1921;937;984;1842;890;952;807;0;639;1424;1423;1;3;1303
166278000;6;50103;                        Colmeal da Torre;729;358;371;707;341;366;289;0;231;512;512;0;0;485
166322000;6;50104;                        Inguias;670;336;334;660;330;330;296;0;223;618;618;0;0;603
166385000;6;50105;                        Maçainhas;356;166;190;355;163;192;164;0;111;311;311;0;0;307
166426000;5;503;                    Covilhã;51797;24725;27072;52941;25165;27776;21220;36;16098;35227;35213;14;76;22083
166427000;6;50301;                        Vila do Carvalho;1741;853;888;1657;805;852;707;1;553;1093;1093;0;1;793
166480000;6;50302;                        Aldeia de São Francisco de Assis;632;303;329;578;278;300;266;1;191;504;504;0;2;506
166535000;6;50303;                        Aldeia do Souto;240;111;129;231;105;126;97;2;73;198;198;0;3;197
166558000;6;50304;                        Barco;473;211;262;468;207;261;202;1;147;457;457;0;1;441
166599000;6;50305;                        Boidobra;3246;1606;1640;3183;1570;1613;1251;1;1021;1622;1622;0;3;938
166663000;6;50306;                        Casegas;425;179;246;395;162;233;197;2;120;578;577;1;2;578
166712000;6;50307;                        Covilhã (Conceição);7175;3382;3793;7513;3528;3985;3070;0;2293;4511;4509;2;8;1450
166829000;6;50308;                        Cortes do Meio;884;430;454;865;414;451;357;1;265;1077;1077;0;6;961
166904000;6;50309;                        Dominguizo;1119;554;565;1073;531;542;443;2;352;682;682;0;3;510
166938000;6;50310;                        Erada;709;342;367;672;325;347;309;0;234;655;655;0;0;622
166999000;6;50311;                        Ferro;1700;816;884;1652;791;861;676;1;509;1173;1173;0;2;1085
167051000;6;50312;                        Orjais;806;386;420;782;372;410;332;0;268;532;532;0;1;491
167097000;6;50313;                        Ourondo;372;164;208;354;152;202;154;1;104;356;356;0;1;354
167140000;6;50314;                        Paul;1624;772;852;1551;728;823;651;2;497;1147;1147;0;3;1061
167219000;6;50315;                        Peraboa;953;440;513;952;433;519;374;1;287;616;615;1;1;587
167270000;6;50316;                        Peso;737;344;393;715;330;385;292;0;231;597;597;0;0;556
167306000;6;50317;                        Covilhã (Santa Maria);3220;1448;1772;3911;1759;2152;1408;5;911;2689;2689;0;7;583
167374000;6;50318;                        São Jorge da Beira;633;304;329;599;286;313;279;1;200;670;670;0;1;653
167412000;6;50319;                        Covilhã (São Martinho);4165;1960;2205;5590;2715;2875;1744;3;1260;2981;2980;1;11;1040
167475000;6;50320;                        Covilhã (São Pedro);2225;1056;1169;2162;1019;1143;884;4;660;1278;1278;0;7;587
167538000;6;50321;                        Sarzedo;130;59;71;127;58;69;67;0;39;232;232;0;0;232
167554000;6;50322;                        Sobral de São Miguel;418;190;228;398;183;215;197;1;115;492;492;0;1;490
167588000;6;50323;                        Teixoso;4360;2108;2252;4217;2023;2194;1739;1;1390;2386;2384;2;3;1533
167682000;6;50324;                        Tortosendo;5624;2742;2882;5362;2586;2776;2166;3;1752;3156;3156;0;3;1975
167790000;6;50325;                        Unhais da Serra;1398;672;726;1433;684;749;596;1;438;999;999;0;3;791
167833000;6;50326;                        Vale Formoso;574;270;304;560;261;299;228;0;190;496;495;1;0;481
167868000;6;50327;                        Verdelhos;664;329;335;637;311;326;280;1;198;790;790;0;2;763
167917000;6;50328;                        Vales do Rio;674;333;341;649;321;328;268;0;202;442;442;0;0;410
167956000;6;50329;                        Coutada;406;191;215;377;182;195;173;0;134;365;365;0;0;358
167993000;6;50330;                        Cantar-Galo;2233;1095;1138;2149;1039;1110;936;0;737;1314;1314;0;0;688
168029000;6;50331;                        Canhoso;2237;1075;1162;2129;1007;1122;877;0;727;1139;1133;6;1;369
168066000;5;504;                    Fundão;29213;14006;15207;28107;13405;14702;11995;16;9091;22004;21981;23;54;18168
168067000;6;50401;                        Alcaide;616;300;316;607;290;317;261;0;193;546;546;0;0;526
168111000;6;50402;                        Alcaria;1180;575;605;1146;556;590;462;2;351;763;763;0;4;674
168173000;6;50403;                        Alcongosta;497;234;263;476;219;257;211;0;153;385;385;0;0;369
168195000;6;50404;                        Aldeia de Joanes;1333;645;688;1263;607;656;476;2;413;707;707;0;3;493
168241000;6;50405;                        Aldeia Nova do Cabo;600;296;304;578;288;290;260;1;185;458;457;1;2;445
168269000;6;50406;                        Alpedrinha;1087;523;564;1020;484;536;410;1;322;819;819;0;4;755
168320000;6;50407;                        Atalaia do Campo;546;271;275;523;264;259;251;0;183;478;478;0;0;469
168344000;6;50408;                        Barroca;496;244;252;470;224;246;228;0;161;590;590;0;0;582
168388000;6;50409;                        Bogas de Baixo;194;95;99;188;91;97;105;0;68;310;310;0;0;310
168423000;6;50410;                        Bogas de Cima;347;162;185;338;163;175;150;0;112;361;360;1;0;356
168458000;6;50411;                        Capinha;494;234;260;489;234;255;215;1;152;561;561;0;1;558
168495000;6;50412;                        Castelejo;656;299;357;633;283;350;282;0;208;474;474;0;0;469
168550000;6;50413;                        Castelo Novo;406;194;212;392;185;207;157;0;125;464;464;0;2;465
168593000;6;50414;                        Donas;863;419;444;905;435;470;336;1;273;538;538;0;2;500
168620000;6;50415;                        Escarigo;224;100;124;215;96;119;113;0;79;297;297;0;0;293
168641000;6;50416;                        Fatela;564;266;298;536;249;287;225;0;175;490;489;1;0;486
168668000;6;50417;                        Fundão;9236;4421;4815;8735;4160;4575;3606;6;2806;5219;5208;11;17;2030
168858000;6;50418;                        Janeiro de Cima;306;140;166;299;136;163;136;0;99;320;320;0;2;319
168892000;6;50419;                        Lavacolhos;236;119;117;235;118;117;109;0;73;274;274;0;0;273
168914000;6;50420;                        Orca;650;323;327;640;320;320;324;0;209;801;797;4;4;802
168987000;6;50421;                        Pêro Viseu;728;347;381;751;370;381;305;0;230;675;675;0;0;671
169051000;6;50422;                        Póvoa de Atalaia;642;295;347;593;276;317;295;0;203;531;531;0;0;527
169106000;6;50423;                        Salgueiro;690;329;361;670;321;349;313;1;220;612;611;1;3;609
169148000;6;50424;                        Silvares;968;478;490;931;454;477;394;0;310;850;850;0;9;827
169205000;6;50425;                        Soalheira;891;439;452;867;420;447;365;1;264;688;688;0;1;667
169265000;6;50426;                        Souto da Casa;807;372;435;786;362;424;362;0;257;754;754;0;0;726
169328000;6;50427;                        Telhado;618;298;320;607;293;314;262;0;198;471;469;2;0;456
169365000;6;50428;                        Vale de Prazeres;1267;587;680;1246;572;674;571;0;400;1229;1227;2;0;1220
169453000;6;50429;                        Valverde;1402;669;733;1329;620;709;518;0;449;752;752;0;0;711
169514000;6;50430;                        Mata da Rainha;149;67;82;148;67;81;81;0;57;232;232;0;0;230
169527000;6;50431;                        Enxames;520;265;255;491;248;243;212;0;163;355;355;0;0;350
169555000;4;16B;                Oeste;362540;175117;187423;349608;167325;182283;140696;191;112160;223479;223190;289;471;160794
169556000;5;1001;                    Alcobaça;56693;27457;29236;54155;26001;28154;21908;27;17461;34625;34578;47;59;26663
169557000;6;100101;                        Alcobaça;5751;2624;3127;5394;2429;2965;2405;6;1704;3405;3404;1;11;1009
169641000;6;100102;                        Alfeizerão;3854;1867;1987;3746;1806;1940;1514;2;1207;2509;2508;1;4;2274
169815000;6;100103;                        Alpedriz;777;389;388;737;362;375;314;0;241;440;436;4;0;412
169858000;6;100104;                        Bárrio;1523;762;761;1466;733;733;597;0;503;821;821;0;0;786
169909000;6;100105;                        Benedita;8635;4190;4445;8233;3968;4265;3077;5;2526;3894;3890;4;8;3057
170187000;6;100106;                        Cela;3264;1599;1665;3094;1497;1597;1242;1;1024;1720;1720;0;1;1682
170306000;6;100107;                        Coz;1895;910;985;1811;868;943;744;0;607;1003;1002;1;0;960
170369000;6;100108;                        Évora de Alcobaça;4485;2200;2285;4312;2089;2223;1670;3;1375;2315;2315;0;5;2256
170537000;6;100109;                        Maiorga;2050;978;1072;1912;911;1001;816;0;665;1154;1152;2;0;1033
170600000;6;100110;                        Pataias;5451;2692;2759;5214;2554;2660;2199;2;1768;3865;3857;8;6;3039
170820000;6;100111;                        Aljubarrota (Prazeres);4235;2055;2180;4013;1932;2081;1651;1;1341;2286;2268;18;1;1882
170944000;6;100112;                        São Martinho do Porto;2868;1351;1517;2791;1303;1488;1210;1;860;4891;4889;2;13;2427
171091000;6;100113;                        Aljubarrota (São Vicente);2404;1180;1224;2321;1124;1197;917;0;728;1286;1286;0;1;1247
171195000;6;100114;                        Turquel;4561;2229;2332;4360;2108;2252;1636;3;1366;2265;2261;4;3;1951
171392000;6;100115;                        Vestiaria;1258;612;646;1211;585;626;507;2;395;740;740;0;3;661
171428000;6;100116;                        Vimeiro;1948;980;968;1886;934;952;727;1;606;1068;1067;1;1;1056
171513000;6;100118;                        Martingança;1145;557;588;1098;535;563;444;0;358;598;598;0;2;566
171558000;6;100119;                        Montes;589;282;307;556;263;293;238;0;187;365;364;1;0;365
171584000;5;1005;                    Bombarral;13193;6353;6840;12593;5975;6618;5211;9;4140;8025;8016;9;13;6489
171585000;6;100501;                        Bombarral;5664;2665;2999;5398;2502;2896;2222;4;1749;3430;3428;2;6;2076
171758000;6;100502;                        Carvalhal;2634;1272;1362;2527;1203;1324;1055;1;842;1711;1711;0;3;1675
171888000;6;100503;                        Roliça;2808;1406;1402;2680;1320;1360;1107;3;875;1684;1681;3;3;1583
172014000;6;100504;                        Vale Covo;1157;566;591;1107;533;574;484;1;377;697;697;0;1;665
172083000;6;100505;                        Pó;930;444;486;881;417;464;343;0;297;503;499;4;0;490
172128000;5;1006;                    Caldas da Rainha;51729;24505;27224;49550;23203;26347;20550;48;15871;30934;30909;25;129;19202
172129000;6;100601;                        A dos Francos;1701;815;886;1661;791;870;610;5;521;875;873;2;5;854
172215000;6;100602;                        Alvorninha;2987;1451;1536;2893;1398;1495;1103;5;914;1672;1672;0;5;1642
172392000;6;100603;                        Caldas da Rainha (Nossa Senhora do Pópulo);16114;7418;8696;15342;6987;8355;6763;17;4812;9730;9725;5;89;3541
172653000;6;100604;                        Carvalhal Benfeito;1279;623;656;1239;606;633;473;0;403;666;665;1;0;653
172727000;6;100605;                        Coto;1344;645;699;1274;609;665;485;0;420;659;659;0;1;622
172772000;6;100606;                        Foz do Arelho;1339;643;696;1347;640;707;590;1;399;1721;1720;1;8;923
172839000;6;100607;                        Landal;1051;506;545;1012;487;525;384;0;334;540;540;0;0;538
172911000;6;100608;                        Nadadouro;1904;941;963;1823;886;937;696;5;568;1212;1210;2;5;1143
172979000;6;100609;                        Salir de Matos;2583;1259;1324;2488;1204;1284;956;2;817;1462;1462;0;2;1442
173094000;6;100610;                        Salir do Porto;797;373;424;756;350;406;352;0;256;898;897;1;0;766
173149000;6;100611;                        Santa Catarina;3029;1481;1548;2860;1384;1476;1069;4;904;1422;1421;1;4;1374
173276000;6;100612;                        São Gregório;955;458;497;937;440;497;354;3;296;535;535;0;3;530
173312000;6;100613;                        Serra do Bouro;703;344;359;686;330;356;298;0;237;592;591;1;0;591
173364000;6;100614;                        Tornada;3561;1737;1824;3417;1640;1777;1327;3;1109;1947;1946;1;3;1790
173453000;6;100615;                        Vidais;1159;578;581;1121;553;568;461;1;368;799;799;0;1;787
173511000;6;100616;                        Caldas da Rainha (Santo Onofre);11223;5233;5990;10694;4898;5796;4629;2;3513;6204;6194;10;3;2006
173665000;5;1011;                    Nazaré;15158;7237;7921;14676;6904;7772;5987;6;4734;13119;13099;20;29;7628
173666000;6;101101;                        Famalicão;1740;837;903;1671;795;876;685;1;540;1225;1221;4;1;1139
173759000;6;101102;                        Nazaré;10309;4906;5403;10026;4694;5332;4115;4;3197;10324;10312;12;26;5093
174163000;6;101103;                        Valado dos Frades;3109;1494;1615;2979;1415;1564;1187;1;997;1570;1566;4;2;1396
174253000;5;1012;                    Óbidos;11772;5724;6048;11650;5631;6019;4596;5;3649;8996;8989;7;31;8286
174254000;6;101201;                        A dos Negros;1489;732;757;1415;683;732;565;1;461;870;870;0;1;854
174308000;6;101202;                        Amoreira;989;478;511;1189;588;601;428;0;314;1641;1640;1;2;1312
174363000;6;101203;                        Olho Marinho;1279;642;637;1245;619;626;519;1;399;893;892;1;3;880
174419000;6;101204;                        Óbidos (Santa Maria);2032;977;1055;1969;930;1039;753;2;604;1279;1277;2;9;1255
174576000;6;101205;                        Óbidos (São Pedro);1308;618;690;1293;604;689;500;0;395;852;852;0;15;825
174670000;6;101206;                        Sobral da Lagoa;439;206;233;432;200;232;182;0;144;340;340;0;0;336
174700000;6;101207;                        Vau;952;481;471;915;461;454;378;0;307;1444;1442;2;0;1341
174777000;6;101208;                        Gaeiras;2331;1127;1204;2222;1062;1160;909;1;728;1150;1149;1;1;976
174835000;6;101209;                        Usseira;953;463;490;970;484;486;362;0;297;527;527;0;0;507
174873000;5;1014;                    Peniche;27753;13444;14309;26669;12734;13935;10971;11;8707;21162;21095;67;60;13329
174874000;6;101401;                        Peniche (Ajuda);7989;3830;4159;7781;3649;4132;3159;3;2469;4851;4800;51;14;1964
175022000;6;101402;                        Atouguia da Baleia;8954;4386;4568;8547;4143;4404;3378;4;2811;7201;7194;7;17;5122
175428000;6;101403;                        Peniche (Conceição);4643;2230;2413;4462;2116;2346;1934;0;1477;2794;2790;4;5;1457
175537000;6;101404;                        Peniche (São Pedro);2117;1032;1085;1986;961;1025;886;2;677;1423;1421;2;8;988
175609000;6;101405;                        Serra d' El-Rei;1401;685;716;1334;643;691;571;0;448;935;935;0;3;897
175710000;6;101406;                        Ferrel;2649;1281;1368;2559;1222;1337;1043;2;825;3958;3955;3;13;2901
175944000;5;1101;                    Alenquer;43267;21066;22201;42402;20649;21753;16750;17;13493;23547;23530;17;26;16332
175945000;6;110101;                        Abrigada;3320;1593;1727;3206;1531;1675;1304;5;1035;1979;1978;1;5;1917
176103000;6;110102;                        Aldeia Galega da Merceana;2079;996;1083;2007;948;1059;820;1;617;1221;1218;3;1;1062
176213000;6;110103;                        Aldeia Gavinha;1142;546;596;1117;525;592;476;0;370;662;661;1;0;648
176256000;6;110104;                        Cabanas de Torres;989;480;509;951;458;493;394;0;308;587;587;0;0;572
176316000;6;110105;                        Cadafais;1734;836;898;1661;793;868;696;1;556;915;912;3;1;702
176364000;6;110106;                        Carnota;1678;820;858;1629;794;835;642;1;541;938;936;2;1;921
176459000;6;110107;                        Meca;1719;847;872;1662;808;854;651;0;558;939;939;0;0;911
176529000;6;110108;                        Olhalvo;1907;901;1006;1833;859;974;716;2;591;992;992;0;2;975
176586000;6;110109;                        Ota;1289;645;644;2069;1238;831;512;1;421;647;647;0;1;524
176627000;6;110110;                        Pereiro de Palhacana;577;296;281;557;286;271;236;1;189;434;434;0;3;433
176672000;6;110111;                        Alenquer (Santo Estêvão);6687;3217;3470;6479;3087;3392;2594;1;2098;3741;3739;2;4;2100
176793000;6;110112;                        Alenquer (Triana);4134;2016;2118;3973;1917;2056;1609;0;1307;2113;2113;0;3;1396
176886000;6;110113;                        Ventosa;2173;1039;1134;2087;993;1094;866;2;679;1467;1466;1;2;1410
177013000;6;110114;                        Vila Verde dos Francos;1162;586;576;1136;567;569;448;0;384;697;697;0;0;694
177082000;6;110115;                        Carregado;11707;5770;5937;11093;5386;5707;4403;2;3531;5589;5585;4;3;1460
177219000;6;110116;                        Ribafria;970;478;492;942;459;483;383;0;308;626;626;0;0;607
177271000;5;1102;                    Arruda dos Vinhos;13391;6571;6820;13038;6327;6711;5047;9;4101;6705;6703;2;11;4752
177272000;6;110201;                        Arranhó;2381;1180;1201;2352;1155;1197;904;0;760;1176;1176;0;0;1051
177389000;6;110202;                        Arruda dos Vinhos;8656;4258;4398;8385;4076;4309;3236;7;2627;4281;4280;1;9;2507
177573000;6;110203;                        Cardosas;836;400;436;815;385;430;321;1;255;462;462;0;1;445
177615000;6;110204;                        Santiago dos Velhos;1518;733;785;1486;711;775;586;1;459;786;785;1;1;749
177697000;5;1104;                    Cadaval;14228;6871;7357;13620;6509;7111;5580;10;4461;8749;8731;18;15;7878
177698000;6;110401;                        Alguber;957;460;497;932;436;496;337;1;302;553;552;1;1;549
177764000;6;110402;                        Cadaval;3113;1459;1654;2977;1382;1595;1217;1;970;1661;1657;4;2;961
177854000;6;110403;                        Cercal;560;266;294;449;199;250;236;2;185;427;427;0;2;411
177893000;6;110404;                        Figueiros;690;333;357;669;323;346;263;0;222;431;431;0;0;424
177929000;6;110405;                        Lamas;3072;1478;1594;2962;1414;1548;1213;2;958;1961;1958;3;3;1918
178066000;6;110406;                        Painho;1320;634;686;1267;610;657;522;1;423;724;720;4;1;701
178121000;6;110407;                        Peral;905;467;438;878;447;431;368;0;284;647;647;0;2;626
178172000;6;110408;                        Pêro Moniz;639;321;318;612;308;304;263;0;199;430;425;5;1;421
178228000;6;110409;                        Vermelha;1288;619;669;1228;577;651;510;1;407;851;851;0;1;822
178304000;6;110410;                        Vilar;1684;834;850;1646;813;833;651;2;511;1064;1063;1;2;1045
178408000;5;1108;                    Lourinhã;25735;12518;13217;24532;11799;12733;10073;11;7895;17035;17004;31;27;13306
178409000;6;110801;                        Lourinhã;9897;4703;5194;9431;4458;4973;3947;3;3041;7409;7393;16;12;4573
178809000;6;110802;                        Miragaia;1822;905;917;1744;853;891;705;0;568;1010;1009;1;0;983
178909000;6;110803;                        Moita dos Ferreiros;1734;845;889;1676;801;875;702;1;537;1133;1128;5;2;1071
179012000;6;110804;                        Moledo;472;232;240;461;226;235;188;0;143;318;317;1;0;309
179048000;6;110805;                        Reguengo Grande;1626;793;833;1547;748;799;632;1;506;1077;1074;3;2;1016
179127000;6;110806;                        Santa Bárbara;1943;943;1000;1815;864;951;688;1;583;984;982;2;1;932
179219000;6;110807;                        São Bartolomeu dos Galegos;1011;495;516;971;471;500;400;1;316;748;747;1;3;727
179290000;6;110808;                        Vimeiro;1470;742;728;1410;705;705;594;2;441;932;932;0;2;755
179370000;6;110809;                        Marteleira;1761;873;888;1686;827;859;677;1;528;1007;1006;1;1;931
179464000;6;110810;                        Ribamar;2141;1081;1060;2026;995;1031;846;0;663;1253;1252;1;2;953
179523000;6;110811;                        Atalaia;1858;906;952;1765;851;914;694;1;569;1164;1164;0;2;1056
179581000;5;1112;                    Sobral de Monte Agraço;10156;5003;5153;9905;4847;5058;3859;5;3095;5297;5294;3;6;4113
179582000;6;111201;                        Santo Quintino;3706;1843;1863;3677;1800;1877;1427;1;1155;2071;2071;0;1;1839
179775000;6;111202;                        Sapataria;3044;1534;1510;2958;1485;1473;1121;2;898;1483;1482;1;2;1248
179919000;6;111203;                        Sobral de Monte Agraço;3406;1626;1780;3270;1562;1708;1311;2;1042;1743;1741;2;3;1026
180029000;5;1113;                    Torres Vedras;79465;38368;41097;76818;36746;40072;30164;33;24553;45285;45242;43;65;32816
180030000;6;111301;                        A dos Cunhados;8459;4190;4269;8001;3907;4094;3123;8;2604;5691;5683;8;10;4353
180348000;6;111302;                        Campelos;2827;1378;1449;2706;1293;1413;1035;1;885;1367;1364;3;1;1224
180443000;6;111303;                        Carmões;831;398;433;809;387;422;313;1;247;533;533;0;1;525
180484000;6;111304;                        Carvoeira;1583;734;849;1534;709;825;628;0;494;1045;1045;0;0;1015
180564000;6;111305;                        Dois Portos;2124;1012;1112;1995;948;1047;847;0;665;1484;1482;2;0;1434
180679000;6;111306;                        Freiria;2461;1219;1242;2429;1194;1235;882;1;744;1225;1216;9;1;1164
180771000;6;111307;                        Matacães;1087;513;574;1047;497;550;394;1;324;593;593;0;1;578
180832000;6;111308;                        Maxial;2751;1315;1436;2633;1230;1403;1053;2;870;1454;1452;2;2;1415
180956000;6;111309;                        Monte Redondo;795;371;424;772;363;409;287;2;238;417;417;0;2;386
180991000;6;111310;                        Ponte do Rol;2444;1163;1281;2379;1120;1259;905;1;759;1090;1090;0;2;910
181057000;6;111311;                        Ramalhal;3472;1725;1747;3353;1650;1703;1296;1;1080;1675;1673;2;1;1539
181193000;6;111312;                        Runa;1004;476;528;977;458;519;353;1;290;491;491;0;1;438
181221000;6;111313;                        Torres Vedras (Santa Maria do Castelo e São Miguel);6665;3180;3485;6444;3033;3411;2669;1;2089;3552;3551;1;2;2066
181393000;6;111314;                        São Pedro da Cadeira;5077;2557;2520;4938;2464;2474;1788;2;1546;2587;2583;4;3;2341
181559000;6;111315;                        Torres Vedras (São Pedro e Santiago);17965;8327;9638;17354;7996;9358;7093;9;5494;9282;9276;6;17;3514
181889000;6;111316;                        Silveira;8530;4180;4350;8182;3972;4210;3207;0;2645;6768;6765;3;6;4564
182244000;6;111317;                        Turcifal;3342;1628;1714;3351;1625;1726;1269;2;1057;2002;2002;0;5;1742
182381000;6;111318;                        Ventosa;5276;2639;2637;5117;2544;2573;1938;0;1642;2427;2425;2;1;2336
182559000;6;111319;                        Outeiro da Cabeça;840;412;428;823;398;425;336;0;268;453;453;0;0;391
182594000;6;111320;                        Maceira;1932;951;981;1974;958;1016;748;0;612;1149;1148;1;9;881
182653000;4;16C;                Médio Tejo;220661;105219;115442;212112;100134;111978;87011;269;67751;137233;137072;161;479;107291
182654000;5;1401;                    Abrantes;39325;18950;20375;37754;18016;19738;15996;30;12406;25504;25480;24;54;20368
182655000;6;140101;                        Aldeia do Mato;441;203;238;420;192;228;207;0;141;610;610;0;2;562
182702000;6;140102;                        Alferrarede;3884;1857;2027;3718;1767;1951;1538;4;1208;2264;2262;2;4;1644
182799000;6;140103;                        Alvega;1499;734;765;1455;697;758;616;1;483;1094;1093;1;3;1080
182869000;6;140104;                        Bemposta;1795;878;917;1709;816;893;741;1;597;1303;1302;1;2;1297
182926000;6;140105;                        Martinchel;604;299;305;571;276;295;249;0;200;462;462;0;1;458
182964000;6;140106;                        Mouriscas;1832;878;954;1873;919;954;756;8;558;1472;1470;2;9;1455
183070000;6;140107;                        Pego;2431;1189;1242;2348;1139;1209;1016;2;788;1650;1649;1;5;1573
183119000;6;140108;                        Rio de Moinhos;1202;583;619;1133;544;589;487;1;376;779;779;0;4;728
183165000;6;140109;                        Rossio ao Sul do Tejo;2012;955;1057;2018;951;1067;811;1;617;1186;1185;1;2;766
183208000;6;140110;                        São Facundo;927;471;456;908;458;450;399;0;295;691;689;2;0;680
183247000;6;140111;                        Abrantes (São João);1699;767;932;1622;717;905;673;4;491;1064;1064;0;6;593
183299000;6;140112;                        São Miguel do Rio Torto;2869;1371;1498;2743;1296;1447;1225;1;947;1984;1976;8;3;1804
183385000;6;140113;                        Abrantes (São Vicente);11622;5594;6028;10964;5208;5756;4520;5;3608;6088;6085;3;9;3016
183589000;6;140114;                        Souto;418;200;218;405;197;208;194;0;140;604;604;0;0;600
183631000;6;140115;                        Tramagal;3500;1679;1821;3391;1619;1772;1464;2;1147;2008;2007;1;3;1921
183741000;6;140116;                        Vale das Mós;588;300;288;559;282;277;250;0;186;428;427;1;0;403
183765000;6;140117;                        Concavada;653;343;310;606;312;294;252;0;200;426;426;0;1;406
183794000;6;140118;                        Fontes;627;299;328;611;293;318;283;0;194;711;711;0;0;708
183839000;6;140119;                        Carvalhal;722;350;372;700;333;367;315;0;230;680;679;1;0;674
183888000;5;1402;                    Alcanena;13868;6686;7182;13186;6305;6881;5550;4;4263;8063;8060;3;11;6697
183889000;6;140201;                        Alcanena;4131;2003;2128;3789;1814;1975;1652;2;1270;2262;2260;2;6;1493
184036000;6;140202;                        Bugalhos;1084;537;547;1048;515;533;406;0;331;588;588;0;0;565
184102000;6;140203;                        Espinheiro;553;260;293;522;241;281;245;0;177;379;379;0;0;369
184148000;6;140204;                        Louriceira;583;294;289;559;281;278;239;0;185;353;353;0;0;348
184203000;6;140205;                        Malhou;773;388;385;760;381;379;309;0;245;527;527;0;0;515
184280000;6;140206;                        Minde;3293;1551;1742;3139;1463;1676;1272;1;1009;1833;1833;0;1;1422
184433000;6;140207;                        Moitas Venda;866;408;458;826;388;438;351;0;258;576;576;0;2;554
184476000;6;140208;                        Monsanto;886;436;450;852;415;437;376;0;276;523;522;1;0;508
184543000;6;140209;                        Serra de Santo António;725;341;384;765;359;406;289;1;212;454;454;0;2;441
184620000;6;140210;                        Vila Moreira;974;468;506;926;448;478;411;0;300;568;568;0;0;482
184673000;5;1408;                    Constância;4056;1946;2110;4009;1944;2065;1565;3;1271;2175;2170;5;6;1851
184674000;6;140801;                        Constância;993;468;525;947;439;508;383;1;298;583;583;0;3;465
184753000;6;140802;                        Montalvo;1275;625;650;1226;595;631;473;2;398;614;612;2;2;470
184784000;6;140803;                        Santa Margarida da Coutada;1788;853;935;1836;910;926;709;0;575;978;975;3;1;916
184857000;5;1410;                    Entroncamento;20206;9629;10577;19259;9024;10235;8067;7;6377;10703;10697;6;12;4150
184858000;6;141001;                        São João Baptista;7576;3552;4024;7309;3363;3946;3270;2;2487;4440;4436;4;5;1581
184992000;6;141002;                        Nossa Senhora de Fátima;12630;6077;6553;11950;5661;6289;4797;5;3890;6263;6261;2;7;2569
185195000;5;1411;                    Ferreira do Zêzere;8619;4098;4521;8334;3941;4393;3438;7;2648;7508;7503;5;17;6933
185196000;6;141101;                        Águas Belas;1072;520;552;1023;490;533;429;0;336;886;885;1;0;858
185340000;6;141102;                        Areias;1484;693;791;1434;664;770;615;2;440;1476;1475;1;2;1469
185481000;6;141103;                        Beco;906;416;490;878;406;472;365;0;292;759;759;0;1;759
185599000;6;141104;                        Chãos;597;278;319;593;275;318;252;0;196;618;618;0;0;612
185672000;6;141105;                        Dornes;594;288;306;588;287;301;251;1;191;587;585;2;5;585
185741000;6;141106;                        Ferreira do Zêzere;2353;1136;1217;2284;1097;1187;878;3;705;1800;1800;0;7;1288
185875000;6;141107;                        Igreja Nova do Sobral;662;312;350;615;285;330;272;1;192;625;624;1;1;615
185981000;6;141108;                        Paio Mendes;495;239;256;473;226;247;191;0;151;425;425;0;1;419
186054000;6;141109;                        Pias;456;216;240;446;211;235;185;0;145;332;332;0;0;328
186090000;5;1417;                    Sardoal;3939;1916;2023;3731;1790;1941;1514;13;1184;2970;2969;1;15;2810
186091000;6;141701;                        Alcaravela;904;439;465;851;403;448;344;2;278;695;695;0;2;682
186200000;6;141702;                        Santiago de Montalegre;229;111;118;221;108;113;99;0;73;312;312;0;0;312
186260000;6;141703;                        Sardoal;2404;1172;1232;2277;1095;1182;906;9;709;1579;1578;1;11;1435
186420000;6;141704;                        Valhascos;402;194;208;382;184;198;165;2;124;384;384;0;2;381
186452000;5;1418;                    Tomar;40677;19271;21406;39449;18538;20911;16353;38;12552;26300;26232;68;68;20756
186453000;6;141801;                        Alviobeira;623;297;326;596;284;312;247;0;186;476;476;0;1;468
186513000;6;141802;                        Asseiceira;2945;1417;1528;2801;1332;1469;1167;2;936;1665;1663;2;4;1615
186659000;6;141803;                        Beselga;751;365;386;729;348;381;321;0;240;645;645;0;0;642
186733000;6;141804;                        Carregueiros;1179;558;621;1111;518;593;467;0;377;716;716;0;0;698
186798000;6;141805;                        Casais;2342;1128;1214;2250;1070;1180;927;2;744;1592;1592;0;2;1551
186932000;6;141806;                        Junceira;889;422;467;879;418;461;319;1;248;670;670;0;3;656
187015000;6;141807;                        Madalena;3239;1626;1613;3044;1520;1524;1227;6;1005;1784;1784;0;7;1732
187153000;6;141808;                        Olalhas;1415;690;725;1345;641;704;559;1;407;1302;1302;0;2;1289
187286000;6;141809;                        Paialvo;2599;1227;1372;2511;1156;1355;1003;9;783;1521;1518;3;11;1491
187469000;6;141810;                        Pedreira;549;253;296;550;258;292;223;0;185;335;335;0;0;323
187491000;6;141811;                        Santa Maria dos Olivais;12616;5847;6769;12466;5766;6700;5188;9;3890;7189;7184;5;17;3169
187710000;6;141812;                        Tomar (São João Baptista);5593;2614;2979;5390;2487;2903;2328;2;1721;3351;3299;52;14;2178
187856000;6;141813;                        São Pedro de Tomar;3027;1470;1557;2947;1427;1520;1163;4;949;1878;1875;3;4;1813
188035000;6;141814;                        Sabacheira;955;443;512;918;430;488;406;1;303;867;867;0;1;859
188138000;6;141815;                        Serra;1191;552;639;1176;537;639;488;1;331;1719;1716;3;2;1691
188291000;6;141816;                        Além da Ribeira;764;362;402;736;346;390;320;0;247;590;590;0;0;581
188360000;5;1419;                    Torres Novas;36717;17511;19206;35111;16616;18495;14628;36;11448;20862;20847;15;43;16603
188361000;6;141901;                        Alcorochel;810;391;419;754;358;396;341;1;253;505;504;1;1;503
188399000;6;141902;                        Assentiz;2921;1390;1531;2838;1348;1490;1177;2;905;1942;1942;0;2;1929
188568000;6;141903;                        Brogueira;1112;530;582;1083;513;570;431;0;358;661;660;1;0;659
188637000;6;141904;                        Chancelaria;1659;797;862;1594;763;831;664;2;501;1110;1107;3;2;1099
188753000;6;141905;                        Lapas;2590;1253;1337;2450;1170;1280;1031;1;802;1240;1240;0;1;762
188801000;6;141906;                        Olaia;1725;860;865;1658;814;844;695;3;537;1050;1050;0;3;1024
188896000;6;141907;                        Paço;684;353;331;648;333;315;286;0;223;479;479;0;1;478
188944000;6;141908;                        Parceiros de Igreja;907;434;473;888;423;465;382;0;294;724;722;2;1;704
189011000;6;141909;                        Pedrógão;2037;970;1067;1934;917;1017;780;1;625;1246;1245;1;1;1219
189143000;6;141910;                        Riachos;5247;2496;2751;5080;2396;2684;2053;6;1678;2558;2557;1;7;2193
189244000;6;141911;                        Ribeira Branca;618;292;326;602;283;319;249;0;204;414;414;0;0;408
189293000;6;141912;                        Torres Novas (Salvador);2227;1040;1187;2122;977;1145;832;7;618;1154;1153;1;8;693
189363000;6;141913;                        Torres Novas (Santa Maria);5026;2388;2638;4843;2301;2542;1972;4;1571;2683;2683;0;7;1585
189484000;6;141914;                        Torres Novas (Santiago);993;466;527;913;425;488;429;0;317;687;686;1;0;580
189549000;6;141915;                        Torres Novas (São Pedro);5466;2527;2939;5159;2358;2801;2257;6;1711;2998;2995;3;6;1461
189662000;6;141916;                        Zibreira;1028;508;520;954;467;487;391;2;324;578;577;1;2;557
189724000;6;141917;                        Meia Via;1667;816;851;1591;770;821;658;1;527;833;833;0;1;749
189763000;5;1420;                    Vila Nova da Barquinha;7322;3555;3767;7093;3417;3676;2910;5;2321;4102;4096;6;12;3414
189764000;6;142001;                        Atalaia;1697;833;864;1628;792;836;651;1;549;856;856;0;2;789
189832000;6;142002;                        Praia do Ribatejo;1702;819;883;1716;844;872;684;2;521;1080;1075;5;5;997
189952000;6;142003;                        Tancos;243;136;107;232;125;107;87;1;68;149;149;0;1;143
189984000;6;142004;                        Vila Nova da Barquinha;1588;751;837;1503;702;801;656;1;509;953;953;0;2;599
190086000;6;142005;                        Moita do Norte;2092;1016;1076;2014;954;1060;832;0;674;1064;1063;1;2;886
190182000;5;1421;                    Ourém;45932;21657;24275;44186;20543;23643;16990;126;13281;29046;29018;28;241;23709
190183000;6;142101;                        Alburitel;1179;570;609;1124;533;591;434;3;366;609;609;0;4;605
190223000;6;142102;                        Atouguia;2454;1187;1267;2374;1130;1244;888;1;722;1354;1354;0;1;1329
190331000;6;142103;                        Casal dos Bernardos;921;430;491;887;413;474;374;0;290;818;818;0;0;816
190407000;6;142104;                        Caxarias;2166;1029;1137;2115;992;1123;850;1;676;1477;1474;3;3;1307
190525000;6;142105;                        Espite;1104;501;603;1070;487;583;457;3;352;1059;1059;0;3;1060
190625000;6;142106;                        Fátima;11596;5238;6358;11434;5073;6361;3900;97;2997;6575;6566;9;197;3704
190920000;6;142107;                        Formigais;375;177;198;360;170;190;164;0;120;325;323;2;2;326
190947000;6;142108;                        Freixianda;2474;1168;1306;2429;1135;1294;939;3;719;1806;1805;1;4;1760
191116000;6;142109;                        Gondemaria;1175;570;605;1118;536;582;450;0;355;754;752;2;0;744
191177000;6;142110;                        Olival;1995;953;1042;1931;920;1011;811;2;611;1462;1461;1;3;1450
191314000;6;142111;                        Nossa Senhora das Misericórdias;5077;2481;2596;4788;2303;2485;1799;3;1474;2729;2728;1;4;2584
191527000;6;142112;                        Rio de Couros;1877;895;982;1788;845;943;717;0;588;1404;1404;0;0;1395
191638000;6;142113;                        Seiça;2076;968;1108;2001;920;1081;855;1;633;1531;1530;1;2;1519
191763000;6;142114;                        Urqueira;1682;807;875;1583;756;827;694;0;514;1356;1355;1;0;1349
191851000;6;142115;                        Nossa Senhora da Piedade;7217;3464;3753;6745;3175;3570;2712;8;2111;4167;4162;5;14;2151
192037000;6;142116;                        Matas;944;446;498;897;428;469;355;2;287;634;634;0;2;628
192108000;6;142117;                        Cercal;784;390;394;742;365;377;284;0;233;410;409;1;0;409
192146000;6;142118;                        Ribeira do Fárrio;836;383;453;800;362;438;307;2;233;576;575;1;2;573
