ordem;nivel;cod_dim2;Zona Geográfica;População residente - Total;População residente - H;População residente - M;População presente - Total;População presente - H;População presente - M;Famílias - Clássicas ;Famílias - Institucionais;Núcleos familiares ;Alojamentos familiares - Total ;Alojamentos familiares - Clássicos;Alojamentos familiares - Não clássicos;Alojamentos colectivos;Edifícios clássicos
192193000;3;17;            Lisboa;2821876;1334605;1487271;2731459;1281415;1450044;1147775;1172;852217;1485795;1483717;2078;2063;448957
192194000;4;171;                Grande Lisboa;2042477;961132;1081345;1982759;926955;1055804;835653;885;609887;1065235;1064036;1199;1633;277387
192195000;5;1105;                    Cascais;206479;96866;109613;198340;92312;106028;82093;123;61887;108998;108840;158;173;43624
192196000;6;110501;                        Alcabideche;42162;20428;21734;40755;19636;21119;15460;30;12493;19758;19696;62;31;10662
192837000;6;110502;                        Carcavelos;23347;10780;12567;22179;10145;12034;9982;10;7130;12339;12323;16;16;2947
193128000;6;110503;                        Cascais;35409;16224;19185;34023;15544;18479;14564;11;10567;22734;22718;16;36;8777
193735000;6;110504;                        Estoril;26399;12062;14337;25435;11586;13849;11147;27;7650;16027;16018;9;45;5597
194151000;6;110505;                        Parede;21660;9829;11831;20742;9295;11447;9154;25;6290;12101;12086;15;26;3807
194427000;6;110506;                        São Domingos de Rana;57502;27543;29959;55206;26106;29100;21786;20;17757;26039;25999;40;19;11834
195270000;5;1106;                    Lisboa;547733;250874;296859;547348;250857;296491;243892;379;154519;323076;322865;211;905;52496
195271000;6;110601;                        Ajuda;15584;7120;8464;14916;6787;8129;6982;5;4610;8872;8866;6;7;2837
195474000;6;110602;                        Alcântara;13943;6254;7689;14352;6460;7892;6591;10;3968;8900;8886;14;20;1659
195610000;6;110603;                        Alto do Pina;10333;4687;5646;9975;4488;5487;4647;9;2914;6106;6104;2;11;588
195678000;6;110604;                        Alvalade;8869;3764;5105;9129;3850;5279;4189;9;2440;5381;5381;0;14;633
195730000;6;110605;                        Ameixoeira;11863;5568;6295;11299;5270;6029;4772;5;3462;6235;6227;8;5;998
195838000;6;110606;                        Anjos;9361;4392;4969;9442;4431;5011;4604;11;2462;6032;6027;5;34;968
195906000;6;110607;                        Beato;12429;5763;6666;12047;5567;6480;5757;1;3652;7636;7631;5;4;1832
196023000;6;110608;                        Benfica;36821;16487;20334;35713;15958;19755;16735;11;11067;21204;21197;7;17;2811
196272000;6;110609;                        Campo Grande;10514;4679;5835;11918;5267;6651;4669;13;2928;6199;6199;0;21;639
196343000;6;110610;                        Campolide;15460;7468;7992;15669;7580;8089;6729;20;4114;9235;9224;11;20;2472
196494000;6;110611;                        Carnide;23316;10893;12423;23072;10861;12211;9064;17;6598;11148;11145;3;18;1804
196665000;6;110612;                        Castelo;355;158;197;353;157;196;191;0;97;348;347;1;1;102
196676000;6;110613;                        Charneca;9935;4753;5182;9469;4481;4988;3677;2;2862;4446;4430;16;2;702
196752000;6;110614;                        Coração de Jesus;3689;1698;1991;5355;2617;2738;1928;2;946;2849;2848;1;42;493
196810000;6;110615;                        Encarnação;2252;1060;1192;2300;1068;1232;1175;2;578;2261;2258;3;22;497
196871000;6;110616;                        Graça;5787;2613;3174;5606;2514;3092;2769;3;1621;4118;4117;1;7;874
196915000;6;110617;                        Lapa;8000;3553;4447;7780;3445;4335;3618;7;2130;5284;5281;3;13;936
196984000;6;110618;                        Lumiar;41163;19140;22023;39642;18182;21460;17185;21;11690;21451;21446;5;21;1775
197247000;6;110619;                        Madalena;393;187;206;457;234;223;181;0;106;370;370;0;5;79
197266000;6;110620;                        Mártires;372;182;190;349;172;177;184;1;92;321;321;0;5;64
197278000;6;110621;                        Marvila;38102;17945;20157;36630;17144;19486;14194;11;11494;16669;16649;20;12;1553
197506000;6;110622;                        Mercês;4345;1968;2377;4121;1857;2264;2176;3;1118;3248;3241;7;4;732
197553000;6;110623;                        Nossa Senhora de Fátima;15283;6692;8591;16114;7069;9045;7061;20;4043;10387;10386;1;55;1264
197681000;6;110624;                        Pena;4486;2166;2320;4600;2299;2301;2207;4;1139;3505;3503;2;13;735
197733000;6;110625;                        Penha de França;12780;5680;7100;12406;5431;6975;6184;6;3642;8308;8305;3;8;1291
197804000;6;110626;                        Prazeres;8096;3679;4417;7660;3497;4163;3777;6;2200;4937;4924;13;12;1290
197883000;6;110627;                        Sacramento;742;357;385;802;383;419;376;0;173;676;674;2;10;134
197899000;6;110628;                        Santa Catarina;3716;1692;2024;3591;1631;1960;1917;2;913;2951;2949;2;15;608
197956000;6;110629;                        Santa Engrácia;5249;2376;2873;5097;2305;2792;2680;0;1507;3530;3529;1;4;662
198002000;6;110630;                        Santa Isabel;6875;3034;3841;6643;2919;3724;3173;9;1841;4305;4305;0;15;940
198055000;6;110631;                        Santa Justa;891;497;394;1865;1069;796;412;1;180;628;628;0;32;193
198076000;6;110632;                        Santa Maria de Belém;8541;3868;4673;8302;3755;4547;3809;13;2374;5255;5253;2;18;2000
198254000;6;110633;                        Santa Maria dos Olivais;51036;24026;27010;49643;23224;26419;21132;15;15230;26059;26045;14;29;3435
198614000;6;110634;                        Santiago;619;261;358;582;242;340;326;1;155;556;556;0;3;113
198630000;6;110635;                        Santo Condestável;15257;6628;8629;14566;6269;8297;7358;10;4306;9481;9476;5;14;1711
198741000;6;110636;                        Santo Estêvão;1511;691;820;1398;643;755;849;0;399;1565;1564;1;6;409
198784000;6;110637;                        Santos-o-Velho;4020;1865;2155;3966;1819;2147;1930;0;1057;2888;2888;0;10;653
198830000;6;110638;                        São Cristóvão e São Lourenço;1341;675;666;1275;647;628;676;4;309;1092;1092;0;4;217
198860000;6;110639;                        São Domingos de Benfica;33745;15194;18551;33365;14938;18427;15298;16;9821;20233;20229;4;27;1753
199063000;6;110640;                        São Francisco Xavier;8020;3656;4364;8496;4135;4361;3341;5;2315;4216;4203;13;6;1039
199181000;6;110641;                        São João;15187;6790;8397;14852;6618;8234;7233;8;4329;9484;9480;4;20;1281
199270000;6;110642;                        São João de Brito;11727;5152;6575;11516;5025;6491;5233;34;3181;6782;6780;2;43;1225
199375000;6;110643;                        São João de Deus;9798;4224;5574;9797;4230;5567;4603;6;2703;6427;6425;2;14;831
199472000;6;110644;                        São Jorge de Arroios;18415;8405;10010;19367;9011;10356;9218;22;4702;11887;11882;5;75;1617
199590000;6;110645;                        São José;2746;1295;1451;3159;1581;1578;1429;3;695;2327;2324;3;27;522
199632000;6;110646;                        São Mamede;5420;2358;3062;5824;2572;3252;2427;12;1386;3321;3321;0;27;594
199687000;6;110647;                        São Miguel;1531;694;837;1534;697;837;872;0;405;1138;1138;0;1;264
199717000;6;110648;                        São Nicolau;1231;715;516;1946;1082;864;456;5;229;1159;1159;0;29;234
199774000;6;110649;                        São Paulo;2728;1354;1374;2760;1380;1380;1315;2;702;2036;2034;2;11;396
199843000;6;110650;                        São Sebastião da Pedreira;6342;2877;3465;9224;4415;4809;2838;7;1651;4043;4041;2;47;589
199912000;6;110651;                        São Vicente de Fora;3539;1579;1960;3430;1529;1901;1842;1;998;2644;2639;5;6;831
199954000;6;110652;                        Sé;910;437;473;912;432;480;433;2;235;862;862;0;9;144
199975000;6;110653;                        Socorro;3065;1625;1440;3062;1620;1442;1470;2;750;2081;2076;5;10;473
200001000;5;1107;                    Loures;205054;98266;106788;196682;93335;103347;80464;67;63285;99262;99060;202;82;31095
200002000;6;110701;                        Apelação;5647;2785;2862;5467;2680;2787;1959;4;1591;2197;2193;4;5;662
200077000;6;110702;                        Bucelas;4663;2243;2420;4522;2151;2371;1893;1;1517;2612;2608;4;2;2063
200233000;6;110703;                        Camarate;19789;9513;10276;18971;9084;9887;7563;7;5965;9268;9201;67;8;3285
200528000;6;110705;                        Fanhões;2801;1403;1398;2735;1378;1357;1098;6;857;1429;1422;7;7;1284
200633000;6;110706;                        Frielas;2171;1088;1083;2100;1051;1049;817;0;668;1011;996;15;0;394
200683000;6;110707;                        Loures;27362;13071;14291;26242;12374;13868;10598;21;8481;13715;13700;15;21;5028
201172000;6;110708;                        Lousa;3169;1511;1658;3062;1459;1603;1268;3;981;1767;1766;1;5;1544
201302000;6;110709;                        Moscavide;14266;6560;7706;13745;6229;7516;6561;3;4379;7990;7990;0;3;1004
201409000;6;110712;                        Sacavém;18469;8708;9761;17612;8244;9368;7528;1;5658;9533;9531;2;2;1010
201551000;6;110713;                        Santa Iria de Azoia;18240;8836;9404;17537;8396;9141;7075;5;5883;8567;8559;8;7;3498
201984000;6;110714;                        Santo Antão do Tojal;4216;2097;2119;4037;1988;2049;1583;5;1310;2245;2241;4;6;1566
202101000;6;110715;                        São João da Talha;17252;8360;8892;16507;7920;8587;6465;5;5451;7630;7620;10;5;3336
202461000;6;110716;                        São Julião do Tojal;3837;1850;1987;3720;1771;1949;1430;2;1153;1793;1788;5;2;1452
202619000;6;110717;                        Unhos;9507;4668;4839;9159;4461;4698;3564;0;2914;4360;4346;14;0;2239
202800000;6;110719;                        Portela;11809;5517;6292;11290;5184;6106;4768;1;3826;5469;5464;5;1;367
202885000;6;110722;                        Bobadela;8839;4228;4611;8564;4060;4504;3679;1;2827;4364;4360;4;4;1123
203001000;6;110723;                        Prior Velho;7136;3570;3566;6951;3454;3497;2757;1;2005;3385;3362;23;3;515
203076000;6;110724;                        Santo António dos Cavaleiros;25881;12258;13623;24461;11451;13010;9858;1;7819;11927;11913;14;1;725
203251000;5;1109;                    Mafra;76685;37317;39368;73810;35601;38209;28887;31;23418;42895;42867;28;62;28002
203252000;6;110901;                        Azueira;3164;1536;1628;3092;1493;1599;1165;2;988;1581;1580;1;2;1394
203366000;6;110902;                        Carvoeira;2155;1062;1093;2004;978;1026;849;0;684;1659;1658;1;1;1392
203500000;6;110903;                        Cheleiros;1347;675;672;1310;654;656;542;1;407;789;789;0;1;704
203577000;6;110904;                        Encarnação;4798;2372;2426;4621;2257;2364;1703;3;1404;2427;2425;2;4;2102
203756000;6;110905;                        Enxara do Bispo;1740;847;893;1705;830;875;675;0;538;829;829;0;0;754
203839000;6;110906;                        Ericeira;10260;4968;5292;9831;4723;5108;4076;6;3078;9047;9041;6;24;4242
204230000;6;110907;                        Gradil;1226;571;655;1201;560;641;442;2;357;650;649;1;4;587
204291000;6;110908;                        Igreja Nova;3037;1522;1515;2950;1468;1482;1155;0;970;1541;1540;1;1;1384
204452000;6;110909;                        Mafra;17986;8673;9313;17318;8280;9038;6780;8;5543;9103;9102;1;15;5126
204971000;6;110910;                        Malveira;6493;3097;3396;6208;2931;3277;2564;2;1999;3286;3283;3;2;1246
205109000;6;110911;                        Milharado;7023;3470;3553;6836;3336;3500;2479;1;2111;3084;3081;3;1;2296
205338000;6;110912;                        Santo Estêvão das Galés;1709;828;881;1675;809;866;654;2;530;880;879;1;2;819
205464000;6;110913;                        Santo Isidoro;3814;1902;1912;3648;1806;1842;1436;0;1186;2366;2364;2;1;2221
205660000;6;110914;                        Sobral da Abelheira;1152;563;589;1111;542;569;453;0;353;630;627;3;0;598
205733000;6;110915;                        Vila Franca do Rosário;871;418;453;837;401;436;315;0;257;438;438;0;0;375
205774000;6;110916;                        Venda do Pinheiro;8146;3936;4210;7763;3691;4072;2931;4;2461;3718;3715;3;4;2153
206003000;6;110917;                        São Miguel de Alcainça;1764;877;887;1700;842;858;668;0;552;867;867;0;0;609
206054000;5;1110;                    Oeiras;172120;80137;91983;165497;76492;89005;71584;75;51876;86056;86015;41;106;18243
206055000;6;111002;                        Barcarena;13861;6749;7112;13330;6411;6919;5415;10;4266;6403;6392;11;10;2358
206317000;6;111003;                        Carnaxide;25911;12079;13832;24987;11540;13447;10098;5;7828;11719;11717;2;10;1596
206578000;6;111004;                        Oeiras e São Julião da Barra;33827;15241;18586;32403;14421;17982;14825;17;10124;18274;18260;14;24;2887
207016000;6;111005;                        Paço de Arcos;15315;6977;8338;14829;6774;8055;6998;6;4421;8964;8962;2;11;1466
207248000;6;111006;                        Algés;22273;10317;11956;21169;9720;11449;9562;3;6621;11675;11674;1;5;1318
207406000;6;111007;                        Cruz Quebrada-Dafundo;6393;2896;3497;6308;2836;3472;2925;5;1865;3633;3633;0;6;607
207470000;6;111008;                        Linda-a-Velha;19999;9194;10805;19113;8721;10392;8632;7;6225;10146;10145;1;11;1544
207666000;6;111009;                        Porto Salvo;15157;7250;7907;14570;6894;7676;5675;4;4650;6614;6611;3;8;2762
207941000;6;111010;                        Queijas;10377;4972;5405;9938;4726;5212;4081;11;3253;4680;4677;3;14;1925
208101000;6;111011;                        Caxias;9007;4462;4545;8850;4449;4401;3373;7;2623;3948;3944;4;7;1780
208254000;5;1111;                    Sintra;377835;180705;197130;361554;171452;190102;144160;119;114114;182673;182489;184;181;56903
208255000;6;111102;                        Algueirão-Mem Martins;66250;31600;34650;63034;29739;33295;25014;43;20052;30804;30787;17;47;7770
208899000;6;111103;                        Almargem do Bispo;8983;4401;4582;8645;4182;4463;3444;5;2801;4521;4517;4;8;3903
209201000;6;111104;                        Belas;26087;12691;13396;25057;12089;12968;9121;17;7602;11177;11165;12;10;2927
209521000;6;111105;                        Colares;7628;3623;4005;7434;3522;3912;3011;5;2318;6017;6007;10;24;5083
209798000;6;111106;                        Montelavar;3559;1740;1819;3429;1660;1769;1407;0;1108;1777;1775;2;2;1407
209898000;6;111107;                        Queluz;26248;12178;14070;25604;11954;13650;11139;4;7875;13682;13672;10;10;2040
210092000;6;111108;                        Rio de Mouro;47311;22567;24744;44882;21112;23770;17561;7;14277;21993;21966;27;10;5193
210588000;6;111109;                        Sintra (Santa Maria e São Miguel);9364;4410;4954;9028;4202;4826;3794;4;2897;4917;4913;4;14;2817
210732000;6;111110;                        São João das Lampas;11392;5600;5792;10989;5353;5636;4438;4;3504;6708;6694;14;5;6389
211153000;6;111111;                        Sintra (São Martinho);6226;2972;3254;6078;2889;3189;2385;3;1887;3535;3533;2;10;3189
211324000;6;111112;                        Sintra (São Pedro de Penaferrim);14001;7024;6977;13591;6797;6794;4812;13;4003;6290;6280;10;16;3730
211582000;6;111113;                        Terrugem;5113;2502;2611;4934;2405;2529;1976;2;1596;2505;2499;6;2;2175
211757000;6;111114;                        Pêro Pinheiro;4246;2083;2163;4190;2102;2088;1700;3;1293;2394;2392;2;6;1911
211889000;6;111115;                        Casal de Cambra;12701;6168;6533;12435;5999;6436;4529;1;3936;5737;5722;15;1;2041
212103000;6;111116;                        Massamá;28112;13374;14738;26623;12525;14098;10691;1;8527;12689;12679;10;3;1013
212309000;6;111117;                        Monte Abraão;20809;9798;11011;19787;9196;10591;8304;1;6216;10041;10037;4;1;618
212466000;6;111118;                        Agualva;35824;17015;18809;34047;16037;18010;13951;4;10954;17350;17328;22;5;2409
212800000;6;111119;                        Cacém;21289;10112;11177;20239;9473;10766;8229;1;6494;10012;10009;3;1;1217
212985000;6;111120;                        Mira-Sintra;5280;2522;2758;5087;2415;2672;2055;1;1664;2380;2378;2;5;393
213050000;6;111121;                        São Marcos;17412;8325;9087;16441;7801;8640;6599;0;5110;8144;8136;8;1;678
213149000;5;1114;                    Vila Franca de Xira;136886;65808;71078;132269;62861;69408;53396;33;42980;65075;64919;156;50;16984
213150000;6;111401;                        Alhandra;6047;2802;3245;5935;2735;3200;2591;3;1856;3191;3190;1;2;1041
213251000;6;111402;                        Alverca do Ribatejo;31070;14918;16152;29926;14205;15721;12494;8;9866;14827;14808;19;18;3394
213701000;6;111403;                        Cachoeiras;766;383;383;758;372;386;300;1;242;368;366;2;1;363
213755000;6;111404;                        Calhandriz;801;374;427;809;377;432;313;1;260;476;476;0;1;446
213806000;6;111405;                        Castanheira do Ribatejo;7500;3623;3877;7260;3466;3794;2893;5;2313;3569;3557;12;6;989
213924000;6;111406;                        Póvoa de Santa Iria;29348;14249;15099;28235;13519;14716;10893;1;9176;12860;12854;6;1;1582
214163000;6;111407;                        São João dos Montes;6018;2962;3056;5806;2808;2998;2267;1;1936;2869;2862;7;1;1972
214402000;6;111408;                        Vialonga;21033;10192;10841;20172;9680;10492;7813;2;6639;9319;9271;48;2;2701
214743000;6;111409;                        Vila Franca de Xira;18197;8579;9618;17842;8334;9508;7565;7;5651;10091;10045;46;12;2909
215045000;6;111410;                        Sobralinho;5050;2457;2593;4840;2317;2523;1986;0;1608;2418;2405;13;2;863
215134000;6;111411;                        Forte da Casa;11056;5269;5787;10686;5048;5638;4281;4;3433;5087;5085;2;4;724
215255000;5;1115;                    Amadora;175136;82342;92794;169021;78904;90117;73433;20;53062;88002;87939;63;34;13696
215256000;6;111501;                        Alfragide;9904;4708;5196;9531;4487;5044;3859;3;2912;4502;4501;1;5;514
215339000;6;111502;                        Brandoa;17805;8535;9270;17146;8129;9017;6905;1;5365;8356;8348;8;1;1459
215458000;6;111503;                        Buraca;16081;7599;8482;15523;7283;8240;6275;5;4666;7347;7342;5;6;1511
215589000;6;111504;                        Damaia;20894;9734;11160;19989;9219;10770;9384;0;6406;11420;11393;27;0;1503
215737000;6;111505;                        Falagueira;14531;6820;7711;14110;6568;7542;6114;2;4475;7022;7020;2;3;1069
215834000;6;111506;                        Mina;17977;8445;9532;17133;7992;9141;7570;1;5546;9233;9226;7;2;1981
215965000;6;111507;                        Reboleira;14344;6558;7786;13659;6177;7482;6816;1;4281;8616;8615;1;2;635
216070000;6;111508;                        Venteira;18539;8534;10005;18721;8722;9999;8458;3;5789;10494;10491;3;10;1326
216210000;6;111509;                        Alfornelos;10439;4880;5559;10000;4614;5386;4393;1;3129;4945;4942;3;1;348
216270000;6;111510;                        São Brás;26263;12625;13638;25189;12000;13189;9829;2;8041;11419;11417;2;3;2192
216575000;6;111511;                        Venda Nova;8359;3904;4455;8020;3713;4307;3830;1;2452;4648;4644;4;1;1158
216668000;5;1116;                    Odivelas;144549;68817;75732;138238;65141;73097;57744;38;44746;69198;69042;156;40;16344
216669000;6;111601;                        Caneças;12324;5952;6372;11934;5711;6223;4548;16;3764;5527;5517;10;16;2944
216865000;6;111602;                        Famões;11095;5431;5664;10620;5143;5477;3865;8;3403;4931;4921;10;8;2841
217173000;6;111603;                        Odivelas;59559;28131;31428;56796;26521;30275;24581;5;18468;29422;29361;61;6;3521
217620000;6;111604;                        Olival Basto;5812;2767;3045;5553;2621;2932;2541;0;1778;3029;3017;12;0;663
217673000;6;111605;                        Pontinha;23041;11027;12014;22142;10521;11621;9348;2;7067;11531;11495;36;3;3207
217925000;6;111606;                        Póvoa de Santo Adrião;13061;6117;6944;12371;5722;6649;5302;0;4108;6261;6247;14;0;949
218007000;6;111607;                        Ramada;19657;9392;10265;18822;8902;9920;7559;7;6158;8497;8484;13;7;2219
218239000;4;172;                Península de Setúbal;779399;373473;405926;748700;354460;394240;312122;287;242330;420560;419681;879;430;171570
218240000;5;1502;                    Alcochete;17569;8494;9075;16855;8052;8803;6794;4;5407;8818;8813;5;11;4575
218241000;6;150201;                        Alcochete;12239;5902;6337;11736;5609;6127;4703;3;3759;6215;6213;2;10;2952
218472000;6;150202;                        Samouco;3143;1535;1608;3013;1444;1569;1257;0;970;1559;1558;1;0;853
218537000;6;150203;                        São Francisco;2187;1057;1130;2106;999;1107;834;1;678;1044;1042;2;1;770
218583000;5;1503;                    Almada;174030;82496;91534;168490;79183;89307;71901;53;53485;101443;101146;297;93;34163
218584000;6;150301;                        Almada;16584;7480;9104;15891;7112;8779;7927;8;5090;10369;10358;11;8;1672
218715000;6;150302;                        Caparica;20454;9846;10608;20202;9649;10553;7916;4;6094;10947;10931;16;7;3430
218980000;6;150303;                        Costa da Caparica;13418;6384;7034;13136;6228;6908;6135;2;3985;13964;13935;29;26;3362
219206000;6;150304;                        Cova da Piedade;19904;9082;10822;18935;8525;10410;8925;1;6341;10897;10892;5;2;1905
219376000;6;150305;                        Trafaria;5696;2774;2922;5476;2630;2846;2319;0;1678;3288;3104;184;2;2022
219488000;6;150306;                        Cacilhas;6017;2684;3333;5729;2534;3195;2818;0;1886;3721;3721;0;1;457
219536000;6;150307;                        Pragal;7156;3394;3762;7603;3590;4013;2840;1;2161;3377;3374;3;5;465
219592000;6;150308;                        Sobreda;15166;7287;7879;14626;6922;7704;5630;13;4711;6908;6891;17;13;4024
219840000;6;150309;                        Charneca de Caparica;29763;14647;15116;28604;13899;14705;11131;21;9197;18186;18178;8;24;12865
220687000;6;150310;                        Laranjeiro;20988;9941;11047;20256;9611;10645;8523;2;6430;10540;10524;16;4;1480
220838000;6;150311;                        Feijó;18884;8977;9907;18032;8483;9549;7737;1;5912;9246;9238;8;1;2481
221028000;5;1504;                    Barreiro;78764;37347;41417;75961;35607;40354;33174;22;25000;41739;41682;57;33;11008
221029000;6;150401;                        Barreiro;7449;3476;3973;7221;3319;3902;3394;4;2262;4967;4958;9;6;1729
221155000;6;150402;                        Lavradio;14428;6854;7574;13849;6505;7344;5944;5;4622;7296;7294;2;5;1442
221316000;6;150403;                        Palhais;1869;910;959;1802;861;941;754;0;595;915;905;10;1;588
221376000;6;150404;                        Santo André;11480;5538;5942;11012;5238;5774;4769;3;3703;5685;5677;8;4;1571
221511000;6;150405;                        Verderena;10285;4834;5451;9787;4560;5227;4654;0;3259;5721;5718;3;2;824
221593000;6;150406;                        Alto do Seixalinho;19995;9334;10661;19624;9072;10552;8656;4;6398;10924;10916;8;8;1717
221757000;6;150407;                        Santo António da Charneca;11536;5575;5961;10996;5253;5743;4313;6;3621;5332;5317;15;7;2588
221980000;6;150408;                        Coina;1722;826;896;1670;799;871;690;0;540;899;897;2;0;549
222026000;5;1506;                    Moita;66029;31708;34321;62833;29678;33155;26137;14;20382;34659;34623;36;14;12398
222027000;6;150601;                        Alhos Vedros;15050;7380;7670;14266;6845;7421;5970;6;4669;8210;8199;11;6;3723
222274000;6;150602;                        Baixa da Banheira;21085;9985;11100;20080;9352;10728;8879;1;6638;11767;11758;9;1;3060
222467000;6;150603;                        Moita;17653;8488;9165;16832;7978;8854;6878;5;5535;9017;9008;9;5;3796
222727000;6;150604;                        Gaio-Rosário;1227;620;607;1160;579;581;464;0;367;591;591;0;0;536
222747000;6;150605;                        Sarilhos Pequenos;1150;540;610;1129;524;605;437;1;352;620;619;1;1;488
222771000;6;150606;                        Vale da Amoreira;9864;4695;5169;9366;4400;4966;3509;1;2821;4454;4448;6;1;795
222861000;5;1507;                    Montijo;51222;24723;26499;49327;23582;25745;20576;25;15990;26733;26671;62;33;12996
222862000;6;150701;                        Canha;1689;819;870;1645;790;855;683;4;520;1200;1200;0;5;1175
222969000;6;150702;                        Montijo;29908;14259;15649;28720;13569;15151;12158;11;9296;15565;15535;30;16;5299
223501000;6;150703;                        Santo Isidro de Pegões;1538;753;785;1508;733;775;603;0;489;806;798;8;0;720
223571000;6;150704;                        Sarilhos Grandes;3424;1666;1758;3324;1600;1724;1376;2;1077;1751;1746;5;2;1577
223720000;6;150705;                        Alto-Estanqueiro-Jardia;2846;1379;1467;2793;1342;1451;1100;2;894;1301;1298;3;3;1281
223847000;6;150706;                        Pegões;2375;1176;1199;2293;1120;1173;920;4;733;1142;1132;10;4;991
223939000;6;150707;                        Atalaia;2239;1087;1152;2168;1050;1118;863;1;703;1146;1145;1;1;688
224033000;6;150708;                        Afonsoeiro;7203;3584;3619;6876;3378;3498;2873;1;2278;3822;3817;5;2;1265
224181000;5;1508;                    Palmela;62831;30486;32345;60417;28971;31446;23677;46;19679;33141;33073;68;55;21631
224182000;6;150801;                        Marateca;3724;1853;1871;3650;1811;1839;1437;2;1175;1843;1840;3;4;1674
224305000;6;150802;                        Palmela;17481;8462;9019;16769;8029;8740;6513;18;5458;9022;9007;15;22;6488
224803000;6;150803;                        Pinhal Novo;25003;12035;12968;23965;11354;12611;9515;15;7827;12489;12479;10;18;5541
225227000;6;150804;                        Quinta do Anjo;11865;5825;6040;11392;5534;5858;4455;8;3739;7380;7363;17;8;5722
225787000;6;150805;                        Poceirão;4758;2311;2447;4641;2243;2398;1757;3;1480;2407;2384;23;3;2206
225943000;5;1510;                    Seixal;158269;75916;82353;150664;71299;79365;62261;51;49684;79486;79305;181;66;30124
225944000;6;151001;                        Aldeia de Paio Pires;13258;6433;6825;12549;5976;6573;5235;1;4134;6415;6404;11;2;1634
226075000;6;151002;                        Amora;48629;23185;25444;46092;21685;24407;19554;16;15141;23933;23840;93;17;6464
226650000;6;151003;                        Arrentela;28886;13782;15104;27267;12810;14457;11337;6;9082;14364;14338;26;8;3849
227041000;6;151004;                        Seixal;2776;1304;1472;2637;1225;1412;1242;0;856;1884;1882;2;1;662
227099000;6;151005;                        Corroios;47661;22843;24818;45495;21515;23980;18651;14;15022;22820;22807;13;14;8256
227789000;6;151006;                        Fernão Ferro;17059;8369;8690;16624;8088;8536;6242;14;5449;10070;10034;36;24;9259
228604000;5;1511;                    Sesimbra;49500;24317;25183;47506;23037;24469;19274;30;15399;31792;31761;31;45;20433
228605000;6;151101;                        Sesimbra (Castelo);19053;9429;9624;18172;8881;9291;7271;8;5963;13567;13554;13;14;10567
229365000;6;151102;                        Sesimbra (Santiago);4841;2352;2489;4785;2299;2486;2120;4;1534;6038;6032;6;12;1467
229517000;6;151103;                        Quinta do Conde;25606;12536;13070;24549;11857;12692;9883;18;7902;12187;12175;12;19;8399
229999000;5;1512;                    Setúbal;121185;57986;63199;116647;55051;61596;48328;42;37304;62749;62607;142;80;24242
230000000;6;151201;                        Setúbal (Nossa Senhora da Anunciada);13738;6441;7297;13254;6108;7146;5759;9;4159;7761;7750;11;23;3483
230213000;6;151202;                        Setúbal (Santa Maria da Graça);7620;3528;4092;7270;3345;3925;3505;1;2317;4779;4772;7;5;1104
230336000;6;151203;                        Setúbal (São Julião);16740;7669;9071;15703;7106;8597;7091;7;5120;9403;9396;7;12;1496
230506000;6;151204;                        São Lourenço;11638;5656;5982;11270;5393;5877;4335;6;3595;6272;6259;13;9;4850
230815000;6;151205;                        Setúbal (São Sebastião);52542;25329;27213;50772;24083;26689;20713;11;16184;25811;25725;86;20;5886
231343000;6;151206;                        São Simão;7239;3494;3745;7050;3381;3669;2602;5;2227;3753;3745;8;6;3449
231619000;6;151207;                        Gâmbia-Pontes-Alto da Guerra;5885;2954;2931;5722;2828;2894;2132;3;1819;2509;2502;7;5;1929
231754000;6;151208;                        Sado;5783;2915;2868;5606;2807;2799;2191;0;1883;2461;2458;3;0;2045
