ordem;nivel;cod_dim2;Zona Geográfica;População residente - Total;População residente - H;População residente - M;População presente - Total;População presente - H;População presente - M;Famílias - Clássicas ;Famílias - Institucionais;Núcleos familiares ;Alojamentos familiares - Total ;Alojamentos familiares - Clássicos;Alojamentos familiares - Não clássicos;Alojamentos colectivos;Edifícios clássicos
3000;3;11;            Norte;3689682;1766260;1923422;3583442;1695397;1888045;1330892;1235;1133106;1847784;1846589;1195;3106;1209911
4000;4;111;                Minho-Lima;244836;114369;130467;236467;109183;127284;89590;86;75101;150481;150414;67;418;120886
5000;5;1601;                    Arcos de Valdevez;22847;10429;12418;22253;10078;12175;9138;12;7020;17261;17252;9;36;15350
6000;6;160101;                        Aboim das Choças;333;150;183;328;143;185;131;0;105;209;209;0;0;208
41000;6;160102;                        Aguiã;705;354;351;679;337;342;257;0;225;455;455;0;0;444
108000;6;160103;                        Alvora;261;104;157;258;106;152;122;0;76;205;205;0;0;204
138000;6;160104;                        Ázere;247;111;136;243;110;133;101;0;81;182;182;0;0;176
160000;6;160105;                        Cabana Maior;239;96;143;231;92;139;117;0;76;407;407;0;0;404
210000;6;160106;                        Cabreiro;428;177;251;420;171;249;195;0;140;356;356;0;0;354
255000;6;160107;                        Carralcova;124;50;74;122;49;73;69;0;36;141;141;0;0;135
276000;6;160108;                        Cendufe;360;168;192;351;160;191;128;0;108;214;214;0;0;210
310000;6;160109;                        Couto;615;286;329;592;279;313;249;1;189;479;479;0;1;474
368000;6;160110;                        Eiras;269;128;141;269;130;139;114;0;88;189;189;0;0;189
395000;6;160111;                        Ermelo;92;43;49;92;43;49;48;0;29;165;165;0;0;165
413000;6;160112;                        Extremo;160;73;87;158;72;86;60;0;49;99;99;0;0;99
434000;6;160113;                        Gavieira;298;128;170;290;122;168;141;0;95;554;554;0;3;555
471000;6;160114;                        Giela;514;231;283;508;222;286;192;0;149;341;339;2;0;209
493000;6;160115;                        Gondoriz;958;429;529;916;407;509;398;0;293;707;706;1;0;697
560000;6;160116;                        Grade;393;180;213;400;182;218;145;1;111;311;311;0;1;312
593000;6;160117;                        Guilhadeses;1119;520;599;1054;486;568;401;1;341;573;573;0;1;503
657000;6;160118;                        Loureda;195;86;109;170;75;95;85;0;63;142;142;0;0;142
676000;6;160119;                        Jolda (Madalena);350;172;178;338;165;173;126;0;105;223;223;0;2;223
705000;6;160120;                        Mei;118;53;65;106;46;60;46;0;35;78;78;0;0;78
716000;6;160121;                        Miranda;325;140;185;324;139;185;158;0;98;368;368;0;0;368
751000;6;160122;                        Monte Redondo;227;102;125;232;101;131;93;0;69;195;195;0;0;192
776000;6;160123;                        Oliveira;330;140;190;323;136;187;127;0;103;233;233;0;0;222
797000;6;160124;                        Paçô;933;449;484;877;421;456;330;1;291;641;641;0;6;509
835000;6;160125;                        Padroso;234;106;128;231;103;128;106;0;74;224;224;0;0;224
853000;6;160126;                        Parada;383;189;194;381;189;192;146;0;128;329;329;0;1;222
876000;6;160127;                        Portela;260;117;143;250;111;139;114;0;84;181;181;0;0;181
896000;6;160128;                        Prozelo;943;452;491;919;438;481;346;1;269;552;552;0;1;510
937000;6;160129;                        Rio Cabrão;135;64;71;137;65;72;51;0;46;78;78;0;0;78
949000;6;160130;                        Rio Frio;684;306;378;681;303;378;308;1;202;634;634;0;2;629
1007000;6;160131;                        Rio de Moinhos;438;198;240;441;200;241;176;0;131;312;312;0;0;311
1040000;6;160132;                        Sá;138;58;80;142;59;83;62;0;41;124;124;0;0;124
1058000;6;160133;                        Sabadim;468;220;248;457;214;243;189;0;147;333;333;0;0;331
1090000;6;160134;                        Arcos de Valdevez (Salvador);1079;499;580;1038;473;565;463;0;328;815;815;0;5;303
1126000;6;160135;                        Padreiro (Salvador);301;132;169;304;133;171;111;0;92;186;186;0;0;168
1155000;6;160136;                        Padreiro (Santa Cristina);76;35;41;80;38;42;43;0;22;99;98;1;0;98
1167000;6;160137;                        Távora (Santa Maria);690;337;353;656;318;338;252;0;222;417;417;0;0;407
1220000;6;160138;                        Santar;164;79;85;160;78;82;57;0;49;81;81;0;0;80
1235000;6;160139;                        São Cosme e São Damião;190;85;105;186;82;104;77;0;60;172;172;0;0;164
1248000;6;160140;                        São Jorge;714;325;389;705;318;387;290;1;204;566;565;1;1;551
1294000;6;160141;                        Arcos de Valdevez (São Paio);1147;529;618;1094;498;596;453;1;350;829;829;0;4;446
1343000;6;160142;                        Jolda (São Paio);360;165;195;344;151;193;115;0;108;202;200;2;0;200
1366000;6;160143;                        Távora (São Vicente);265;123;142;263;122;141;117;0;91;184;184;0;0;184
1386000;6;160144;                        Senharei;259;116;143;228;104;124;122;0;88;229;228;1;0;229
1410000;6;160145;                        Sistelo;273;110;163;268;108;160;116;0;86;221;221;0;0;219
1431000;6;160146;                        Soajo;986;409;577;967;399;568;500;0;314;1076;1076;0;1;1068
1515000;6;160147;                        Souto;622;286;336;598;277;321;204;0;182;377;376;1;0;364
1554000;6;160148;                        Tabaçô;355;173;182;354;173;181;124;0;109;164;164;0;0;159
1572000;6;160149;                        Vale;776;366;410;766;354;412;286;1;247;543;543;0;1;542
1622000;6;160150;                        Vila Fonche;1118;488;630;1128;486;642;394;3;326;692;692;0;6;313
1656000;6;160151;                        Vilela;196;92;104;194;90;104;83;0;65;174;174;0;0;173
1673000;5;1602;                    Caminha;16684;7737;8947;16025;7359;8666;6257;7;5104;13892;13886;6;59;9318
1674000;6;160201;                        Âncora;1182;576;606;1140;544;596;401;0;368;718;717;1;1;600
1738000;6;160202;                        Arga de Baixo;74;28;46;70;26;44;34;0;22;64;64;0;0;64
1754000;6;160203;                        Arga de Cima;73;33;40;73;33;40;29;0;25;46;46;0;0;46
1764000;6;160204;                        Arga de São João;61;26;35;61;26;35;22;0;17;32;32;0;0;32
1772000;6;160205;                        Argela;393;186;207;368;173;195;143;0;114;257;257;0;1;248
1801000;6;160206;                        Azevedo;158;77;81;156;75;81;53;0;47;96;96;0;1;95
1822000;6;160207;                        Caminha (Matriz);1346;564;782;1310;544;766;535;2;359;1240;1239;1;8;612
1865000;6;160208;                        Cristelo;244;121;123;271;151;120;95;0;79;244;244;0;32;261
1880000;6;160209;                        Dem;363;164;199;363;162;201;116;0;116;188;188;0;0;185
1902000;6;160210;                        Gondar;222;98;124;210;89;121;57;0;66;82;82;0;0;81
1917000;6;160211;                        Lanhelas;991;453;538;926;423;503;362;0;306;573;572;1;1;542
1951000;6;160212;                        Moledo;1322;602;720;1270;579;691;535;0;421;1891;1891;0;3;1228
2026000;6;160213;                        Orbacém;213;92;121;200;87;113;71;0;66;134;134;0;0;134
2047000;6;160214;                        Riba de Âncora;723;324;399;666;291;375;260;0;226;417;417;0;0;412
2087000;6;160215;                        Seixas;1502;698;804;1441;657;784;548;2;456;1208;1208;0;3;1018
2146000;6;160216;                        Venade;817;390;427;800;373;427;293;0;250;539;537;2;0;531
2196000;6;160217;                        Vila Praia de Âncora;4820;2271;2549;4639;2162;2477;1929;3;1475;4692;4692;0;7;1964
2292000;6;160218;                        Vilar de Mouros;753;357;396;694;325;369;271;0;239;536;535;1;0;520
2328000;6;160219;                        Vilarelho;1125;532;593;1070;496;574;410;0;356;785;785;0;2;600
2357000;6;160220;                        Vile;302;145;157;297;143;154;93;0;96;150;150;0;0;145
2376000;5;1603;                    Melgaço;9213;4076;5137;9020;4002;5018;3839;5;2929;7583;7583;0;20;7004
2377000;6;160301;                        Alvaredo;528;229;299;518;225;293;199;0;176;322;322;0;1;321
2419000;6;160302;                        Castro Laboreiro;540;204;336;529;197;332;256;0;161;1006;1006;0;4;1003
2513000;6;160303;                        Chaviães;385;172;213;368;167;201;165;0;125;318;318;0;0;317
2542000;6;160304;                        Cousso;294;122;172;281;119;162;135;0;102;267;267;0;0;265
2571000;6;160305;                        Cristoval;528;231;297;498;219;279;231;0;170;443;443;0;0;441
2624000;6;160306;                        Cubalhão;156;69;87;154;68;86;72;0;57;138;138;0;0;138
2640000;6;160307;                        Fiães;239;103;136;236;103;133;117;0;82;215;215;0;0;215
2672000;6;160308;                        Gave;237;93;144;227;88;139;114;0;72;276;276;0;0;275
2703000;6;160309;                        Lamas de Mouro;117;48;69;108;46;62;47;0;43;108;108;0;1;109
2718000;6;160310;                        Paços;317;145;172;302;137;165;134;0;102;249;249;0;0;247
2749000;6;160311;                        Paderne;1160;511;649;1150;497;653;461;1;366;763;763;0;3;758
2838000;6;160312;                        Parada do Monte;370;150;220;351;139;212;173;0;115;509;509;0;0;506
2884000;6;160313;                        Penso;523;248;275;501;237;264;209;0;182;410;410;0;0;410
2925000;6;160314;                        Prado;452;220;232;493;258;235;183;1;147;270;270;0;3;267
2965000;6;160315;                        Remoães;98;47;51;94;46;48;42;0;32;76;76;0;0;76
2980000;6;160316;                        Roussas;1107;496;611;1077;482;595;402;1;327;691;691;0;1;561
3050000;6;160317;                        São Paio;602;277;325;590;270;320;252;0;194;439;439;0;1;440
3105000;6;160318;                        Vila;1560;711;849;1543;704;839;647;2;476;1083;1083;0;6;655
3163000;5;1604;                    Monção;19230;8728;10502;18639;8407;10232;7441;8;5968;13377;13377;0;30;11713
3164000;6;160401;                        Abedim;205;85;120;198;82;116;86;0;65;180;180;0;0;180
3183000;6;160402;                        Anhões;140;57;83;138;56;82;67;0;42;106;106;0;0;106
3201000;6;160403;                        Badim;178;70;108;174;72;102;80;0;55;147;147;0;0;146
3228000;6;160404;                        Barbeita;1016;475;541;971;454;517;362;1;316;603;603;0;2;598
3306000;6;160405;                        Barroças e Taias;319;157;162;317;157;160;120;0;100;214;214;0;0;209
3334000;6;160406;                        Bela;698;327;371;676;317;359;263;0;223;442;442;0;0;441
3385000;6;160407;                        Cambeses;496;216;280;476;205;271;187;0;150;336;336;0;0;335
3415000;6;160408;                        Ceivães;492;237;255;470;220;250;206;0;149;384;384;0;0;384
3454000;6;160409;                        Lapela;223;99;124;211;94;117;85;0;70;145;145;0;1;142
3471000;6;160410;                        Lara;266;119;147;259;115;144;96;0;76;192;192;0;0;191
3496000;6;160411;                        Longos Vales;989;451;538;951;426;525;377;0;300;651;651;0;0;650
3565000;6;160412;                        Lordelo;116;60;56;116;60;56;45;0;40;82;82;0;0;82
3578000;6;160413;                        Luzio;120;50;70;119;50;69;55;0;39;108;108;0;0;108
3592000;6;160414;                        Mazedo;1859;868;991;1764;815;949;684;1;595;1202;1202;0;2;710
3668000;6;160415;                        Merufe;1097;477;620;1049;449;600;409;0;336;685;685;0;0;680
3729000;6;160416;                        Messegães;253;119;134;249;116;133;111;0;84;206;206;0;0;199
3749000;6;160417;                        Monção;2469;1132;1337;2465;1122;1343;912;4;744;1583;1583;0;20;898
3817000;6;160418;                        Moreira;615;277;338;603;270;333;248;0;192;422;422;0;0;419
3851000;6;160419;                        Parada;107;48;59;100;46;54;41;0;32;72;72;0;0;72
3864000;6;160420;                        Pias;854;401;453;821;386;435;338;0;270;574;574;0;0;572
3920000;6;160421;                        Pinheiros;345;156;189;332;150;182;130;0;111;228;228;0;0;214
3947000;6;160422;                        Podame;278;121;157;271;118;153;119;1;80;224;224;0;1;225
3975000;6;160423;                        Portela;242;112;130;241;113;128;105;0;80;208;208;0;0;204
3996000;6;160424;                        Riba de Mouro;964;372;592;913;344;569;397;0;298;1031;1031;0;0;1010
4084000;6;160425;                        Sá;200;87;113;197;85;112;82;0;66;146;146;0;1;146
4104000;6;160426;                        Sago;225;103;122;218;103;115;88;0;70;177;177;0;0;177
4129000;6;160427;                        Segude;356;157;199;351;153;198;137;0;117;237;237;0;1;237
4164000;6;160428;                        Tangil;768;330;438;749;318;431;327;0;236;584;584;0;0;578
4227000;6;160429;                        Troporiz;274;120;154;270;118;152;101;0;80;198;198;0;0;197
4251000;6;160430;                        Troviscoso;1066;516;550;1049;507;542;390;1;332;679;679;0;1;667
4308000;6;160431;                        Trute;277;113;164;274;115;159;111;0;76;210;210;0;0;208
4331000;6;160432;                        Valadares;205;95;110;203;94;109;80;0;65;164;164;0;1;165
4351000;6;160433;                        Cortes;1518;721;797;1444;677;767;602;0;479;957;957;0;0;563
4397000;5;1605;                    Paredes de Coura;9198;4373;4825;8912;4211;4701;3504;3;2849;6067;6065;2;17;5725
4398000;6;160501;                        Agualonga;295;129;166;297;133;164;115;0;94;210;210;0;1;208
4425000;6;160502;                        Bico;466;220;246;440;204;236;168;1;132;321;321;0;3;324
4472000;6;160503;                        Castanheira;631;309;322;609;295;314;229;0;195;356;355;1;0;352
4513000;6;160504;                        Cossourado;319;150;169;317;146;171;127;0;101;266;266;0;0;265
4551000;6;160505;                        Coura;374;173;201;373;174;199;153;0;123;305;305;0;0;302
4594000;6;160506;                        Cristelo;317;151;166;307;146;161;113;0;106;191;191;0;0;186
4619000;6;160507;                        Cunha;529;255;274;498;241;257;186;0;166;295;295;0;0;291
4652000;6;160508;                        Ferreira;425;195;230;408;186;222;177;0;133;347;347;0;3;350
4696000;6;160509;                        Formariz;573;275;298;551;262;289;220;0;186;366;366;0;0;362
4730000;6;160510;                        Infesta;450;212;238;449;210;239;178;0;144;329;329;0;0;328
4763000;6;160511;                        Insalde;364;167;197;360;164;196;146;0;110;246;246;0;0;246
4794000;6;160512;                        Linhares;198;97;101;197;96;101;77;0;65;151;151;0;2;152
4816000;6;160513;                        Mozelos;347;169;178;338;166;172;131;1;109;223;223;0;2;224
4843000;6;160514;                        Padornelo;437;205;232;427;198;229;171;0;133;265;264;1;0;263
4878000;6;160515;                        Parada;298;142;156;295;137;158;113;0;84;184;184;0;0;183
4902000;6;160516;                        Paredes de Coura;1581;764;817;1486;713;773;588;1;460;877;877;0;2;570
4948000;6;160517;                        Porreiras;95;51;44;95;51;44;42;0;29;60;60;0;0;57
4959000;6;160518;                        Resende;518;253;265;503;242;261;180;0;170;278;278;0;1;270
4991000;6;160519;                        Romarigães;246;108;138;248;107;141;97;0;76;200;200;0;0;200
5023000;6;160520;                        Rubiães;512;242;270;501;239;262;204;0;164;421;421;0;3;416
5072000;6;160521;                        Vascões;223;106;117;213;101;112;89;0;69;176;176;0;0;176
5097000;5;1606;                    Ponte da Barca;12061;5596;6465;11596;5330;6266;4471;3;3700;7953;7951;2;15;6800
5098000;6;160601;                        Azias;377;173;204;367;169;198;154;0;117;333;333;0;0;332
5142000;6;160602;                        Boivães;289;141;148;281;135;146;100;0;86;158;158;0;0;158
5175000;6;160603;                        Bravães;629;283;346;603;268;335;218;0;187;332;332;0;0;308
5224000;6;160604;                        Britelo;485;233;252;448;212;236;216;0;154;468;466;2;5;457
5266000;6;160605;                        Crasto;458;209;249;448;204;244;161;0;147;269;269;0;0;268
5306000;6;160606;                        Cuide de Vila Verde;344;157;187;339;155;184;121;0;105;201;201;0;0;196
5334000;6;160607;                        Entre Ambos-os-Rios;502;227;275;465;205;260;208;0;166;419;419;0;2;417
5363000;6;160608;                        Ermida;61;31;30;59;30;29;26;0;21;65;65;0;0;65
5369000;6;160609;                        Germil;49;22;27;45;20;25;24;0;17;47;47;0;0;46
5382000;6;160610;                        Grovelas;203;99;104;196;92;104;67;0;60;94;94;0;0;91
5401000;6;160611;                        Lavradas;875;396;479;825;373;452;307;0;273;477;477;0;0;463
5466000;6;160612;                        Lindoso;427;198;229;404;178;226;179;0;135;359;359;0;1;356
5489000;6;160613;                        Nogueira;410;195;215;394;186;208;138;0;125;209;209;0;0;208
5522000;6;160614;                        Oleiros;466;224;242;446;208;238;172;0;141;263;263;0;0;260
5565000;6;160615;                        Paço Vedro de Magalhães;967;471;496;938;457;481;361;0;302;694;694;0;0;550
5604000;6;160616;                        Ponte da Barca;2371;1067;1304;2287;1018;1269;860;3;693;1367;1367;0;7;522
5652000;6;160617;                        Ruivos;221;101;120;220;100;120;76;0;61;125;125;0;0;125
5674000;6;160618;                        Touvedo (Salvador);167;85;82;154;79;75;61;0;54;99;99;0;0;91
5692000;6;160619;                        Sampriz;342;146;196;344;148;196;131;0;104;263;263;0;0;263
5724000;6;160620;                        Vila Chã (Santiago);139;69;70;136;66;70;62;0;41;190;190;0;0;168
5741000;6;160621;                        Vila Chã (São João Baptista);484;222;262;461;209;252;183;0;152;377;377;0;0;371
5777000;6;160622;                        Touvedo (São Lourenço);210;98;112;205;96;109;86;0;69;182;182;0;0;182
5800000;6;160623;                        Vade (São Pedro);264;126;138;255;123;132;87;0;77;169;169;0;0;159
5822000;6;160624;                        Vade (São Tomé);287;126;161;275;120;155;104;0;91;194;194;0;0;164
5845000;6;160625;                        Vila Nova de Muía;1034;497;537;1001;479;522;369;0;322;599;599;0;0;580
5896000;5;1607;                    Ponte de Lima;43498;20503;22995;41874;19384;22490;14406;11;12946;21872;21867;5;105;19654
5897000;6;160701;                        Anais;1073;501;572;983;449;534;353;0;328;535;535;0;0;522
5951000;6;160702;                        Arca;885;427;458;829;396;433;312;0;258;487;487;0;2;281
5972000;6;160703;                        Arcos;640;282;358;630;274;356;216;0;191;326;325;1;7;330
6004000;6;160704;                        Arcozelo;3734;1786;1948;3582;1704;1878;1236;0;1113;1745;1744;1;13;1438
6074000;6;160705;                        Ardegão;233;118;115;220;107;113;78;0;65;125;125;0;1;122
6095000;6;160706;                        Bárrio;359;179;180;354;178;176;124;0;110;194;194;0;1;191
6114000;6;160707;                        Beiral do Lima;558;260;298;552;256;296;208;0;168;403;403;0;0;403
6145000;6;160708;                        Bertiandos;414;190;224;403;182;221;142;0;125;188;188;0;0;178
6157000;6;160709;                        Boalhosa;163;71;92;166;71;95;66;0;52;138;138;0;0;138
6167000;6;160710;                        Brandara;442;211;231;428;201;227;150;0;132;224;224;0;0;214
6190000;6;160711;                        Cabaços;671;302;369;648;285;363;213;0;204;340;340;0;1;338
6227000;6;160712;                        Cabração;118;51;67;116;51;65;57;0;37;132;132;0;2;134
6245000;6;160713;                        Calheiros;991;463;528;930;421;509;317;0;304;456;456;0;2;455
6296000;6;160714;                        Calvelo;685;324;361;643;300;343;246;0;215;388;388;0;0;378
6322000;6;160715;                        Cepões;562;263;299;528;240;288;185;0;173;279;279;0;0;272
6351000;6;160716;                        Correlhã;2936;1405;1531;2790;1314;1476;923;1;855;1210;1210;0;6;1106
6428000;6;160717;                        Estorãos;464;224;240;450;214;236;178;0;137;356;356;0;9;304
6459000;6;160718;                        Facha;1529;720;809;1495;692;803;485;0;451;670;670;0;4;664
6509000;6;160719;                        Feitosa;1363;676;687;1314;639;675;466;0;419;731;731;0;2;427
6548000;6;160720;                        Fojo Lobal;280;137;143;250;111;139;99;0;77;152;152;0;1;152
6564000;6;160721;                        Fontão;1101;524;577;1079;510;569;344;1;324;516;516;0;5;508
6604000;6;160722;                        Fornelos;1638;768;870;1566;719;847;513;1;490;732;732;0;3;677
6666000;6;160723;                        Freixo;1209;560;649;1154;520;634;410;1;357;662;661;1;5;643
6712000;6;160724;                        Friastelas;450;208;242;441;201;240;142;0;136;262;262;0;0;258
6741000;6;160725;                        Gaifar;266;118;148;260;115;145;105;0;89;165;165;0;0;161
6759000;6;160726;                        Gandra;1108;520;588;1087;508;579;374;1;340;575;575;0;2;555
6795000;6;160727;                        Gemieira;598;277;321;545;252;293;199;0;171;304;304;0;1;303
6827000;6;160728;                        Gondufe;450;212;238;440;204;236;142;0;136;270;270;0;0;266
6851000;6;160729;                        Labruja;439;206;233;432;203;229;152;0;134;267;267;0;1;259
6881000;6;160730;                        Labrujó;127;64;63;124;60;64;42;0;31;77;77;0;0;75
6892000;6;160731;                        Mato;312;154;158;305;149;156;108;0;97;168;168;0;0;165
6910000;6;160732;                        Moreira do Lima;869;415;454;834;391;443;300;0;267;485;485;0;0;478
6952000;6;160733;                        Navió;231;118;113;224;113;111;65;0;66;117;117;0;0;116
6967000;6;160734;                        Poiares;775;365;410;704;317;387;235;0;232;338;337;1;0;329
7000000;6;160735;                        Ponte de Lima;2871;1294;1577;2897;1283;1614;990;3;782;1552;1552;0;10;674
7071000;6;160736;                        Queijada;274;131;143;267;125;142;90;0;80;148;148;0;1;149
7089000;6;160737;                        Refóios do Lima;2169;1007;1162;2190;993;1197;745;2;633;1241;1241;0;6;1215
7166000;6;160738;                        Rendufe;184;86;98;173;80;93;71;0;57;123;123;0;4;125
7177000;6;160739;                        Ribeira;1902;889;1013;1836;853;983;618;0;577;896;895;1;4;850
7227000;6;160740;                        Sá;423;193;230;413;190;223;136;0;125;189;189;0;0;183
7246000;6;160741;                        Sandiães;435;211;224;418;199;219;152;0;132;241;241;0;0;240
7263000;6;160742;                        Santa Comba;658;319;339;610;288;322;211;0;200;268;268;0;4;235
7287000;6;160743;                        Santa Cruz do Lima;480;219;261;457;208;249;161;1;142;259;259;0;2;258
7310000;6;160744;                        Rebordões (Santa Maria);1056;513;543;976;452;524;326;0;312;468;468;0;3;461
7344000;6;160745;                        Seara;714;349;365;695;332;363;216;0;214;281;281;0;1;267
7369000;6;160746;                        Serdedelo;464;216;248;446;202;244;132;0;140;207;207;0;0;205
7392000;6;160747;                        Rebordões (Souto);1127;550;577;1090;519;571;362;0;338;524;524;0;0;511
7449000;6;160748;                        Vilar das Almas;374;173;201;367;171;196;141;0;119;236;236;0;0;236
7474000;6;160749;                        Vilar do Monte;106;50;56;103;49;54;36;0;34;79;79;0;0;77
7486000;6;160750;                        Vitorino das Donas;1051;494;557;994;448;546;335;0;317;459;459;0;2;458
7531000;6;160751;                        Vitorino dos Piães;1537;710;827;1436;645;791;499;0;460;684;684;0;0;670
7593000;5;1608;                    Valença;14127;6619;7508;13862;6467;7395;5309;2;4409;8130;8119;11;20;6817
7594000;6;160801;                        Arão;758;366;392;744;357;387;296;0;246;406;406;0;0;366
7616000;6;160802;                        Boivão;239;105;134;238;104;134;88;0;73;159;159;0;0;159
7631000;6;160803;                        Cerdal;1693;816;877;1665;802;863;611;0;536;996;996;0;0;992
7710000;6;160804;                        Cristelo Covo;965;457;508;945;442;503;365;0;310;588;588;0;1;538
7741000;6;160805;                        Fontoura;751;362;389;740;356;384;275;0;229;420;420;0;0;415
7788000;6;160806;                        Friestas;562;250;312;535;236;299;212;0;172;315;315;0;0;311
7820000;6;160807;                        Gandra;1318;595;723;1277;575;702;481;0;431;681;681;0;1;624
7893000;6;160808;                        Ganfei;1296;618;678;1251;593;658;474;0;415;662;662;0;1;657
7948000;6;160809;                        Gondomil;301;127;174;297;125;172;124;0;90;221;221;0;1;221
7979000;6;160810;                        Sanfins;163;85;78;161;86;75;56;0;50;104;104;0;0;104
7995000;6;160811;                        São Julião;363;181;182;361;181;180;135;0;109;239;239;0;0;238
8023000;6;160812;                        São Pedro da Torre;1267;576;691;1251;565;686;473;0;402;667;667;0;3;653
8079000;6;160813;                        Silva;260;130;130;255;127;128;103;0;79;187;186;1;0;184
8103000;6;160814;                        Taião;153;69;84;157;70;87;60;0;53;92;92;0;0;92
8117000;6;160815;                        Valença;3430;1590;1840;3404;1571;1833;1335;2;1010;2076;2067;9;13;947
8220000;6;160816;                        Verdoejo;608;292;316;581;277;304;221;0;204;317;316;1;0;316
8258000;5;1609;                    Viana do Castelo;88725;41889;46836;85312;39690;45622;31733;33;27328;48193;48164;29;98;32925
8259000;6;160901;                        Afife;1632;750;882;1543;690;853;638;0;522;1264;1263;1;5;1058
8349000;6;160902;                        Alvarães;2623;1274;1349;2574;1228;1346;912;2;805;1345;1344;1;2;1299
8442000;6;160903;                        Amonde;293;122;171;274;110;164;100;0;90;138;138;0;0;136
8475000;6;160904;                        Anha;2415;1136;1279;2317;1072;1245;852;1;780;1190;1185;5;3;1109
8562000;6;160905;                        Areosa;4853;2267;2586;4622;2133;2489;1758;2;1517;2513;2511;2;3;1837
8695000;6;160906;                        Barroselas;3927;1874;2053;3745;1778;1967;1371;2;1212;1850;1847;3;4;1660
8811000;6;160907;                        Cardielos;1309;623;686;1224;569;655;395;1;408;527;527;0;3;519
8870000;6;160908;                        Carreço;1759;830;929;1643;767;876;619;1;573;971;970;1;2;920
8980000;6;160909;                        Carvoeiro;1104;527;577;1040;476;564;345;0;340;498;498;0;0;490
9042000;6;160910;                        Castelo do Neiva;2930;1385;1545;2811;1310;1501;1038;0;916;1779;1775;4;1;1654
9148000;6;160911;                        Darque;7817;3772;4045;7458;3527;3931;2940;2;2405;4762;4760;2;10;2318
9291000;6;160912;                        Deão;951;434;517;915;411;504;307;0;289;441;441;0;0;436
9338000;6;160913;                        Deocriste;776;384;392;741;361;380;232;0;227;331;331;0;0;320
9382000;6;160914;                        Freixieiro de Soutelo;511;245;266;488;224;264;169;0;154;311;311;0;0;305
9429000;6;160915;                        Lanheses;1645;762;883;1606;739;867;553;0;504;740;739;1;2;726
9522000;6;160916;                        Mazarefes;1343;651;692;1295;616;679;451;0;416;602;602;0;0;583
9579000;6;160917;                        Meadela;9782;4669;5113;9280;4381;4899;3596;0;3113;4737;4736;1;2;2265
9747000;6;160918;                        Meixedo;467;203;264;460;199;261;151;0;141;202;202;0;0;199
9780000;6;160919;                        Viana do Castelo (Monserrate);4948;2295;2653;5041;2321;2720;2073;5;1454;3161;3160;1;11;1254
9870000;6;160920;                        Montaria;549;232;317;528;218;310;195;0;166;310;310;0;0;309
9927000;6;160921;                        Moreira de Geraz do Lima;597;283;314;577;278;299;192;0;182;279;279;0;0;275
9963000;6;160922;                        Mujães;1550;736;814;1461;680;781;543;0;476;797;797;0;1;751
10027000;6;160923;                        Neiva;1225;570;655;1185;552;633;418;0;381;599;599;0;0;578
10083000;6;160924;                        Nogueira;916;415;501;880;391;489;266;0;268;346;346;0;0;339
10144000;6;160925;                        Outeiro;1234;582;652;1183;551;632;354;0;368;502;502;0;0;501
10212000;6;160926;                        Perre;2956;1416;1540;2784;1304;1480;928;0;911;1116;1116;0;1;1080
10338000;6;160927;                        Portela Susã;597;270;327;576;257;319;195;1;182;284;284;0;1;278
10369000;6;160928;                        Santa Marta de Portuzelo;3805;1798;2007;3586;1680;1906;1257;0;1203;1666;1666;0;0;1484
10502000;6;160929;                        Geraz do Lima (Santa Leocádia);916;423;493;885;403;482;287;0;283;462;462;0;0;461
10574000;6;160930;                        Geraz do Lima (Santa Maria);875;413;462;786;362;424;296;0;271;440;440;0;1;438
10626000;6;160931;                        Viana do Castelo (Santa Maria Maior);10645;4929;5716;10463;4767;5696;4268;14;3133;5929;5924;5;39;1972
10803000;6;160932;                        Serreleis;1003;464;539;962;439;523;316;0;316;398;398;0;0;390
10849000;6;160933;                        Subportela;1179;563;616;1115;524;591;360;0;362;524;524;0;0;520
10905000;6;160934;                        Torre;615;299;316;611;296;315;182;0;177;281;281;0;0;275
10947000;6;160935;                        Vila Franca;1757;864;893;1708;823;885;560;1;539;774;773;1;2;759
11034000;6;160936;                        Vila Fria;1327;646;681;1297;627;670;451;0;422;569;569;0;0;563
11098000;6;160937;                        Vila Mou;566;239;327;529;220;309;197;0;175;285;285;0;0;283
11140000;6;160938;                        Vila de Punhe;2273;1083;1190;2171;1008;1163;829;0;699;1191;1191;0;2;1161
11231000;6;160939;                        Vilar de Murteda;214;92;122;210;89;121;77;0;68;135;135;0;0;135
11261000;6;160940;                        Chafé;2841;1369;1472;2738;1309;1429;1062;1;880;3944;3943;1;3;1285
11365000;5;1610;                    Vila Nova de Cerveira;9253;4419;4834;8974;4255;4719;3492;2;2848;6153;6150;3;18;5580
11366000;6;161001;                        Campos;1367;656;711;1323;635;688;497;0;425;704;704;0;1;668
11438000;6;161002;                        Candemil;232;112;120;226;108;118;95;0;74;163;163;0;1;162
11472000;6;161003;                        Cornes;478;220;258;459;213;246;171;0;148;289;289;0;0;285
11515000;6;161004;                        Covas;675;313;362;662;307;355;284;0;200;633;632;1;2;632
11575000;6;161005;                        Gondar;127;59;68;120;56;64;56;0;40;103;103;0;0;102
11591000;6;161006;                        Gondarém;1010;474;536;986;454;532;382;0;323;734;734;0;3;692
11659000;6;161007;                        Loivo;885;439;446;842;408;434;325;0;278;526;526;0;0;484
11706000;6;161008;                        Lovelhe;443;218;225;404;202;202;163;0;134;274;274;0;1;224
11739000;6;161009;                        Mentrestido;264;123;141;257;119;138;109;0;88;219;219;0;0;218
11779000;6;161010;                        Nogueira;315;153;162;300;147;153;120;0;100;182;182;0;0;177
11809000;6;161011;                        Reboreda;756;352;404;781;352;429;272;1;222;444;443;1;1;439
11855000;6;161012;                        Sapardos;366;187;179;365;189;176;147;0;114;261;261;0;0;261
11893000;6;161013;                        Sopo;557;271;286;524;250;274;209;0;171;447;446;1;0;444
11932000;6;161014;                        Vila Meã;346;184;162;347;183;164;124;0;103;179;179;0;1;162
11959000;6;161015;                        Vila Nova de Cerveira;1432;658;774;1378;632;746;538;1;428;995;995;0;8;630
12002000;4;112;                Cávado;410169;196823;213346;397380;187935;209445;137346;169;122071;190251;190104;147;362;124414
12003000;5;301;                    Amares;18889;9131;9758;18349;8799;9550;6172;3;5617;9586;9584;2;21;8452
12004000;6;30101;                        Amares;1550;775;775;1485;739;746;513;1;461;759;759;0;3;635
12044000;6;30102;                        Barreiros;760;363;397;730;349;381;238;0;222;340;340;0;0;334
12077000;6;30103;                        Besteiros;576;281;295;570;276;294;195;0;171;293;293;0;0;270
12110000;6;30104;                        Bico;777;368;409;745;348;397;250;0;229;380;380;0;0;369
12141000;6;30105;                        Caires;868;414;454;853;399;454;279;0;261;462;462;0;0;452
12185000;6;30106;                        Caldelas;872;406;466;839;389;450;300;0;263;496;496;0;4;421
12221000;6;30107;                        Carrazedo;732;335;397;724;325;399;247;0;221;371;371;0;0;363
12256000;6;30108;                        Dornelas;508;246;262;500;239;261;168;0;152;254;254;0;0;254
12278000;6;30109;                        Ferreiros;3212;1543;1669;3095;1476;1619;1095;1;965;1678;1678;0;4;1000
12341000;6;30110;                        Figueiredo;1104;534;570;1085;522;563;369;0;344;655;655;0;0;618
12378000;6;30111;                        Fiscal;718;337;381;703;323;380;245;0;214;388;387;1;0;384
12423000;6;30112;                        Goães;557;269;288;537;258;279;179;0;166;274;274;0;0;273
12456000;6;30113;                        Lago;1910;927;983;1836;878;958;577;0;565;795;795;0;0;716
12506000;6;30114;                        Paranhos;111;55;56;109;56;53;40;0;36;74;74;0;0;74
12520000;6;30115;                        Paredes Secas;166;78;88;166;77;89;51;0;40;97;97;0;0;96
12531000;6;30116;                        Portela;168;82;86;162;81;81;53;0;47;88;88;0;0;87
12546000;6;30117;                        Prozelo;785;400;385;777;397;380;258;0;241;381;381;0;3;329
12578000;6;30118;                        Rendufe;1124;555;569;1103;542;561;336;0;317;510;509;1;3;497
12622000;6;30119;                        Bouro (Santa Maria);760;351;409;747;348;399;260;1;221;441;441;0;2;437
12642000;6;30120;                        Bouro (Santa Marta);490;238;252;482;231;251;163;0;147;283;283;0;0;280
12670000;6;30121;                        Sequeiros;204;105;99;196;101;95;71;0;58;136;136;0;0;133
12689000;6;30122;                        Seramil;182;97;85;181;96;85;59;0;55;85;85;0;2;87
12706000;6;30123;                        Torre;458;226;232;441;214;227;144;0;136;217;217;0;0;215
12740000;6;30124;                        Vilela;297;146;151;283;135;148;82;0;85;129;129;0;0;128
12766000;5;302;                    Barcelos;120391;58284;62107;115034;54676;60358;38052;30;35957;47394;47339;55;57;37190
12767000;6;30201;                        Abade de Neiva;2024;971;1053;1907;898;1009;627;0;614;753;751;2;1;677
12831000;6;30202;                        Aborim;891;426;465;850;397;453;305;0;277;367;367;0;1;322
12871000;6;30203;                        Adães;790;389;401;726;358;368;257;0;226;300;300;0;0;277
12900000;6;30204;                        Aguiar;546;269;277;506;244;262;164;0;162;213;213;0;0;207
12926000;6;30205;                        Airó;913;454;459;869;423;446;269;1;266;324;324;0;1;288
12951000;6;30206;                        Aldreu;904;436;468;847;394;453;302;0;281;358;356;2;0;356
12992000;6;30207;                        Alheira;1072;512;560;1054;501;553;332;1;336;489;489;0;1;470
13038000;6;30208;                        Alvelos;2145;1047;1098;2060;986;1074;639;0;661;751;751;0;0;684
13096000;6;30209;                        Arcozelo;12840;6101;6739;12212;5701;6511;4618;4;3904;5710;5696;14;5;1615
13250000;6;30210;                        Areias;1014;502;512;953;458;495;328;0;296;407;406;1;0;348
13284000;6;30211;                        Areias de Vilar;1365;774;591;1307;733;574;342;3;345;420;419;1;1;393
13319000;6;30212;                        Balugães;841;400;441;796;363;433;264;0;251;362;362;0;0;349
13353000;6;30213;                        Barcelinhos;1781;835;946;1699;777;922;632;1;562;852;852;0;4;583
13391000;6;30214;                        Barcelos;4660;2116;2544;4637;2092;2545;1667;5;1336;2245;2240;5;11;698
13479000;6;30215;                        Barqueiros;1957;919;1038;1862;858;1004;587;1;586;841;841;0;2;774
13540000;6;30216;                        Cambeses;1300;643;657;1251;607;644;424;0;401;521;520;1;0;467
13588000;6;30217;                        Campo;983;471;512;917;431;486;310;0;295;351;351;0;0;329
13618000;6;30218;                        Carapeços;2277;1076;1201;2192;1013;1179;668;1;675;755;754;1;1;708
13680000;6;30219;                        Carreira;1451;710;741;1401;673;728;441;0;432;522;522;0;0;474
13724000;6;30220;                        Carvalhal;1391;668;723;1365;653;712;440;0;434;546;546;0;0;487
13770000;6;30221;                        Carvalhos;691;341;350;653;316;337;220;0;215;267;267;0;0;266
13809000;6;30222;                        Chavão;746;360;386;696;327;369;214;0;220;274;274;0;0;256
13840000;6;30223;                        Chorente;753;363;390;669;318;351;224;0;230;277;277;0;0;256
13877000;6;30224;                        Cossourado;825;402;423;772;364;408;263;0;239;374;373;1;1;367
13914000;6;30225;                        Courel;488;240;248;464;227;237;140;0;138;192;192;0;0;182
13938000;6;30226;                        Couto;348;178;170;334;167;167;104;0;106;114;114;0;0;110
13951000;6;30227;                        Creixomil;834;409;425;809;395;414;260;0;245;310;310;0;0;310
13973000;6;30228;                        Cristelo;1875;913;962;1803;866;937;527;1;554;684;683;1;1;662
14044000;6;30229;                        Durrães;723;347;376;694;323;371;225;0;214;330;330;0;2;322
14076000;6;30230;                        Encourados;514;260;254;485;242;243;164;0;162;212;209;3;0;202
14101000;6;30231;                        Faria;550;269;281;539;266;273;167;0;158;219;219;0;1;213
14130000;6;30232;                        Feitos;538;268;270;493;227;266;157;0;156;184;184;0;0;173
14150000;6;30233;                        Fonte Coberta;582;288;294;579;283;296;184;0;173;234;234;0;0;210
14175000;6;30234;                        Fornelos;803;410;393;744;373;371;217;0;244;273;270;3;0;261
14209000;6;30235;                        Fragoso;2193;1074;1119;2066;985;1081;664;0;645;887;884;3;0;852
14293000;6;30236;                        Gamil;924;458;466;896;437;459;282;0;279;355;354;1;1;319
14319000;6;30237;                        Gilmonde;1516;756;760;1440;700;740;470;0;457;583;583;0;0;531
14360000;6;30238;                        Góios;548;278;270;537;270;267;166;0;160;211;211;0;0;199
14391000;6;30239;                        Grimancelos;791;360;431;774;352;422;245;0;230;331;331;0;1;320
14416000;6;30240;                        Gueral;380;184;196;375;181;194;108;0;113;145;145;0;0;143
14435000;6;30241;                        Igreja Nova;384;181;203;367;171;196;130;0;122;215;215;0;0;213
14453000;6;30242;                        Lama;1271;603;668;1228;576;652;367;0;377;462;462;0;0;444
14483000;6;30243;                        Lijó;2306;1087;1219;2231;1038;1193;715;0;675;818;818;0;0;692
14533000;6;30244;                        Macieira de Rates;2083;1029;1054;1826;867;959;582;0;573;676;676;0;1;585
14611000;6;30245;                        Manhente;1703;825;878;1618;756;862;533;0;525;644;644;0;0;558
14662000;6;30246;                        Mariz;374;190;184;347;173;174;123;0;118;153;153;0;0;147
14677000;6;30247;                        Martim;2375;1151;1224;2205;1031;1174;681;0;687;806;806;0;0;654
14725000;6;30248;                        Midões;462;209;253;446;197;249;138;0;134;181;181;0;0;176
14748000;6;30249;                        Milhazes;912;428;484;850;393;457;251;0;262;354;353;1;0;339
14787000;6;30250;                        Minhotães;775;357;418;751;347;404;240;0;238;296;296;0;0;278
14821000;6;30251;                        Monte de Fralães;408;200;208;391;189;202;133;0;122;161;161;0;0;128
14836000;6;30252;                        Moure;925;443;482;877;413;464;302;0;282;378;378;0;0;327
14869000;6;30253;                        Negreiros;1618;781;837;1555;744;811;467;0;493;598;598;0;0;586
14936000;6;30254;                        Oliveira;1004;504;500;963;475;488;314;0;298;405;404;1;0;357
14978000;6;30255;                        Palme;1073;523;550;1006;477;529;315;0;309;410;410;0;0;398
15023000;6;30256;                        Panque;680;330;350;670;322;348;206;0;203;277;277;0;0;273
15055000;6;30257;                        Paradela;850;415;435;804;385;419;230;0;239;281;281;0;2;281
15088000;6;30258;                        Pedra Furada;399;199;200;381;185;196;120;0;117;170;170;0;1;168
15108000;6;30259;                        Pereira;1318;648;670;1293;629;664;393;0;395;442;442;0;1;392
15142000;6;30260;                        Perelhal;1749;872;877;1668;820;848;606;0;529;726;722;4;0;615
15195000;6;30261;                        Pousa;2272;1092;1180;2128;987;1141;626;0;662;764;761;3;0;650
15250000;6;30262;                        Quintiães;644;317;327;587;269;318;195;0;190;228;228;0;1;223
15285000;6;30263;                        Remelhe;1309;627;682;1260;594;666;411;0;385;484;483;1;0;465
15323000;6;30264;                        Roriz;2152;1059;1093;2080;1005;1075;642;0;610;737;733;4;0;636
15376000;6;30265;                        Rio Covo (Santa Eugénia);1483;714;769;1422;665;757;495;0;462;619;619;0;0;512
15409000;6;30266;                        Rio Covo (Santa Eulália);970;451;519;920;414;506;311;0;303;363;363;0;0;304
15436000;6;30267;                        Tamel (Santa Leocádia);753;359;394;720;335;385;230;0;230;258;258;0;0;247
15464000;6;30268;                        Galegos (Santa Maria);2987;1480;1507;2808;1365;1443;924;0;876;1099;1099;0;0;860
15513000;6;30269;                        Bastuço (Santo Estêvão);460;224;236;453;218;235;146;0;144;178;178;0;0;167
15530000;6;30270;                        Bastuço (São João);661;329;332;627;307;320;199;0;195;250;250;0;0;235
15556000;6;30271;                        Alvito (São Martinho);451;227;224;430;211;219;125;0;135;137;137;0;0;132
15576000;6;30272;                        Galegos (São Martinho);1930;952;978;1829;880;949;630;0;584;742;742;0;0;585
15624000;6;30273;                        Vila Frescainha (São Martinho);2372;1109;1263;2304;1054;1250;820;2;738;998;997;1;2;640
15665000;6;30274;                        Alvito (São Pedro);639;317;322;597;287;310;181;1;182;219;219;0;1;203
15693000;6;30275;                        Vila Frescainha (São Pedro);1593;785;808;1515;739;776;533;0;511;654;653;1;0;560
15727000;6;30276;                        Tamel (São Pedro Fins);538;249;289;525;235;290;166;0;157;217;217;0;1;210
15756000;6;30277;                        Tamel (São Veríssimo);3025;1448;1577;2913;1371;1542;997;1;925;1179;1179;0;1;994
15834000;6;30278;                        Sequeade;795;388;407;765;361;404;235;1;240;310;310;0;1;293
15865000;6;30279;                        Silva;913;453;460;869;427;442;284;2;275;326;326;0;2;302
15892000;6;30280;                        Silveiros;1181;565;616;1180;555;625;391;1;366;497;497;0;2;427
15932000;6;30281;                        Tregosa;686;332;354;646;304;342;238;0;217;342;342;0;1;341
15959000;6;30282;                        Ucha;1420;681;739;1378;650;728;434;0;426;561;561;0;0;505
15994000;6;30283;                        Várzea;1904;940;964;1851;899;952;642;0;598;807;807;0;1;596
16045000;6;30284;                        Viatodos;1840;891;949;1787;864;923;637;0;574;766;766;0;1;700
16091000;6;30285;                        Vila Boa;2483;1335;1148;2403;1302;1101;737;3;667;901;901;0;1;406
16135000;6;30286;                        Vila Cova;2026;937;1089;1972;901;1071;619;1;590;827;827;0;2;815
16191000;6;30287;                        Vila Seca;1197;557;640;1143;533;610;352;0;356;446;446;0;0;426
16230000;6;30288;                        Vilar de Figos;604;278;326;594;273;321;179;0;178;236;236;0;0;235
16256000;6;30289;                        Vilar do Monte;667;336;331;618;304;314;210;0;205;253;253;0;0;250
16283000;5;303;                    Braga;181494;86707;94787;177859;83914;93945;63986;106;53914;84525;84497;28;161;38892
16284000;6;30301;                        Adaúfe;3711;1801;1910;3711;1810;1901;1186;0;1135;1472;1471;1;1;1311
16391000;6;30302;                        Arcos;764;372;392;723;348;375;239;0;228;273;273;0;0;253
16410000;6;30303;                        Arentim;884;432;452;862;421;441;283;0;276;365;365;0;0;344
16447000;6;30304;                        Aveleda;2149;1056;1093;2113;1033;1080;716;1;663;864;864;0;1;735
16490000;6;30305;                        Cabreiros;1511;736;775;1452;696;756;457;1;461;534;533;1;1;501
16534000;6;30306;                        Celeirós;3289;1648;1641;3227;1591;1636;1092;2;1011;1405;1405;0;2;922
16590000;6;30307;                        Braga (Cividade);1422;609;813;1406;613;793;541;8;403;690;689;1;8;226
16609000;6;30308;                        Crespos;899;435;464;882;421;461;279;0;264;374;374;0;0;345
16649000;6;30309;                        Cunha;646;308;338;615;290;325;202;1;190;268;268;0;1;259
16681000;6;30310;                        Dume;3251;1579;1672;3165;1529;1636;1096;0;976;1387;1387;0;0;1109
16747000;6;30311;                        Escudeiros;1115;558;557;1072;528;544;355;0;331;429;429;0;0;390
16788000;6;30312;                        Espinho;1181;593;588;1107;545;562;338;4;340;429;429;0;7;405
16828000;6;30313;                        Esporões;1709;839;870;1671;806;865;528;0;503;605;605;0;0;528
16875000;6;30314;                        Ferreiros;7707;3726;3981;7444;3561;3883;2661;2;2393;3470;3470;0;3;1308
16954000;6;30315;                        Figueiredo;1198;573;625;1168;555;613;378;0;363;436;436;0;0;332
16987000;6;30316;                        Fraião;4605;2206;2399;4373;2061;2312;1722;5;1388;2166;2166;0;5;760
17047000;6;30317;                        Frossos;1806;880;926;1735;835;900;571;0;530;697;696;1;0;532
17076000;6;30318;                        Gondizalves;1441;706;735;1377;665;712;456;0;432;589;581;8;0;479
17107000;6;30319;                        Gualtar;5286;2564;2722;5220;2473;2747;1917;2;1578;3021;3020;1;3;1491
17191000;6;30320;                        Guisande;538;276;262;533;273;260;155;0;162;170;170;0;0;157
17212000;6;30321;                        Lamaçães;2525;1228;1297;2412;1165;1247;943;0;771;1135;1135;0;0;469
17253000;6;30322;                        Lamas;842;419;423;819;403;416;257;0;242;289;289;0;0;219
17280000;6;30323;                        Lomar;6041;2950;3091;5860;2841;3019;2053;1;1826;2593;2593;0;1;1249
17358000;6;30324;                        Braga (Maximinos);9792;4671;5121;9389;4414;4975;3683;2;2894;5053;5052;1;5;1025
17447000;6;30325;                        Mire de Tibães;2437;1187;1250;2397;1144;1253;793;2;749;907;907;0;2;823
17508000;6;30326;                        Morreira;747;382;365;736;375;361;257;0;229;293;293;0;1;235
17538000;6;30327;                        Navarra;460;229;231;445;218;227;136;0;133;213;213;0;0;193
17554000;6;30328;                        Nogueira;5924;2918;3006;5753;2831;2922;2037;2;1770;2441;2440;1;4;1297
17635000;6;30329;                        Nogueiró;3749;1618;2131;3697;1586;2111;1248;7;1010;1631;1631;0;6;693
17688000;6;30330;                        Padim da Graça;1521;720;801;1518;713;805;465;0;447;605;605;0;0;486
17730000;6;30331;                        Palmeira;5468;2634;2834;5260;2508;2752;1779;2;1668;2248;2248;0;3;1906
17850000;6;30332;                        Panoias;1663;812;851;1593;770;823;519;0;489;623;623;0;0;578
17886000;6;30333;                        Parada de Tibães;1249;605;644;1197;568;629;389;1;362;486;486;0;1;463
17914000;6;30334;                        Pedralva;1110;537;573;1045;491;554;351;0;334;499;499;0;0;486
17955000;6;30335;                        Pousada;448;225;223;431;212;219;142;0;126;210;210;0;1;210
17977000;6;30336;                        Priscos;1341;654;687;1296;624;672;441;0;409;567;567;0;0;512
18032000;6;30337;                        Real;7666;3697;3969;7355;3499;3856;2638;3;2330;3366;3365;1;3;1285
18108000;6;30338;                        Ruilhe;1142;517;625;1132;503;629;338;2;309;483;483;0;2;421
18147000;6;30339;                        Santa Lucrécia de Algeriz;534;252;282;517;246;271;172;0;154;221;221;0;0;205
18173000;6;30340;                        Penso (Santo Estêvão);435;213;222;418;200;218;140;0;123;175;175;0;0;155
18194000;6;30341;                        Braga (São João do Souto);725;244;481;1174;505;669;209;5;115;346;346;0;10;216
18219000;6;30342;                        Braga (São José de São Lázaro);13576;6237;7339;12994;5888;7106;5219;15;3959;7003;7001;2;29;1580
18349000;6;30343;                        Passos (São Julião);654;309;345;635;293;342;195;0;195;241;241;0;0;235
18370000;6;30344;                        Este (São Mamede);1789;856;933;1756;828;928;574;0;556;716;716;0;0;639
18418000;6;30345;                        Merelim (São Paio);2451;1188;1263;2349;1129;1220;812;0;737;1031;1029;2;0;942
18478000;6;30346;                        Este (São Pedro);2048;995;1053;1992;950;1042;671;0;624;825;825;0;0;680
18525000;6;30347;                        Merelim (São Pedro);1920;947;973;1865;909;956;619;0;570;757;757;0;0;668
18568000;6;30348;                        Oliveira (São Pedro);515;245;270;510;241;269;164;0;155;205;205;0;0;182
18596000;6;30349;                        Braga (São Vicente);13236;6252;6984;12687;5958;6729;4860;16;3820;6737;6736;1;18;1462
18718000;6;30350;                        Penso (São Vicente);314;158;156;313;159;154;101;0;92;113;113;0;1;96
18739000;6;30351;                        Braga (São Vítor);29642;13930;15712;30577;14056;16521;11671;14;8743;16591;16586;5;28;2720
18983000;6;30352;                        Braga (Sé);3358;1544;1814;3190;1451;1739;1307;5;984;1760;1760;0;6;510
19030000;6;30353;                        Semelhe;783;365;418;771;353;418;248;0;246;295;295;0;0;268
19063000;6;30354;                        Sequeira;1811;896;915;1776;864;912;601;0;557;767;767;0;0;646
19108000;6;30355;                        Sobreposta;1301;648;653;1226;593;633;377;1;378;449;448;1;1;435
19162000;6;30356;                        Tadim;1143;553;590;1104;535;569;373;1;354;488;488;0;1;354
19190000;6;30357;                        Tebosa;1129;554;575;1040;499;541;383;0;354;430;430;0;0;382
19236000;6;30358;                        Tenões;1380;666;714;1355;648;707;507;1;408;742;742;0;6;426
19272000;6;30359;                        Trandeiras;700;340;360;685;329;356;219;0;206;257;257;0;0;233
19296000;6;30360;                        Vilaça;794;395;399;783;388;395;270;0;250;333;332;1;0;296
19325000;6;30361;                        Vimieiro;1233;624;609;1206;604;602;391;0;369;466;466;0;0;360
19360000;6;30362;                        Fradelos;786;396;390;745;369;376;262;0;240;291;291;0;0;265
19383000;5;306;                    Esposende;34254;16278;17976;32711;15294;17417;11087;4;10231;20929;20911;18;24;15089
19384000;6;30601;                        Antas;2221;1033;1188;2164;994;1170;729;0;667;1187;1187;0;1;1136
19482000;6;30602;                        Apúlia;4198;1985;2213;4051;1893;2158;1378;1;1254;2989;2987;2;6;1979
19623000;6;30603;                        Belinho;2017;981;1036;1906;899;1007;628;0;599;982;982;0;1;969
19693000;6;30604;                        Curvos;811;382;429;738;338;400;249;0;223;387;386;1;1;379
19730000;6;30605;                        Esposende;3595;1702;1893;3507;1650;1857;1335;1;1105;2629;2628;1;6;1029
19824000;6;30606;                        Fão;3103;1465;1638;2942;1373;1569;1110;1;924;2737;2735;2;5;1711
19943000;6;30607;                        Fonte Boa;1326;639;687;1278;619;659;345;0;383;437;437;0;0;432
20007000;6;30608;                        Forjães;2767;1307;1460;2632;1218;1414;877;1;830;1173;1172;1;1;1041
20156000;6;30609;                        Gandra;1323;651;672;1277;619;658;401;0;405;708;700;8;1;622
20217000;6;30610;                        Gemeses;1078;518;560;1045;499;546;319;0;326;631;631;0;0;523
20299000;6;30611;                        Mar;1182;564;618;1115;520;595;355;0;354;558;558;0;0;542
20339000;6;30612;                        Marinhas;6193;2959;3234;5846;2738;3108;1997;0;1850;4669;4666;3;1;2973
20583000;6;30613;                        Palmeira de Faro;2403;1129;1274;2287;1056;1231;782;0;707;1058;1058;0;1;982
20692000;6;30614;                        Rio Tinto;618;285;333;598;274;324;185;0;189;236;236;0;0;234
20742000;6;30615;                        Vila Chã;1419;678;741;1325;604;721;397;0;415;548;548;0;0;537
20808000;5;310;                    Terras de Bouro;7253;3478;3775;7250;3454;3796;2492;7;2151;4819;4819;0;58;4654
20809000;6;31001;                        Balança;341;158;183;338;157;181;127;0;102;195;195;0;0;192
20849000;6;31002;                        Brufe;50;24;26;48;23;25;22;0;14;38;38;0;1;39
20857000;6;31003;                        Campo do Gerês;162;81;81;163;83;80;54;0;44;160;160;0;7;163
20879000;6;31004;                        Carvalheira;386;186;200;378;182;196;135;0;115;249;249;0;1;250
20909000;6;31005;                        Chamoim;291;128;163;293;128;165;101;0;90;204;204;0;0;200
20931000;6;31006;                        Chorense;454;215;239;430;198;232;156;1;129;281;281;0;2;281
20956000;6;31007;                        Cibões;371;176;195;360;169;191;137;1;111;289;289;0;1;288
20987000;6;31008;                        Covide;343;171;172;335;167;168;125;1;100;220;220;0;2;220
21019000;6;31009;                        Gondoriz;295;147;148;300;148;152;112;0;88;287;287;0;0;285
21039000;6;31010;                        Moimenta;741;353;388;744;347;397;256;1;212;439;439;0;3;332
21077000;6;31011;                        Monte;126;63;63;120;62;58;37;0;38;57;57;0;2;59
21094000;6;31012;                        Ribeira;242;113;129;234;109;125;76;0;73;149;149;0;0;149
21117000;6;31013;                        Rio Caldo;892;433;459;871;421;450;295;1;266;578;578;0;5;580
21170000;6;31014;                        Souto;494;239;255;472;225;247;159;0;145;284;284;0;1;282
21192000;6;31015;                        Valdosende;630;304;326;675;324;351;210;1;191;422;422;0;7;427
21223000;6;31016;                        Vilar;149;77;72;138;71;67;53;0;42;123;123;0;0;121
21242000;6;31017;                        Vilar da Veiga;1286;610;676;1351;640;711;437;1;391;844;844;0;26;786
21295000;5;313;                    Vila Verde;47888;22945;24943;46177;21798;24379;15557;19;14201;22998;22954;44;41;20137
21296000;6;31301;                        Aboim da Nóbrega;987;458;529;926;426;500;348;1;280;611;611;0;4;606
21336000;6;31302;                        Arcozelo;405;187;218;398;182;216;137;0;125;220;219;1;0;217
21352000;6;31303;                        Atães;659;307;352;625;281;344;218;0;196;352;352;0;0;349
21387000;6;31304;                        Atiães;520;239;281;498;223;275;156;1;144;212;212;0;2;209
21412000;6;31305;                        Azões;314;148;166;294;131;163;101;0;90;156;156;0;0;152
21435000;6;31306;                        Barbudo;2400;1135;1265;2292;1063;1229;744;3;685;1115;1113;2;2;640
21486000;6;31307;                        Barros;335;166;169;318;156;162;115;0;103;194;194;0;0;191
21507000;6;31308;                        Cabanelas;2102;1032;1070;2021;971;1050;644;0;625;826;794;32;1;733
21554000;6;31309;                        Cervães;1981;963;1018;1926;923;1003;645;0;622;964;964;0;0;942
21629000;6;31310;                        Codeceda;172;83;89;163;79;84;63;0;50;144;144;0;0;144
21646000;6;31311;                        Coucieiro;531;248;283;524;247;277;173;0;154;270;270;0;0;269
21674000;6;31312;                        Covas;396;182;214;384;179;205;140;0;116;235;234;1;0;230
21692000;6;31313;                        Dossãos;500;251;249;478;232;246;155;0;149;207;207;0;0;206
21710000;6;31314;                        Duas Igrejas;1291;588;703;1208;533;675;427;1;352;683;683;0;1;674
21765000;6;31315;                        Esqueiros;493;237;256;463;222;241;157;0;143;206;206;0;0;190
21787000;6;31316;                        Freiriz;1099;526;573;1063;501;562;339;1;322;469;469;0;1;468
21824000;6;31317;                        Geme;551;258;293;545;249;296;179;0;167;245;241;4;0;224
21850000;6;31318;                        Goães;546;271;275;533;263;270;178;0;157;251;251;0;0;249
21875000;6;31319;                        Godinhaços;380;168;212;361;156;205;146;0;118;292;292;0;0;290
21902000;6;31320;                        Gomide;228;116;112;223;113;110;79;0;71;128;128;0;0;125
21918000;6;31321;                        Gondiães;347;164;183;337;157;180;116;0;102;170;170;0;0;168
21939000;6;31322;                        Gondomar;71;34;37;67;30;37;23;0;20;61;61;0;0;61
21950000;6;31323;                        Laje;2895;1382;1513;2760;1305;1455;938;1;868;1261;1260;1;2;1199
22035000;6;31324;                        Lanhas;581;289;292;573;283;290;188;0;172;246;246;0;1;240
22055000;6;31325;                        Loureira;1152;557;595;1116;533;583;360;0;347;481;481;0;0;449
22085000;6;31326;                        Marrancos;504;226;278;467;199;268;166;0;152;261;261;0;0;255
22107000;6;31327;                        Mós;323;151;172;310;145;165;106;0;96;158;158;0;0;152
22125000;6;31328;                        Moure;1421;681;740;1367;645;722;451;1;412;657;657;0;1;611
22176000;6;31329;                        Nevogilde;324;158;166;315;152;163;103;0;100;139;139;0;1;140
22199000;6;31330;                        Oleiros;1169;552;617;1172;555;617;381;0;346;569;569;0;0;544
22234000;6;31331;                        Parada de Gatim;793;392;401;756;363;393;223;0;230;312;312;0;0;295
22261000;6;31332;                        Passó;208;104;104;202;98;104;76;0;64;129;129;0;0;128
22279000;6;31333;                        Pedregais;331;150;181;328;148;180;117;0;104;196;196;0;0;194
22303000;6;31334;                        Penascais;255;120;135;252;120;132;87;0;83;129;129;0;0;128
22321000;6;31335;                        Pico;610;291;319;605;288;317;204;0;188;320;320;0;0;292
22352000;6;31336;                        Pico de Regalados;845;402;443;827;393;434;278;0;253;381;381;0;3;366
22384000;6;31337;                        Ponte;483;229;254;469;221;248;166;1;137;223;223;0;1;222
22408000;6;31338;                        Portela das Cabras;278;135;143;278;135;143;91;0;83;146;146;0;0;145
22425000;6;31339;                        Rio Mau;667;319;348;650;311;339;216;0;202;337;337;0;0;333
22454000;6;31340;                        Sabariz;443;211;232;430;203;227;153;0;128;229;229;0;1;224
22473000;6;31341;                        Sande;591;297;294;564;283;281;180;0;164;244;244;0;0;244
22510000;6;31342;                        Vila de Prado;4472;2164;2308;4280;2029;2251;1444;3;1310;1934;1933;1;6;1368
22588000;6;31343;                        Oriz (Santa Marinha);336;173;163;324;168;156;120;0;105;151;151;0;0;150
22600000;6;31344;                        Carreiras (Santiago);377;170;207;369;164;205;132;0;114;191;191;0;0;190
22624000;6;31345;                        Escariz (São Mamede);388;181;207;377;173;204;136;0;130;196;196;0;0;190
22647000;6;31346;                        Escariz (São Martinho);361;183;178;352;178;174;128;0;112;219;219;0;0;219
22668000;6;31347;                        Valbom (São Martinho);185;81;104;180;77;103;61;0;58;90;90;0;0;90
22678000;6;31348;                        Carreiras (São Miguel);553;261;292;535;249;286;183;0;167;247;247;0;0;242
22692000;6;31349;                        Oriz (São Miguel);235;111;124;237;112;125;79;0;60;129;129;0;0;127
22706000;6;31350;                        Prado (São Miguel);717;355;362;692;331;361;239;0;216;352;352;0;0;329
22741000;6;31351;                        Valbom (São Pedro);249;123;126;251;119;132;87;0;76;147;147;0;0;146
22759000;6;31352;                        Soutelo;2102;990;1112;2082;966;1116;634;2;632;868;867;1;6;814
22816000;6;31353;                        Travassós;218;108;110;211;102;109;56;0;57;82;82;0;0;82
22829000;6;31354;                        Turiz;1746;863;883;1688;828;860;531;1;508;765;765;0;1;743
22879000;6;31355;                        Valdreu;516;238;278;510;231;279;195;0;157;418;418;0;0;417
22912000;6;31356;                        Valões;195;91;104;187;85;102;68;0;59;116;116;0;0;115
22930000;6;31357;                        Vila Verde;4647;2245;2402;4422;2101;2321;1565;3;1402;2473;2472;1;7;1238
22999000;6;31358;                        Vilarinho;410;201;209;392;188;204;132;0;118;191;191;0;0;179
23021000;4;113;                Ave;511737;247027;264710;497823;238326;259497;174493;134;158084;221360;221243;117;274;157558
23022000;5;307;                    Fafe;50633;23946;26687;48988;22967;26021;17722;15;15556;25232;25228;4;29;19791
23023000;6;30701;                        Aboim;355;165;190;340;154;186;120;0;104;255;255;0;1;254
23057000;6;30702;                        Agrela;187;79;108;184;77;107;65;0;58;115;115;0;0;108
23077000;6;30703;                        Antime;1476;689;787;1411;652;759;548;1;484;678;678;0;1;614
23127000;6;30704;                        Ardegão;301;129;172;295;123;172;119;0;95;162;162;0;0;153
23151000;6;30705;                        Armil;735;361;374;730;359;371;265;0;231;358;358;0;0;310
23192000;6;30706;                        Arnozela;265;112;153;256;107;149;101;0;74;171;171;0;0;168
23226000;6;30707;                        Cepães;1410;681;729;1373;664;709;487;1;416;674;674;0;3;590
23284000;6;30708;                        Estorãos;1508;715;793;1496;708;788;523;0;495;768;768;0;0;716
23355000;6;30709;                        Fafe;15703;7368;8335;14979;6939;8040;5705;5;4847;7884;7883;1;9;4138
23656000;6;30710;                        Fareja;855;420;435;832;409;423;267;0;264;329;329;0;0;276
23681000;6;30711;                        Felgueiras;117;52;65;115;51;64;40;0;35;64;64;0;0;64
23702000;6;30712;                        Fornelos;1374;643;731;1307;605;702;466;1;408;713;713;0;1;602
23755000;6;30713;                        Freitas;585;266;319;581;263;318;198;1;175;340;340;0;1;330
23819000;6;30714;                        Golães;2135;1026;1109;2096;1003;1093;697;0;653;931;931;0;0;773
23876000;6;30715;                        Gontim;89;42;47;87;42;45;37;0;25;67;67;0;0;67
23890000;6;30716;                        Medelo;1602;773;829;1546;737;809;556;0;494;755;755;0;2;565
23951000;6;30717;                        Monte;308;126;182;297;121;176;133;0;90;350;350;0;0;348
23986000;6;30718;                        Moreira do Rei;1667;805;862;1626;778;848;595;0;506;934;934;0;0;898
24082000;6;30719;                        Passos;1076;531;545;1054;504;550;332;1;312;463;463;0;2;429
24131000;6;30720;                        Pedraído;265;118;147;257;114;143;103;0;79;181;181;0;0;181
24174000;6;30721;                        Queimadela;490;201;289;481;195;286;191;0;133;328;328;0;1;326
24217000;6;30722;                        Quinchães;2278;1090;1188;2259;1077;1182;809;1;726;1110;1107;3;1;992
24315000;6;30723;                        Regadas;1666;805;861;1650;795;855;597;0;512;730;730;0;0;650
24426000;6;30724;                        Revelhe;849;403;446;830;392;438;278;1;255;428;428;0;2;413
24486000;6;30725;                        Ribeiros;640;314;326;605;287;318;224;0;202;333;333;0;0;320
24544000;6;30726;                        Arões (Santa Cristina);1538;747;791;1517;737;780;503;0;479;705;705;0;1;596
24595000;6;30727;                        Silvares (São Clemente);570;262;308;548;248;300;197;0;181;269;269;0;0;252
24631000;6;30728;                        São Gens;1703;798;905;1635;764;871;601;0;529;865;865;0;0;772
24737000;6;30729;                        Silvares (São Martinho);1325;634;691;1280;611;669;455;0;408;634;634;0;0;582
24801000;6;30730;                        Arões (São Romão);3295;1603;1692;3211;1552;1659;1072;1;1005;1375;1375;0;1;1117
24851000;6;30731;                        Seidões;512;237;275;505;232;273;165;1;155;233;233;0;1;225
24881000;6;30732;                        Serafão;996;468;528;967;454;513;342;0;314;534;534;0;1;519
24960000;6;30733;                        Travassós;1539;706;833;1469;664;805;492;1;451;729;729;0;1;699
25023000;6;30734;                        Várzea Cova;358;172;186;348;164;184;138;0;106;295;295;0;0;295
25061000;6;30735;                        Vila Cova;219;96;123;215;91;124;79;0;61;122;122;0;0;121
25093000;6;30736;                        Vinhós;642;309;333;606;294;312;222;0;194;350;350;0;0;328
25141000;5;308;                    Guimarães;158124;76767;81357;154672;74750;79922;53902;39;48550;66716;66706;10;74;43928
25142000;6;30801;                        Aldão;1293;629;664;1270;614;656;422;0;401;523;523;0;0;345
25171000;6;30802;                        Arosa;499;227;272;488;221;267;182;0;159;281;281;0;0;267
25194000;6;30803;                        Atães;1918;980;938;1889;964;925;611;0;584;763;763;0;1;633
25232000;6;30804;                        Azurém;8348;3931;4417;8784;4236;4548;3163;6;2590;4276;4275;1;7;1466
25347000;6;30805;                        Balazar;440;211;229;425;197;228;147;0;133;220;220;0;0;203
25369000;6;30806;                        Barco;1510;735;775;1476;716;760;458;0;457;592;592;0;0;447
25400000;6;30807;                        Brito;4939;2468;2471;4750;2356;2394;1608;1;1496;1839;1839;0;1;1384
25473000;6;30808;                        Caldelas;5723;2802;2921;5548;2697;2851;1975;0;1742;2722;2722;0;3;1135
25540000;6;30809;                        Calvos;1082;513;569;1065;506;559;329;1;327;402;402;0;2;305
25561000;6;30810;                        Castelões;310;149;161;304;147;157;114;0;94;183;183;0;0;180
25579000;6;30811;                        Conde;1378;664;714;1361;655;706;456;0;436;532;532;0;0;455
25610000;6;30812;                        Costa;5155;2475;2680;4943;2355;2588;1886;0;1599;2297;2297;0;2;794
25653000;6;30813;                        Creixomil;9641;4584;5057;9391;4458;4933;3571;2;2992;4325;4324;1;4;1987
25772000;6;30814;                        Donim;833;386;447;807;363;444;261;1;247;392;392;0;1;342
25799000;6;30815;                        Fermentões;5707;2768;2939;5505;2645;2860;1932;0;1732;2245;2245;0;0;1245
25886000;6;30816;                        Figueiredo;436;201;235;428;196;232;140;0;124;168;167;1;0;154
25904000;6;30817;                        Gandarela;1074;544;530;1042;523;519;348;0;339;390;390;0;0;326
25934000;6;30818;                        Gémeos;442;214;228;437;209;228;140;0;135;167;167;0;0;117
25949000;6;30819;                        Gominhães;511;260;251;507;257;250;156;0;154;196;196;0;0;168
25964000;6;30820;                        Gonça;1051;526;525;1004;496;508;333;0;315;422;422;0;0;382
25989000;6;30821;                        Gondar;2868;1408;1460;2762;1340;1422;987;0;894;1141;1140;1;0;615
26037000;6;30822;                        Gondomar;495;238;257;499;241;258;171;0;151;269;269;0;0;247
26060000;6;30823;                        Guardizela;2474;1206;1268;2416;1175;1241;809;1;761;938;938;0;1;783
26115000;6;30824;                        Infantas;1764;869;895;1699;837;862;552;0;549;698;697;1;1;532
26152000;6;30826;                        Leitões;568;268;300;549;258;291;175;0;169;185;185;0;0;170
26167000;6;30827;                        Longos;1372;644;728;1349;633;716;442;1;416;636;636;0;2;553
26201000;6;30828;                        Lordelo;4287;2080;2207;4158;2005;2153;1462;1;1353;1645;1644;1;3;1450
26283000;6;30829;                        Mascotelos;1631;799;832;1585;770;815;583;0;512;699;699;0;0;415
26306000;6;30830;                        Mesão Frio;4173;2010;2163;3988;1915;2073;1397;0;1304;1658;1658;0;1;1017
26369000;6;30831;                        Moreira de Cónegos;4853;2377;2476;4771;2322;2449;1667;0;1550;1885;1885;0;0;1625
26445000;6;30832;                        Nespereira;2578;1282;1296;2531;1255;1276;834;0;801;982;982;0;1;777
26490000;6;30833;                        Oleiros;462;221;241;455;217;238;145;0;134;179;179;0;0;153
26507000;6;30834;                        Guimarães (Oliveira do Castelo);3265;1515;1750;3238;1514;1724;1250;7;964;1676;1676;0;9;805
26572000;6;30835;                        Pencelo;1258;624;634;1269;615;654;415;1;381;515;515;0;1;372
26605000;6;30836;                        Pinheiro;1234;603;631;1210;592;618;405;0;377;445;445;0;0;345
26640000;6;30837;                        Polvoreira;3495;1708;1787;3455;1685;1770;1187;0;1077;1405;1404;1;1;1124
26727000;6;30838;                        Ponte;6610;3223;3387;6437;3102;3335;2217;1;2048;2754;2754;0;4;1797
26827000;6;30839;                        Rendufe;712;356;356;692;342;350;241;0;220;324;324;0;0;297
26852000;6;30840;                        Ronfe;4462;2207;2255;4326;2127;2199;1483;0;1378;1748;1748;0;0;1409
26928000;6;30841;                        Briteiros (Salvador);980;471;509;951;453;498;319;0;299;460;460;0;0;383
26955000;6;30842;                        Prazins (Santa Eufémia);1221;594;627;1186;577;609;373;0;355;489;489;0;0;434
26985000;6;30843;                        Briteiros (Santa Leocádia);819;390;429;798;377;421;263;0;242;346;345;1;0;296
27010000;6;30844;                        Airão (Santa Maria);1686;841;845;1625;810;815;556;0;508;644;644;0;0;525
27050000;6;30845;                        Souto (Santa Maria);771;400;371;761;394;367;259;0;240;369;369;0;0;328
27078000;6;30846;                        Candoso (Santiago);2163;1075;1088;2094;1026;1068;661;0;647;761;760;1;1;553
27112000;6;30847;                        Briteiros (Santo Estêvão);1292;649;643;1282;647;635;400;1;388;565;565;0;1;485
27146000;6;30848;                        Prazins (Santo Tirso);993;503;490;961;481;480;296;0;292;419;419;0;0;327
27172000;6;30849;                        Sande (São Clemente);1695;824;871;1641;795;846;532;2;501;684;683;1;2;504
27221000;6;30850;                        Selho (São Cristóvão);2380;1170;1210;2313;1125;1188;788;1;746;939;939;0;1;725
27261000;6;30851;                        São Faustino;998;501;497;968;482;486;313;0;303;375;375;0;0;290
27288000;6;30853;                        Airão (São João Baptista);827;400;427;805;388;417;248;1;234;293;293;0;1;247
27312000;6;30854;                        Selho (São Jorge);5625;2723;2902;5386;2580;2806;1949;2;1768;2323;2323;0;5;1441
27389000;6;30855;                        Sande (São Lourenço);1097;516;581;1064;496;568;364;0;330;563;563;0;0;464
27422000;6;30856;                        Selho (São Lourenço);1782;905;877;1753;881;872;606;0;571;708;708;0;0;489
27468000;6;30857;                        Candoso (São Martinho);1340;657;683;1299;633;666;455;0;420;550;550;0;0;498
27491000;6;30858;                        Sande (São Martinho);2533;1210;1323;2484;1186;1298;868;0;769;1144;1144;0;0;821
27548000;6;30860;                        Guimarães (São Paio);2896;1325;1571;2868;1303;1565;1151;2;871;1449;1449;0;7;446
27579000;6;30862;                        Souto (São Salvador);830;394;436;815;381;434;271;0;253;358;358;0;0;323
27614000;6;30863;                        Guimarães (São Sebastião);1976;905;1071;1899;859;1040;768;5;519;1028;1028;0;5;433
27640000;6;30864;                        Abação (São Tomé);2252;1143;1109;2223;1129;1094;674;0;662;779;779;0;0;565
27689000;6;30865;                        São Torcato;3373;1643;1730;3284;1586;1698;1147;0;1049;1443;1443;0;0;1109
27745000;6;30866;                        Serzedelo;3680;1804;1876;3655;1778;1877;1251;0;1166;1500;1500;0;0;1239
27810000;6;30867;                        Serzedo;1202;596;606;1171;573;598;400;0;374;468;468;0;0;371
27844000;6;30868;                        Silvares;2282;1124;1158;2237;1096;1141;767;0;701;923;923;0;0;780
27900000;6;30869;                        Tabuadelo;1555;762;793;1523;738;785;500;0;489;592;592;0;1;478
27938000;6;30871;                        Urgezes;5259;2496;2763;5138;2435;2703;1845;2;1612;2302;2302;0;5;1270
27998000;6;30872;                        Vermil;1144;559;585;1122;543;579;376;0;348;444;444;0;0;374
28026000;6;30873;                        Sande (Vila Nova);1739;834;905;1688;806;882;576;0;533;739;739;0;0;642
28068000;6;30874;                        Corvite;883;448;435;865;436;429;272;0;265;342;342;0;0;267
28084000;5;309;                    Póvoa de Lanhoso;21886;10413;11473;21480;10073;11407;7341;10;6547;11739;11739;0;31;9750
28085000;6;30901;                        Águas Santas;420;199;221;412;193;219;135;0;129;201;201;0;0;197
28107000;6;30902;                        Ajude;139;74;65;137;74;63;47;0;43;68;68;0;0;68
28119000;6;30903;                        Brunhais;313;151;162;302;140;162;103;1;94;173;173;0;1;169
28140000;6;30904;                        Calvos;483;250;233;474;237;237;149;0;142;204;204;0;2;206
28169000;6;30905;                        Campos;1046;525;521;1036;517;519;342;0;317;510;510;0;0;473
28217000;6;30906;                        Covelas;416;209;207;427;213;214;132;0;124;173;173;0;0;172
28245000;6;30907;                        Esperança;339;149;190;339;147;192;129;0;110;232;232;0;0;227
28259000;6;30908;                        Ferreiros;416;203;213;422;205;217;124;0;119;176;176;0;0;171
28288000;6;30909;                        Fonte Arcada;1273;583;690;1203;535;668;413;1;373;648;648;0;1;596
28331000;6;30910;                        Frades;270;134;136;264;128;136;97;0;80;149;149;0;1;150
28358000;6;30911;                        Friande;241;113;128;236;111;125;86;0;74;157;157;0;0;156
28383000;6;30912;                        Galegos;543;269;274;529;255;274;191;0;167;295;295;0;0;278
28410000;6;30913;                        Garfe;1000;458;542;990;455;535;347;0;302;536;536;0;0;509
28452000;6;30914;                        Geraz do Minho;521;258;263;521;259;262;171;0;157;241;241;0;1;231
28486000;6;30915;                        Lanhoso;742;334;408;742;334;408;264;1;218;426;426;0;2;399
28526000;6;30916;                        Louredo;439;205;234;421;190;231;136;0;126;174;174;0;0;164
28551000;6;30917;                        Monsul;773;363;410;764;359;405;237;0;234;358;358;0;0;350
28588000;6;30918;                        Moure;242;121;121;227;109;118;76;0;68;124;124;0;5;118
28601000;6;30919;                        Póvoa de Lanhoso (Nossa Senhora do Amparo);5052;2378;2674;5000;2313;2687;1748;2;1521;2982;2982;0;9;1382
28696000;6;30920;                        Oliveira;397;179;218;378;169;209;129;0;120;197;197;0;1;191
28714000;6;30921;                        Rendufinho;736;363;373;735;357;378;238;0;207;371;371;0;0;356
28737000;6;30922;                        Santo Emilião;890;423;467;848;390;458;275;1;267;398;398;0;1;332
28770000;6;30923;                        São João de Rei;401;201;200;390;193;197;134;0;117;227;227;0;0;221
28795000;6;30924;                        Serzedelo;723;335;388;721;332;389;249;0;216;413;413;0;0;410
28829000;6;30925;                        Sobradelo da Goma;794;387;407;768;376;392;308;0;242;502;502;0;2;500
28874000;6;30926;                        Taíde;1613;776;837;1552;735;817;522;1;482;910;910;0;1;849
28920000;6;30927;                        Travassos;696;320;376;692;308;384;234;2;206;366;366;0;3;355
28953000;6;30928;                        Verim;353;169;184;358;169;189;120;1;104;206;206;0;1;207
28982000;6;30929;                        Vilela;615;284;331;592;270;322;205;0;188;322;322;0;0;313
29018000;5;311;                    Vieira do Minho;12997;6252;6745;12455;5903;6552;4482;9;3888;8029;8025;4;36;7454
29019000;6;31101;                        Anissó;215;99;116;205;90;115;81;0;66;142;142;0;0;142
29041000;6;31102;                        Anjos;333;142;191;318;138;180;126;0;104;220;220;0;0;217
29073000;6;31103;                        Campos;185;89;96;168;84;84;74;0;53;185;185;0;6;189
29095000;6;31104;                        Caniçada;455;211;244;446;206;240;153;0;140;329;329;0;5;329
29128000;6;31105;                        Cantelães;828;396;432;801;380;421;283;1;239;410;410;0;1;400
29163000;6;31106;                        Cova;301;150;151;279;141;138;95;1;80;201;201;0;1;202
29186000;6;31107;                        Eira Vedra;702;356;346;689;342;347;226;0;216;389;389;0;0;384
29224000;6;31108;                        Guilhofrei;961;452;509;899;410;489;340;0;292;600;600;0;2;591
29283000;6;31109;                        Louredo;436;224;212;433;222;211;172;1;137;301;301;0;1;298
29310000;6;31110;                        Mosteiro;774;388;386;740;364;376;246;0;235;389;388;1;0;385
29363000;6;31111;                        Parada do Bouro;469;246;223;449;228;221;171;0;142;304;304;0;6;305
29394000;6;31112;                        Pinheiro;447;229;218;407;196;211;154;0;139;234;234;0;0;234
29424000;6;31113;                        Rossas;1673;786;887;1620;751;869;584;1;491;1111;1108;3;3;1105
29534000;6;31114;                        Ruivães;738;349;389;686;317;369;293;1;227;574;574;0;1;559
29593000;6;31115;                        Salamonde;387;183;204;353;168;185;144;0;122;309;309;0;1;305
29621000;6;31116;                        Soengas;148;72;76;152;67;85;47;0;45;112;112;0;1;113
29640000;6;31117;                        Soutelo;173;83;90;165;80;85;67;0;54;122;122;0;0;122
29655000;6;31118;                        Tabuaças;919;446;473;905;439;466;287;0;283;484;484;0;2;478
29701000;6;31119;                        Ventosa;358;170;188;342;156;186;119;1;107;268;268;0;3;270
29728000;6;31120;                        Vieira do Minho;2239;1068;1171;2164;1025;1139;739;3;645;1222;1222;0;3;704
29785000;6;31121;                        Vilar do Chão;256;113;143;234;99;135;81;0;71;123;123;0;0;122
29804000;5;312;                    Vila Nova de Famalicão;133832;64849;68983;129947;62345;67602;45138;24;41376;55285;55252;33;46;38868
29805000;6;31201;                        Abade de Vermoim;437;207;230;431;203;228;139;0;142;157;157;0;0;151
29827000;6;31202;                        Antas;6925;3287;3638;6707;3154;3553;2556;3;2142;3279;3278;1;8;1357
29942000;6;31203;                        Avidos;1742;855;887;1656;808;848;582;1;550;710;710;0;1;553
30002000;6;31204;                        Bairro;3598;1716;1882;3513;1658;1855;1239;1;1132;1567;1566;1;2;1217
30098000;6;31205;                        Bente;925;459;466;917;453;464;307;0;288;378;378;0;0;298
30136000;6;31206;                        Brufe;2231;1072;1159;2172;1039;1133;767;1;697;903;903;0;1;707
30192000;6;31207;                        Cabeçudos;1466;746;720;1420;714;706;495;0;465;579;576;3;0;416
30249000;6;31208;                        Calendário;11667;5566;6101;11237;5303;5934;4137;0;3646;5128;5128;0;0;2706
30443000;6;31209;                        Carreira;1662;799;863;1610;770;840;603;0;524;754;754;0;0;623
30495000;6;31210;                        Castelões;2021;997;1024;1959;962;997;614;1;617;731;730;1;1;643
30561000;6;31211;                        Cavalões;1539;743;796;1494;721;773;495;0;470;605;605;0;0;532
30621000;6;31212;                        Cruz;1738;832;906;1712;810;902;554;0;542;643;643;0;3;601
30676000;6;31213;                        Delães;3917;1885;2032;3836;1833;2003;1390;1;1257;1720;1717;3;1;1111
30772000;6;31214;                        Esmeriz;2218;1095;1123;2172;1062;1110;723;0;687;864;864;0;0;641
30844000;6;31215;                        Fradelos;3914;1906;2008;3790;1830;1960;1163;0;1155;1434;1434;0;0;1308
31003000;6;31216;                        Gavião;3747;1764;1983;3588;1664;1924;1249;3;1157;1458;1457;1;4;1129
31097000;6;31217;                        Gondifelos;2438;1160;1278;2376;1111;1265;777;0;731;1110;1110;0;0;980
31205000;6;31218;                        Jesufrei;606;302;304;582;292;290;210;0;184;256;254;2;0;234
31247000;6;31219;                        Joane;8089;3956;4133;7825;3769;4056;2689;1;2465;3228;3226;2;3;2043
31372000;6;31220;                        Lagoa;911;440;471;876;418;458;316;0;280;354;353;1;0;321
31409000;6;31221;                        Landim;2834;1403;1431;2750;1348;1402;933;0;901;1169;1168;1;0;964
31511000;6;31222;                        Lemenhe;1272;637;635;1256;624;632;410;0;395;484;484;0;0;454
31570000;6;31223;                        Louro;2250;1084;1166;2152;1035;1117;732;0;698;901;901;0;1;777
31666000;6;31224;                        Lousado;4057;2009;2048;4037;1978;2059;1314;1;1243;1525;1525;0;1;1249
31782000;6;31225;                        Mogege;1943;950;993;1876;912;964;637;0;597;752;751;1;0;614
31837000;6;31226;                        Mouquim;1266;627;639;1234;606;628;419;0;399;486;486;0;0;445
31896000;6;31227;                        Nine;2974;1453;1521;2904;1414;1490;953;0;922;1203;1203;0;0;1052
32013000;6;31228;                        Novais;1124;554;570;1086;537;549;358;0;357;440;440;0;0;386
32059000;6;31229;                        Outiz;913;412;501;889;392;497;270;1;253;339;339;0;1;309
32101000;6;31230;                        Pedome;2120;1052;1068;2031;997;1034;726;0;661;904;904;0;0;712
32172000;6;31231;                        Portela;585;297;288;562;279;283;177;0;172;212;211;1;0;194
32210000;6;31232;                        Pousada de Saramagos;2234;1084;1150;2172;1042;1130;745;0;694;885;885;0;0;574
32261000;6;31233;                        Requião;3376;1660;1716;3280;1611;1669;1104;1;1037;1296;1296;0;1;1035
32353000;6;31234;                        Riba de Ave;3425;1627;1798;3322;1561;1761;1225;1;1087;1531;1528;3;2;992
32430000;6;31235;                        Ribeirão;8828;4344;4484;8614;4181;4433;2842;1;2647;3351;3345;6;2;2525
32659000;6;31236;                        Ruivães;1877;927;950;1815;888;927;633;0;611;800;799;1;0;673
32739000;6;31237;                        Arnoso (Santa Eulália);1111;538;573;1108;532;576;360;0;340;427;427;0;0;381
32793000;6;31238;                        Arnoso (Santa Maria);2008;997;1011;1934;945;989;638;1;613;809;809;0;1;643
32862000;6;31239;                        Oliveira (Santa Maria);3420;1681;1739;3317;1611;1706;1186;0;1086;1422;1422;0;0;1084
32954000;6;31240;                        Vale (São Cosme);3032;1494;1538;2898;1405;1493;967;0;949;1123;1123;0;0;962
33068000;6;31241;                        Vale (São Martinho);2081;1022;1059;2019;982;1037;655;1;640;774;773;1;1;670
33139000;6;31242;                        Oliveira (São Mateus);2714;1300;1414;2632;1249;1383;958;1;856;1195;1195;0;1;913
33225000;6;31243;                        Seide (São Miguel);1171;565;606;1144;544;600;391;0;374;454;454;0;0;406
33264000;6;31244;                        Seide (São Paio);371;177;194;374;181;193;129;0;116;173;173;0;1;153
33289000;6;31245;                        Sezures;497;237;260;487;230;257;156;0;149;188;188;0;0;170
33313000;6;31246;                        Telhado;1784;869;915;1724;824;900;565;1;549;654;653;1;1;580
33381000;6;31247;                        Vermoim;2930;1435;1495;2820;1354;1466;996;1;913;1208;1208;0;1;851
33474000;6;31248;                        Vila Nova de Famalicão;8478;3947;4531;8324;3856;4468;3241;2;2576;4223;4223;0;8;1119
33559000;6;31249;                        Vilarinho das Cambas;1366;680;686;1313;653;660;413;0;410;499;496;3;0;410
33597000;5;314;                    Vizela;23736;11653;12083;22954;11191;11763;7865;4;7301;9042;9032;10;6;5815
33598000;6;31401;                        Santa Eulália;5619;2771;2848;5379;2631;2748;1827;1;1727;2057;2055;2;1;1417
33681000;6;31402;                        Caldas de Vizela (São João);3411;1635;1776;3310;1576;1734;1170;0;1054;1345;1344;1;2;896
33742000;6;31403;                        Caldas de Vizela (São Miguel);7222;3495;3727;6987;3355;3632;2508;3;2262;2929;2925;4;3;1454
33827000;6;31404;                        Infias;1840;912;928;1789;885;904;613;0;571;705;705;0;0;510
33871000;6;31405;                        Tagilde;1861;936;925;1829;914;915;555;0;550;632;631;1;0;489
33912000;6;31406;                        Vizela (Santo Adrião);2280;1142;1138;2201;1094;1107;728;0;693;837;835;2;0;631
33949000;6;31407;                        Vizela (São Paio);1503;762;741;1459;736;723;464;0;444;537;537;0;0;418
33983000;5;1314;                    Santo Tirso;71530;34334;37196;69630;33096;36534;24958;28;22711;29700;29678;22;41;21930
33984000;6;131401;                        Agrela;1584;754;830;1566;735;831;511;0;500;613;613;0;0;553
34040000;6;131402;                        Água Longa;2207;1081;1126;2151;1036;1115;746;0;691;917;917;0;0;829
34132000;6;131404;                        Areias;2454;1168;1286;2371;1118;1253;849;1;798;1036;1036;0;1;871
34191000;6;131405;                        Aves;8458;4075;4383;8226;3912;4314;3095;4;2705;3717;3714;3;8;2294
34341000;6;131406;                        Burgães;2097;1013;1084;2052;985;1067;710;0;656;850;850;0;0;764
34397000;6;131407;                        Carreira;1110;526;584;1078;512;566;372;1;348;434;434;0;1;409
34428000;6;131410;                        Guimarei;738;358;380;713;343;370;257;0;231;315;315;0;1;280
34458000;6;131411;                        Lama;1393;655;738;1349;624;725;489;0;443;572;572;0;0;479
34490000;6;131412;                        Lamelas;922;435;487;893;415;478;317;1;284;385;385;0;1;365
34532000;6;131413;                        Monte Córdova;3958;1957;2001;3832;1877;1955;1389;1;1246;1676;1672;4;1;1504
34639000;6;131415;                        Palmeira;1321;617;704;1301;602;699;458;0;421;536;536;0;0;445
34676000;6;131416;                        Rebordões;3416;1641;1775;3341;1598;1743;1201;0;1133;1456;1456;0;0;1252
34745000;6;131417;                        Refojos de Riba de Ave;962;456;506;916;430;486;326;0;300;394;394;0;0;366
34798000;6;131418;                        Reguenga;1596;760;836;1562;740;822;530;0;519;648;648;0;0;556
34860000;6;131419;                        Roriz;3665;1791;1874;3566;1722;1844;1238;3;1167;1359;1356;3;3;1108
34942000;6;131420;                        Couto (Santa Cristina);4064;1944;2120;3990;1889;2101;1437;3;1308;1638;1637;1;3;1331
35013000;6;131422;                        Santo Tirso;14107;6599;7508;13757;6378;7379;5051;12;4339;6244;6243;1;18;3161
35198000;6;131424;                        Negrelos (São Mamede);2145;1058;1087;2101;1023;1078;692;0;671;795;795;0;0;714
35232000;6;131426;                        Campo (São Martinho);3470;1683;1787;3388;1631;1757;1206;1;1130;1383;1383;0;2;899
35275000;6;131427;                        Couto (São Miguel);1222;582;640;1199;572;627;433;0;388;512;512;0;0;408
35299000;6;131429;                        São Salvador do Campo;1194;587;607;1169;570;599;379;0;380;444;444;0;0;345
35326000;6;131430;                        Negrelos (São Tomé);4032;1923;2109;3889;1831;2058;1458;0;1335;1748;1747;1;1;1318
35399000;6;131431;                        Sequeiró;1627;797;830;1564;761;803;557;1;511;654;654;0;1;574
35433000;6;131432;                        Vilarinho;3788;1874;1914;3656;1792;1864;1257;0;1207;1374;1365;9;0;1105
35491000;5;1318;                    Trofa;38999;18813;20186;37697;18001;19696;13085;5;12155;15617;15583;34;11;10022
35492000;6;131801;                        Alvarelhos;3151;1553;1598;3049;1491;1558;985;0;988;1137;1135;2;0;1032
35590000;6;131802;                        Bougado (Santiago);6422;3133;3289;6261;3034;3227;2064;0;2012;2425;2422;3;1;1993
35737000;6;131803;                        Bougado (São Martinho);15190;7205;7985;14627;6867;7760;5326;3;4718;6455;6446;9;7;3021
35992000;6;131804;                        Coronado (São Mamede);4292;2106;2186;4149;2010;2139;1408;1;1338;1666;1663;3;2;1297
36090000;6;131805;                        Coronado (São Romão);4827;2341;2486;4660;2226;2434;1634;1;1505;2039;2027;12;1;1046
36160000;6;131806;                        Covelas;1536;753;783;1508;729;779;495;0;485;558;553;5;0;484
36219000;6;131807;                        Guidões;1659;804;855;1586;757;829;546;0;506;618;618;0;0;524
36280000;6;131808;                        Muro;1922;918;1004;1857;887;970;627;0;603;719;719;0;0;625
36342000;4;114;                Grande Porto;1287282;610455;676827;1258991;590650;668341;489471;435;398776;623616;623085;531;934;273491
36343000;5;107;                    Espinho;31786;15112;16674;31208;14737;16471;12017;5;10007;15756;15753;3;22;8889
36344000;6;10701;                        Anta;10363;4934;5429;10142;4786;5356;3758;2;3283;4643;4643;0;2;2657
36542000;6;10702;                        Espinho;9832;4535;5297;9707;4459;5248;4220;1;3058;6292;6291;1;16;2491
36781000;6;10703;                        Guetim;1403;665;738;1363;642;721;484;0;458;568;568;0;0;445
36816000;6;10704;                        Paramos;3515;1731;1784;3434;1689;1745;1218;1;1112;1482;1481;1;2;1288
36908000;6;10705;                        Silvalde;6673;3247;3426;6562;3161;3401;2337;1;2096;2771;2770;1;2;2008
37055000;5;1304;                    Gondomar;168027;81007;87020;162264;77373;84891;61451;28;53350;73436;73416;20;37;36559
37056000;6;130401;                        Covelo;1647;819;828;1607;797;810;546;1;514;616;616;0;1;504
37096000;6;130402;                        Fânzeres;23108;11232;11876;22353;10750;11603;8365;6;7290;10003;10002;1;7;4241
37251000;6;130403;                        Foz do Sousa;6054;2969;3085;5848;2824;3024;1996;0;1908;2335;2335;0;0;1905
37317000;6;130404;                        Jovim;7146;3546;3600;6961;3411;3550;2433;2;2250;2775;2775;0;3;1965
37441000;6;130405;                        Lomba;1505;730;775;1457;710;747;496;1;459;773;773;0;2;699
37486000;6;130406;                        Medas;2129;1053;1076;2040;985;1055;709;0;660;832;832;0;1;722
37543000;6;130407;                        Melres;3691;1872;1819;3579;1778;1801;1133;0;1128;1317;1317;0;0;1202
37619000;6;130408;                        Rio Tinto;50713;23921;26792;48848;22775;26073;19608;7;16169;23846;23844;2;9;9171
37981000;6;130409;                        Gondomar (São Cosme);27047;13068;13979;26096;12479;13617;9813;5;8601;11470;11467;3;7;5651
38216000;6;130410;                        São Pedro da Cova;16478;8155;8323;15973;7823;8150;5753;0;5233;6597;6583;14;0;4117
38388000;6;130411;                        Valbom;14407;6880;7527;14042;6645;7397;5469;4;4583;6596;6596;0;5;3215
38524000;6;130412;                        Baguim do Monte (Rio Tinto);14102;6762;7340;13460;6396;7064;5130;2;4555;6276;6276;0;2;3167
38652000;5;1306;                    Maia;135306;64855;70451;131191;62314;68877;50268;39;42555;59614;59571;43;53;26812
38653000;6;130601;                        Águas Santas;27470;13110;14360;26503;12514;13989;10349;9;8705;12164;12143;21;12;4495
38946000;6;130602;                        Barca;2633;1247;1386;2572;1201;1371;940;0;836;1040;1040;0;0;834
39000000;6;130603;                        Folgosa;3704;1833;1871;3650;1805;1845;1273;2;1151;1538;1538;0;2;1313
39100000;6;130604;                        Gemunde;5215;2529;2686;5090;2440;2650;1846;1;1651;2111;2110;1;1;1131
39168000;6;130605;                        Gondim;2208;1062;1146;2170;1036;1134;732;0;688;819;818;1;0;623
39212000;6;130606;                        Gueifães;11964;5712;6252;11516;5439;6077;4480;3;3812;5075;5073;2;3;2500
39344000;6;130607;                        Maia;12406;5834;6572;11885;5544;6341;4798;2;3869;5692;5689;3;4;1396
39465000;6;130608;                        Milheirós;4861;2350;2511;4707;2247;2460;1747;1;1548;1991;1991;0;1;1263
39534000;6;130609;                        Moreira;12890;6248;6642;12437;5966;6471;4811;2;4100;5823;5821;2;7;2459
39706000;6;130610;                        Nogueira;5473;2621;2852;5288;2498;2790;2001;3;1744;2387;2384;3;4;1244
39794000;6;130611;                        Avioso (Santa Maria);4513;2196;2317;4364;2108;2256;1652;1;1383;1989;1986;3;2;787
39871000;6;130612;                        Avioso (São Pedro);3826;1862;1964;3937;1922;2015;1442;0;1218;1792;1791;1;1;823
39929000;6;130613;                        São Pedro Fins;1837;901;936;1828;891;937;595;1;565;727;726;1;1;555
39980000;6;130614;                        Silva Escura;2507;1207;1300;2464;1176;1288;843;0;764;992;991;1;0;720
40036000;6;130615;                        Vermoim;15764;7607;8157;15146;7228;7918;5840;2;4919;6698;6698;0;2;2319
40202000;6;130616;                        Vila Nova da Telha;5886;2839;3047;5625;2688;2937;2094;6;1843;2575;2573;2;6;1762
40286000;6;130617;                        Pedrouços;12149;5697;6452;12009;5611;6398;4825;6;3759;6201;6199;2;7;2588
40432000;5;1308;                    Matosinhos;175478;83444;92034;171091;80559;90532;67821;50;54687;82155;82085;70;80;33389
40433000;6;130801;                        Custóias;18650;9287;9363;18182;8992;9190;6639;8;5747;7596;7594;2;3;3885
40616000;6;130802;                        Guifões;9495;4552;4943;9225;4370;4855;3621;3;3047;4139;4137;2;3;2590
40718000;6;130803;                        Lavra;10033;4861;5172;9554;4575;4979;3672;2;3209;4941;4932;9;3;3104
40877000;6;130804;                        Leça do Balio;17571;8422;9149;17106;8066;9040;6634;7;5486;7713;7708;5;9;3691
41055000;6;130805;                        Leça da Palmeira;18502;8716;9786;18006;8532;9474;7324;3;5828;9400;9393;7;16;3656
41310000;6;130806;                        Matosinhos;30984;14429;16555;29694;13666;16028;12485;8;9446;15032;15014;18;21;4010
41572000;6;130807;                        Perafita;13607;6571;7036;13153;6244;6909;5036;0;4372;5856;5848;8;3;3244
41731000;6;130808;                        Santa Cruz do Bispo;5767;2846;2921;5538;2718;2820;1964;8;1671;2215;2207;8;3;1320
41804000;6;130809;                        São Mamede de Infesta;23122;10745;12377;23376;10786;12590;9508;7;7138;12284;12279;5;11;4263
42030000;6;130810;                        Senhora da Hora;27747;13015;14732;27257;12610;14647;10938;4;8743;12979;12973;6;8;3626
42281000;5;1312;                    Porto;237591;108104;129487;242216;109898;132318;100826;189;69740;137371;137236;135;520;44324
42282000;6;131201;                        Aldoar;12843;6044;6799;12799;5891;6908;4850;10;3833;5843;5838;5;13;2212
42402000;6;131202;                        Bonfim;24265;10674;13591;24146;10541;13605;10994;39;6955;14993;14988;5;91;5428
42604000;6;131203;                        Campanhã;32659;15130;17529;31846;14582;17264;12955;18;10011;16431;16361;70;27;7133
42971000;6;131204;                        Cedofeita;22077;9736;12341;22814;9970;12844;10375;31;6221;15711;15700;11;82;4796
43143000;6;131205;                        Foz do Douro;10997;5098;5899;10569;4824;5745;4517;3;3306;5701;5698;3;6;1962
43301000;6;131206;                        Lordelo do Ouro;22270;10337;11933;22068;10158;11910;8631;2;6682;10919;10918;1;9;2651
43498000;6;131207;                        Massarelos;6789;3088;3701;7698;3523;4175;3064;2;1951;4380;4376;4;16;1114
43597000;6;131208;                        Miragaia;2067;953;1114;3012;1655;1357;993;0;564;1522;1522;0;7;572
43638000;6;131209;                        Nevogilde;5018;2296;2722;4748;2145;2603;1985;3;1455;2460;2459;1;3;896
43691000;6;131210;                        Paranhos;44298;20045;24253;47800;21748;26052;19185;33;13089;27192;27179;13;64;7789
44108000;6;131211;                        Ramalde;38012;17311;20701;36838;16636;20202;15352;19;11355;18835;18831;4;24;4783
44426000;6;131212;                        Santo Ildefonso;9029;4104;4925;9888;4559;5329;4636;13;2368;7132;7126;6;89;2713
44544000;6;131213;                        São Nicolau;1906;842;1064;2017;922;1095;804;6;546;1586;1585;1;17;443
44581000;6;131214;                        Sé;3460;1609;1851;3705;1725;1980;1583;7;904;2745;2738;7;43;1178
44644000;6;131215;                        Vitória;1901;837;1064;2268;1019;1249;902;3;500;1921;1917;4;29;654
44684000;5;1313;                    Póvoa de Varzim;63408;29958;33450;61276;28580;32696;21669;14;19318;34890;34881;9;37;17060
44685000;6;131301;                        A Ver-o-Mar;8675;4111;4564;8362;3890;4472;3123;2;2695;6405;6399;6;5;2351
44841000;6;131302;                        Aguçadoura;4257;2067;2190;4212;2033;2179;1218;0;1305;1684;1684;0;0;1477
44937000;6;131303;                        Amorim;2784;1350;1434;2730;1313;1417;871;0;855;1022;1022;0;0;903
45019000;6;131304;                        Argivai;2163;1002;1161;2116;962;1154;728;0;676;869;869;0;0;608
45055000;6;131305;                        Balazar;2543;1194;1349;2449;1130;1319;816;1;745;1094;1093;1;1;877
45152000;6;131306;                        Beiriz;3683;1760;1923;3746;1842;1904;1187;0;1155;1549;1549;0;1;1323
45248000;6;131307;                        Estela;2316;1123;1193;2233;1063;1170;652;1;696;934;934;0;4;892
45325000;6;131308;                        Laundos;2055;976;1079;1997;933;1064;564;0;629;785;785;0;1;777
45386000;6;131309;                        Navais;1479;681;798;1417;645;772;439;0;455;557;557;0;0;526
45445000;6;131310;                        Póvoa de Varzim;28420;13243;15177;27122;12403;14719;10660;5;8628;18128;18126;2;19;5510
45795000;6;131311;                        Rates;2505;1234;1271;2442;1188;1254;682;1;749;880;880;0;2;868
45885000;6;131312;                        Terroso;2528;1217;1311;2450;1178;1272;729;4;730;983;983;0;4;948
45973000;5;1315;                    Valongo;93858;45016;48842;90209;42744;47465;33946;24;29632;40413;40383;30;32;18475
45974000;6;131501;                        Alfena;15211;7372;7839;14582;6964;7618;5309;4;4767;6221;6216;5;5;3641
46136000;6;131502;                        Campo;9197;4538;4659;8942;4374;4568;3079;1;2897;3537;3531;6;2;2324
46290000;6;131503;                        Ermesinde;38798;18358;20440;37307;17463;19844;14761;15;12374;17395;17383;12;18;6448
46615000;6;131504;                        Sobrado;6727;3262;3465;6589;3157;3432;2139;1;2066;2475;2475;0;1;1893
46722000;6;131505;                        Valongo;23925;11486;12439;22789;10786;12003;8658;3;7528;10785;10778;7;6;4169
46995000;5;1316;                    Vila do Conde;79533;38469;41064;76143;35842;40301;27210;21;24625;37729;37697;32;41;22895
46996000;6;131601;                        Arcos;819;393;426;807;381;426;251;0;247;312;312;0;1;292
47023000;6;131602;                        Árvore;5196;2609;2587;4976;2448;2528;1845;1;1604;2724;2722;2;1;1751
47144000;6;131603;                        Aveleda;1314;633;681;1269;599;670;447;0;423;503;501;2;0;462
47174000;6;131604;                        Azurara;2305;1091;1214;2309;1081;1228;829;2;716;1264;1264;0;6;692
47210000;6;131605;                        Bagunte;1489;730;759;1396;674;722;424;1;443;494;493;1;1;483
47250000;6;131606;                        Canidelo;906;435;471;886;418;468;293;0;283;330;330;0;0;272
47272000;6;131607;                        Fajozes;1425;699;726;1376;661;715;468;1;449;564;559;5;1;430
47313000;6;131608;                        Ferreiró;690;339;351;667;322;345;212;0;198;247;247;0;1;226
47330000;6;131609;                        Fornelo;1392;671;721;1358;644;714;463;0;428;604;604;0;0;483
47365000;6;131610;                        Gião;1756;877;879;1671;824;847;615;0;556;672;671;1;0;519
47401000;6;131611;                        Guilhabreu;2357;1154;1203;2273;1091;1182;787;0;738;841;840;1;0;658
47444000;6;131612;                        Junqueira;2019;977;1042;1941;920;1021;647;1;621;780;780;0;1;714
47492000;6;131613;                        Labruge;2806;1372;1434;2667;1281;1386;953;1;870;1504;1502;2;1;866
47546000;6;131614;                        Macieira da Maia;2321;1138;1183;2207;1067;1140;757;1;737;952;940;12;1;635
47588000;6;131615;                        Malta;1385;686;699;1339;647;692;463;0;439;506;506;0;0;358
47614000;6;131616;                        Mindelo;3491;1646;1845;3320;1535;1785;1266;0;1098;2478;2478;0;0;1640
47728000;6;131617;                        Modivas;1806;873;933;1740;828;912;596;0;576;718;718;0;0;553
47772000;6;131618;                        Mosteiró;931;451;480;931;450;481;320;0;293;409;409;0;0;354
47807000;6;131619;                        Outeiro Maior;369;179;190;349;168;181;103;0;108;132;132;0;0;122
47825000;6;131620;                        Parada;300;156;144;292;151;141;94;0;89;120;120;0;0;113
47841000;6;131621;                        Retorta;1165;574;591;1122;537;585;396;0;364;479;479;0;1;376
47866000;6;131622;                        Rio Mau;1862;900;962;1780;845;935;593;0;568;732;732;0;0;642
47923000;6;131623;                        Tougues;887;426;461;833;385;448;286;0;274;340;340;0;0;244
47941000;6;131624;                        Touguinha;2000;970;1030;1902;891;1011;601;2;571;743;742;1;2;543
47968000;6;131625;                        Touguinhó;1386;663;723;1292;600;692;439;0;431;574;574;0;0;478
47997000;6;131626;                        Vairão;1251;590;661;1206;565;641;391;0;388;487;487;0;1;414
48037000;6;131627;                        Vila Chã;3094;1473;1621;3027;1420;1607;1041;0;986;1672;1672;0;2;1314
48093000;6;131628;                        Vila do Conde;28636;13730;14906;27167;12466;14701;10192;11;8772;14832;14829;3;21;5940
48407000;6;131629;                        Vilar;1638;801;837;1575;757;818;555;0;537;633;633;0;0;503
48434000;6;131630;                        Vilar de Pinheiro;2537;1233;1304;2465;1186;1279;883;0;818;1083;1081;2;0;818
48482000;5;1317;                    Vila Nova de Gaia;302295;144490;157805;293393;138603;154790;114263;65;94862;142252;142063;189;112;65088
48483000;6;131701;                        Arcozelo;14352;6937;7415;13826;6610;7216;5319;7;4498;6963;6955;8;9;3862
48732000;6;131702;                        Avintes;11497;5603;5894;11260;5479;5781;4119;1;3636;4973;4965;8;2;2897
48900000;6;131703;                        Canelas;13459;6525;6934;13103;6289;6814;4876;0;4270;5841;5833;8;0;2324
49034000;6;131704;                        Canidelo;27769;13362;14407;26591;12606;13985;10768;4;8806;13291;13274;17;9;5427
49283000;6;131705;                        Crestuma;2621;1273;1348;2533;1221;1312;873;1;824;1020;1020;0;2;702
49317000;6;131706;                        Grijó;10578;5115;5463;10317;4941;5376;3705;1;3342;4513;4487;26;11;3286
49492000;6;131707;                        Gulpilhares;11341;5432;5909;10870;5122;5748;4223;8;3521;5594;5590;4;10;3014
49619000;6;131708;                        Lever;2794;1365;1429;2706;1312;1394;940;0;869;1139;1139;0;3;972
49673000;6;131709;                        Madalena;10040;4789;5251;9614;4538;5076;3823;3;3197;4884;4877;7;3;3030
49803000;6;131710;                        Mafamude;38544;17734;20810;37271;16955;20316;15918;10;11960;19714;19691;23;13;5050
50082000;6;131711;                        Olival;5812;2807;3005;5683;2724;2959;1931;0;1818;2180;2180;0;0;1599
50193000;6;131712;                        Oliveira do Douro;22383;10651;11732;21518;10122;11396;8509;1;7135;10585;10575;10;1;3872
50383000;6;131713;                        Pedroso;18714;9148;9566;18078;8750;9328;6626;6;5923;8051;8044;7;13;5415
50659000;6;131714;                        Perozinho;6359;3151;3208;6136;3006;3130;2240;1;1988;2618;2617;1;1;1830
50762000;6;131715;                        Sandim;5938;2866;3072;5899;2857;3042;1908;1;1846;2275;2274;1;2;1962
50895000;6;131716;                        Vila Nova de Gaia (Santa Marinha);30146;14054;16092;29046;13408;15638;12523;8;9326;16346;16334;12;10;5266
51179000;6;131717;                        São Félix da Marinha;12706;6144;6562;12364;5990;6374;4799;2;3991;6431;6425;6;3;3216
51382000;6;131718;                        São Pedro da Afurada;3568;1737;1831;3522;1708;1814;1537;0;1039;2137;2137;0;4;658
51432000;6;131719;                        Seixezelo;1712;831;881;1651;791;860;601;0;537;758;758;0;0;517
51459000;6;131720;                        Sermonde;1360;655;705;1315;627;688;466;1;417;548;548;0;1;439
51480000;6;131721;                        Serzedo;7891;3767;4124;7639;3597;4042;2771;1;2527;3288;3255;33;1;2090
51587000;6;131722;                        Valadares;10678;5072;5606;10266;4830;5436;3998;4;3370;4834;4831;3;8;2438
51705000;6;131723;                        Vilar de Andorinho;18155;8820;9335;18864;8818;10046;6458;2;5629;7882;7876;6;3;2489
51868000;6;131724;                        Vilar do Paraíso;13878;6652;7226;13321;6302;7019;5332;3;4393;6387;6378;9;3;2733
52012000;4;115;                Tâmega;550516;268097;282419;527779;251769;276010;182728;104;166009;248228;248133;95;276;197914
52013000;5;106;                    Castelo de Paiva;16733;8184;8549;15855;7553;8302;5575;5;5143;7423;7417;6;8;6567
52014000;6;10601;                        Bairros;2047;980;1067;1934;907;1027;660;0;656;801;801;0;0;708
52086000;6;10602;                        Fornos;1439;666;773;1331;588;743;515;0;449;678;678;0;0;617
52153000;6;10603;                        Paraíso;924;473;451;888;445;443;318;0;275;515;515;0;0;479
52230000;6;10604;                        Pedorido;1458;712;746;1403;678;725;505;1;450;685;684;1;1;645
52304000;6;10605;                        Raiva;2312;1154;1158;2227;1090;1137;791;2;689;1084;1084;0;2;1020
52372000;6;10606;                        Real;1300;635;665;1241;598;643;418;0;392;655;655;0;0;599
52456000;6;10607;                        Santa Maria de Sardoura;2538;1257;1281;2367;1134;1233;814;1;771;1045;1042;3;1;982
52530000;6;10608;                        São Martinho de Sardoura;1931;954;977;1807;864;943;612;0;596;742;742;0;0;609
52587000;6;10609;                        Sobrado;2784;1353;1431;2657;1249;1408;942;1;865;1218;1216;2;4;908
52668000;5;304;                    Cabeceiras de Basto;16710;8115;8595;15808;7534;8274;5622;4;4869;9328;9326;2;28;8470
52669000;6;30401;                        Abadim;571;268;303;556;259;297;182;0;158;309;309;0;2;309
52697000;6;30402;                        Alvite;963;467;496;884;411;473;301;0;283;423;423;0;1;404
52740000;6;30403;                        Arco de Baúlhe;1669;829;840;1597;779;818;547;0;486;896;896;0;1;727
52790000;6;30404;                        Basto;938;463;475;880;421;459;282;0;258;441;441;0;0;426
52822000;6;30405;                        Bucos;554;261;293;504;225;279;191;1;162;326;326;0;5;327
52857000;6;30406;                        Cabeceiras de Basto;711;344;367;671;323;348;255;1;188;504;504;0;2;500
52912000;6;30407;                        Cavez;1268;623;645;1236;606;630;461;1;377;883;883;0;5;875
52962000;6;30408;                        Faia;558;283;275;537;265;272;187;0;163;258;258;0;2;236
52987000;6;30409;                        Gondiães;227;104;123;218;99;119;105;0;66;275;275;0;1;270
53012000;6;30410;                        Outeiro;1116;547;569;1081;523;558;365;0;337;503;503;0;0;492
53052000;6;30411;                        Painzela;959;464;495;894;418;476;330;0;272;483;483;0;0;449
53088000;6;30412;                        Passos;221;93;128;211;86;125;78;0;65;127;127;0;2;128
53110000;6;30413;                        Pedraça;760;372;388;714;344;370;257;0;220;436;436;0;1;405
53147000;6;30414;                        Refojos de Basto;4680;2260;2420;4361;2064;2297;1557;1;1387;2379;2377;2;4;1851
53345000;6;30415;                        Rio Douro;942;456;486;918;445;473;334;0;276;662;662;0;1;654
53415000;6;30416;                        Vila Nune;379;188;191;362;178;184;119;0;111;224;224;0;0;222
53431000;6;30417;                        Vilar de Cunhas;194;93;101;184;88;96;71;0;60;199;199;0;1;195
53454000;5;305;                    Celorico de Basto;20098;9749;10349;19166;9135;10031;6779;6;5826;10619;10617;2;14;9972
53455000;6;30501;                        Agilde;1227;617;610;1184;589;595;413;0;357;611;610;1;0;595
53498000;6;30502;                        Arnóia;1702;838;864;1612;780;832;572;1;492;1010;1010;0;2;985
53580000;6;30503;                        Borba de Montanha;1294;595;699;1234;552;682;403;1;353;568;567;1;2;553
53638000;6;30504;                        Britelo;2561;1238;1323;2502;1197;1305;888;0;753;1283;1283;0;1;1071
53742000;6;30505;                        Caçarilhe;466;229;237;454;223;231;163;0;140;265;265;0;0;258
53763000;6;30506;                        Canedo de Basto;1010;492;518;933;443;490;344;0;301;509;509;0;1;506
53800000;6;30507;                        Carvalho;789;385;404;823;402;421;259;0;220;419;419;0;0;402
53835000;6;30508;                        Codeçoso;444;206;238;428;196;232;166;0;129;261;261;0;0;256
53870000;6;30509;                        Corgo;311;144;167;313;144;169;113;0;88;209;209;0;0;205
53885000;6;30510;                        Fervença;1445;701;744;1381;653;728;495;0;440;765;765;0;0;671
53938000;6;30511;                        Gagos;628;308;320;599;287;312;210;0;183;316;316;0;0;299
53969000;6;30512;                        Gémeos;650;324;326;625;305;320;221;0;192;319;319;0;2;273
54000000;6;30513;                        Infesta;292;148;144;253;118;135;111;0;78;186;186;0;0;184
54012000;6;30514;                        Molares;621;291;330;619;299;320;200;2;173;292;292;0;3;262
54036000;6;30515;                        Moreira do Castelo;627;322;305;572;283;289;197;0;181;269;269;0;0;267
54069000;6;30516;                        Ourilhe;459;220;239;429;202;227;154;0;137;269;269;0;0;264
54103000;6;30517;                        Rego;1241;614;627;1150;548;602;427;0;351;737;737;0;0;719
54158000;6;30518;                        Ribas;1068;494;574;1002;452;550;312;2;287;480;480;0;3;461
54200000;6;30519;                        Basto (Santa Tecla);212;98;114;201;90;111;74;0;59;167;167;0;0;167
54220000;6;30520;                        Basto (São Clemente);1524;761;763;1386;692;694;532;0;459;837;837;0;0;755
54275000;6;30521;                        Vale de Bouro;813;374;439;790;355;435;274;0;244;445;445;0;0;440
54309000;6;30522;                        Veade;714;350;364;676;325;351;251;0;209;402;402;0;0;379
54352000;5;1301;                    Amarante;56264;26968;29296;53458;25105;28353;19410;10;17194;28238;28230;8;29;22889
54353000;6;130101;                        Aboadela;783;353;430;727;317;410;262;1;229;475;475;0;1;461
54402000;6;130102;                        Aboim;596;284;312;575;272;303;205;0;181;311;311;0;0;302
54427000;6;130103;                        Ansiães;623;295;328;481;213;268;245;0;192;475;475;0;1;471
54466000;6;130104;                        Ataíde;1002;470;532;947;432;515;361;1;310;523;523;0;1;347
54492000;6;130105;                        Bustelo;521;246;275;468;213;255;186;0;165;416;416;0;0;411
54528000;6;130106;                        Canadelo;121;55;66;118;54;64;57;0;39;160;160;0;0;159
54534000;6;130107;                        Candemil;771;367;404;745;351;394;285;0;235;542;542;0;1;537
54571000;6;130108;                        Carneiro;311;152;159;286;132;154;114;0;95;211;211;0;0;209
54584000;6;130109;                        Carvalho de Rei;187;87;100;183;84;99;74;0;52;173;173;0;0;173
54597000;6;130110;                        Cepelos;1758;860;898;1704;821;883;598;0;547;871;871;0;6;708
54632000;6;130111;                        Chapa;301;143;158;291;133;158;103;0;90;178;178;0;0;178
54653000;6;130112;                        Fregim;2836;1345;1491;2679;1244;1435;891;2;827;1116;1114;2;1;970
54704000;6;130113;                        Freixo de Baixo;1434;695;739;1378;658;720;496;0;447;716;716;0;0;603
54746000;6;130114;                        Freixo de Cima;2203;1076;1127;2071;1004;1067;705;0;683;956;954;2;1;789
54797000;6;130115;                        Fridão;863;418;445;842;407;435;309;0;254;415;415;0;0;394
54820000;6;130116;                        Gatão;1586;795;791;1517;748;769;556;0;494;737;737;0;2;636
54870000;6;130117;                        Gondar;1686;830;856;1594;769;825;565;0;515;847;847;0;0;801
54920000;6;130118;                        Jazente;542;266;276;522;257;265;203;0;179;300;300;0;1;277
54946000;6;130119;                        Lomba;793;369;424;778;363;415;264;0;246;420;420;0;0;374
54981000;6;130120;                        Louredo;638;314;324;606;289;317;226;0;200;299;299;0;0;276
55006000;6;130121;                        Lufrei;1777;852;925;1664;786;878;609;0;542;904;904;0;0;788
55049000;6;130122;                        Madalena;1956;894;1062;1962;884;1078;707;2;590;1038;1038;0;5;522
55074000;6;130123;                        Mancelos;3114;1522;1592;2994;1437;1557;1022;0;950;1423;1423;0;0;1262
55152000;6;130124;                        Oliveira;862;420;442;835;401;434;302;0;266;382;382;0;0;285
55175000;6;130125;                        Olo;371;167;204;372;172;200;125;0;105;239;239;0;0;230
55193000;6;130126;                        Padronelo;884;435;449;847;409;438;313;0;278;458;458;0;0;376
55223000;6;130127;                        Real;3142;1528;1614;2948;1381;1567;1115;0;970;1427;1427;0;1;1202
55273000;6;130128;                        Rebordelo;365;174;191;327;150;177;118;0;104;187;187;0;0;182
55297000;6;130129;                        Salvador do Monte;1066;529;537;990;478;512;368;0;343;508;508;0;0;482
55346000;6;130130;                        Sanche;509;238;271;498;232;266;168;0;151;297;297;0;0;291
55376000;6;130131;                        Figueiró (Santa Cristina);1370;667;703;1324;633;691;472;0;428;592;592;0;0;521
55419000;6;130132;                        Figueiró (Santiago);2458;1173;1285;2387;1130;1257;834;0;758;1250;1250;0;0;1047
55493000;6;130133;                        Amarante (São Gonçalo);6540;3018;3522;6166;2801;3365;2410;4;1985;3372;3368;4;3;1331
55572000;6;130134;                        Gouveia (São Simão);633;315;318;609;297;312;235;0;200;423;423;0;0;411
55612000;6;130135;                        Telões;4232;2042;2190;4057;1926;2131;1467;0;1292;2109;2109;0;1;1685
55710000;6;130136;                        Travanca;2278;1108;1170;2193;1045;1148;746;0;696;1019;1019;0;0;896
55760000;6;130137;                        Várzea;383;189;194;383;192;191;140;0;117;256;256;0;0;247
55777000;6;130138;                        Vila Caiz;3026;1452;1574;2737;1218;1519;972;0;916;1269;1269;0;1;1142
55842000;6;130139;                        Vila Chã do Marão;940;441;499;887;412;475;309;0;276;536;536;0;3;528
55877000;6;130140;                        Vila Garcia;803;384;419;766;360;406;273;0;247;408;408;0;0;385
55905000;5;1302;                    Baião;20522;9811;10711;18996;8667;10329;7169;4;6278;11595;11595;0;20;10548
55906000;6;130201;                        Ancede;2527;1226;1301;2391;1129;1262;868;0;784;1280;1280;0;2;1134
56002000;6;130202;                        Campelo;3237;1507;1730;3027;1363;1664;1084;2;966;1594;1594;0;4;1205
56119000;6;130203;                        São Tomé de Covelas;576;287;289;526;247;279;186;0;172;377;377;0;1;373
56147000;6;130204;                        Frende;656;324;332;586;268;318;243;0;209;399;399;0;0;358
56186000;6;130205;                        Gestaçô;1263;600;663;1160;533;627;459;0;386;788;788;0;3;768
56253000;6;130206;                        Gove;1992;985;1007;1855;874;981;681;0;611;1027;1027;0;0;921
56323000;6;130207;                        Grilo;590;293;297;509;230;279;204;0;182;247;247;0;0;226
56356000;6;130208;                        Loivos do Monte;373;173;200;346;150;196;124;0;111;212;212;0;0;209
56381000;6;130209;                        Loivos da Ribeira;480;230;250;468;223;245;162;0;147;231;231;0;0;204
56398000;6;130210;                        Mesquinhata;301;142;159;282;129;153;103;0;89;194;194;0;1;192
56421000;6;130211;                        Ovil;701;329;372;664;301;363;270;0;221;637;637;0;0;633
56473000;6;130212;                        Ribadouro;309;141;168;276;119;157;132;0;94;243;243;0;1;239
56502000;6;130213;                        Santa Cruz do Douro;1453;680;773;1366;610;756;501;1;438;865;865;0;4;841
56572000;6;130214;                        Baião (Santa Leocádia);554;272;282;493;225;268;197;0;168;347;347;0;0;334
56611000;6;130215;                        Santa Marinha do Zêzere;2796;1313;1483;2582;1153;1429;983;1;860;1433;1433;0;4;1232
56720000;6;130216;                        Teixeira;595;276;319;555;249;306;237;0;191;515;515;0;0;511
56770000;6;130217;                        Teixeiró;351;179;172;325;160;165;112;0;103;188;188;0;0;188
56801000;6;130218;                        Tresouras;373;182;191;342;156;186;133;0;111;218;218;0;0;213
56831000;6;130219;                        Valadares;875;428;447;781;356;425;300;0;272;491;491;0;0;465
56876000;6;130220;                        Viariz;520;244;276;462;192;270;190;0;163;309;309;0;0;302
56899000;5;1303;                    Felgueiras;58065;28103;29962;56398;27031;29367;19002;13;17653;24282;24278;4;27;17929
56900000;6;130301;                        Aião;856;415;441;847;407;440;262;0;258;355;355;0;0;325
56926000;6;130302;                        Airães;2486;1170;1316;2381;1107;1274;802;1;767;1040;1040;0;3;890
56991000;6;130303;                        Borba de Godim;2341;1097;1244;2215;1023;1192;817;0;717;1198;1197;1;0;806
57040000;6;130304;                        Caramos;1854;893;961;1754;832;922;599;0;573;812;812;0;0;643
57081000;6;130305;                        Friande;1838;912;926;1749;852;897;564;0;548;726;726;0;0;596
57123000;6;130306;                        Idães;2496;1198;1298;2543;1209;1334;790;1;750;995;995;0;1;788
57169000;6;130307;                        Jugueiros;1303;649;654;1256;627;629;418;0;383;559;558;1;0;480
57207000;6;130308;                        Lagares;2320;1133;1187;2269;1105;1164;799;1;711;937;937;0;1;750
57254000;6;130309;                        Lordelo;357;171;186;353;165;188;102;1;104;145;145;0;1;139
57266000;6;130310;                        Macieira da Lixa;1961;955;1006;1876;896;980;636;0;601;828;828;0;0;730
57327000;6;130311;                        Moure;1321;673;648;1277;642;635;423;0;407;529;528;1;0;431
57379000;6;130312;                        Pedreira;1564;762;802;1525;732;793;492;2;471;625;625;0;3;547
57417000;6;130313;                        Penacova;1130;564;566;1103;550;553;360;0;342;425;425;0;0;361
57441000;6;130314;                        Pinheiro;1042;522;520;1064;531;533;331;0;321;468;468;0;0;419
57474000;6;130315;                        Pombeiro de Ribavizela;2218;1079;1139;2127;1023;1104;683;0;673;815;815;0;2;644
57524000;6;130316;                        Rande;982;446;536;938;421;517;321;0;304;395;395;0;0;307
57547000;6;130317;                        Refontoura;2081;1038;1043;1972;967;1005;622;0;644;745;745;0;0;652
57600000;6;130318;                        Regilde;1284;612;672;1269;602;667;440;0;393;474;474;0;0;361
57630000;6;130319;                        Revinhade;811;405;406;773;381;392;254;0;240;307;307;0;0;238
57651000;6;130320;                        Margaride (Santa Eulália);9653;4633;5020;9574;4568;5006;3311;5;2912;4296;4296;0;11;1998
57805000;6;130321;                        Santão;776;379;397;731;345;386;255;0;235;370;370;0;0;340
57824000;6;130323;                        Vizela (São Jorge);574;284;290;568;279;289;187;0;177;244;244;0;1;218
57846000;6;130324;                        Sendim;1627;781;846;1574;751;823;509;0;500;636;636;0;0;546
57891000;6;130325;                        Sernande;941;461;480;919;448;471;308;0;286;382;382;0;0;307
57912000;6;130326;                        Sousa;1095;532;563;1070;523;547;387;0;324;448;448;0;0;334
57938000;6;130327;                        Torrados;2370;1185;1185;2277;1133;1144;738;0;721;881;881;0;0;638
57989000;6;130328;                        Unhão;800;395;405;738;364;374;254;1;246;340;340;0;1;301
58011000;6;130329;                        Várzea;2859;1380;1479;2769;1325;1444;939;0;878;1112;1112;0;0;798
58071000;6;130330;                        Varziela;1837;879;958;1772;844;928;588;0;537;722;722;0;1;654
58128000;6;130331;                        Vila Cova da Lixa;3850;1810;2040;3717;1736;1981;1341;1;1194;1869;1869;0;1;1170
58220000;6;130332;                        Vila Fria;629;310;319;637;298;339;201;0;189;232;232;0;1;207
58238000;6;130333;                        Vila Verde;809;380;429;761;345;416;269;0;247;372;371;1;0;311
58268000;5;1305;                    Lousada;47387;23077;24310;45482;21756;23726;15257;4;14319;18656;18646;10;11;14384
58269000;6;130501;                        Alvarenga;463;218;245;441;205;236;150;0;138;190;189;1;0;160
58290000;6;130502;                        Aveleda;2073;1004;1069;1984;936;1048;636;1;613;780;780;0;1;618
58334000;6;130503;                        Boim;3102;1546;1556;2960;1451;1509;964;0;917;1134;1133;1;1;843
58369000;6;130504;                        Caíde de Rei;2529;1232;1297;2391;1131;1260;853;0;764;1053;1050;3;0;914
58421000;6;130505;                        Casais;1401;691;710;1373;670;703;422;1;426;502;502;0;1;457
58454000;6;130506;                        Cernadelo;980;474;506;916;430;486;321;0;295;394;394;0;0;328
58477000;6;130507;                        Covas;726;353;373;710;345;365;225;0;214;269;269;0;1;225
58494000;6;130508;                        Cristelos;3040;1484;1556;2913;1395;1518;1031;0;948;1285;1285;0;0;659
58523000;6;130509;                        Figueiras;1382;677;705;1335;640;695;406;0;410;514;514;0;0;438
58558000;6;130510;                        Lodares;2002;959;1043;1899;885;1014;632;1;610;750;750;0;1;607
58600000;6;130511;                        Lustosa;4792;2358;2434;4689;2288;2401;1573;0;1428;1924;1921;3;0;1465
58711000;6;130512;                        Macieira;1344;634;710;1276;585;691;441;0;410;543;543;0;0;491
58752000;6;130513;                        Meinedo;4052;1936;2116;3866;1804;2062;1314;0;1249;1614;1614;0;0;1386
58833000;6;130514;                        Nespereira;2085;1033;1052;2014;980;1034;677;0;649;813;813;0;0;622
58872000;6;130515;                        Nevogilde;2617;1310;1307;2518;1236;1282;774;0;794;869;868;1;0;708
58929000;6;130516;                        Nogueira;1253;603;650;1211;581;630;422;0;388;509;509;0;0;416
58960000;6;130517;                        Ordem;1201;580;621;1172;562;610;379;0;361;458;458;0;0;389
58988000;6;130518;                        Pias;1288;625;663;1227;579;648;424;0;403;521;520;1;0;424
59014000;6;130520;                        Lousada (Santa Margarida);307;144;163;299;138;161;106;0;91;149;149;0;0;135
59026000;6;130521;                        Barrosas (Santo Estêvão);983;504;479;969;492;477;311;0;288;380;380;0;1;273
59055000;6;130522;                        Lousada (São Miguel);879;420;459;760;358;402;292;0;271;337;337;0;0;288
59082000;6;130523;                        Silvares;3207;1534;1673;3090;1461;1629;1064;1;945;1351;1351;0;2;700
59135000;6;130524;                        Sousela;1797;869;928;1736;832;904;572;0;537;670;670;0;1;596
59175000;6;130525;                        Torno;2542;1246;1296;2449;1177;1272;820;0;754;1066;1066;0;2;731
59210000;6;130526;                        Vilar do Torno e Alentém;1342;643;699;1284;595;689;448;0;416;581;581;0;0;511
59257000;5;1307;                    Marco de Canaveses;53450;26039;27411;49491;23024;26467;17717;7;16007;24103;24094;9;23;18915
59258000;6;130701;                        Alpendurada e Matos;5580;2789;2791;5172;2475;2697;1779;1;1678;2286;2286;0;3;1680
59334000;6;130702;                        Ariz;1843;889;954;1678;759;919;615;0;548;840;839;1;0;667
59377000;6;130703;                        Avessadas;1247;593;654;1186;552;634;430;1;375;611;611;0;2;538
59413000;6;130704;                        Banho e Carvalhosa;1276;619;657;1133;494;639;439;0;404;650;650;0;1;567
59440000;6;130705;                        Constance;1626;802;824;1469;690;779;521;0;492;668;667;1;0;538
59470000;6;130706;                        Favões;1234;587;647;1106;500;606;411;0;357;569;569;0;0;437
59492000;6;130707;                        Folhada;602;280;322;574;261;313;208;0;175;373;373;0;0;353
59517000;6;130708;                        Fornos;3614;1753;1861;3394;1568;1826;1219;2;1078;1608;1606;2;2;777
59553000;6;130709;                        Freixo;845;418;427;786;384;402;277;0;255;359;359;0;0;319
59588000;6;130710;                        Magrelos;800;399;401;722;328;394;268;1;238;431;431;0;1;359
59610000;6;130711;                        Manhuncelos;486;238;248;469;222;247;152;0;137;211;210;1;0;193
59631000;6;130712;                        Maureles;460;232;228;441;218;223;147;0;131;214;214;0;0;184
59646000;6;130713;                        Paços de Gaiolo;995;488;507;910;422;488;349;0;299;584;584;0;0;561
59677000;6;130714;                        Paredes de Viadores;1289;654;635;1226;599;627;402;1;376;588;588;0;1;555
59707000;6;130715;                        Penha Longa;1929;974;955;1705;787;918;641;0;583;932;932;0;1;788
59746000;6;130716;                        Rio de Galinhas;2014;942;1072;1888;846;1042;687;0;612;922;922;0;1;645
59776000;6;130717;                        Rosem;220;111;109;210;105;105;70;0;63;126;126;0;1;122
59785000;6;130718;                        Sande;1882;896;986;1689;745;944;631;0;554;962;961;1;2;854
59821000;6;130719;                        Santo Isidoro;1495;722;773;1400;646;754;524;0;472;638;638;0;1;546
59860000;6;130720;                        São Lourenço do Douro;987;486;501;907;420;487;319;0;303;451;451;0;1;382
59883000;6;130721;                        São Nicolau;447;212;235;403;186;217;165;0;138;233;233;0;0;133
59895000;6;130722;                        Soalhães;3682;1789;1893;3476;1640;1836;1199;0;1090;1623;1623;0;0;1489
59968000;6;130723;                        Sobretâmega;1132;556;576;1064;502;562;385;0;347;504;504;0;2;425
59989000;6;130724;                        Tabuado;1375;674;701;1325;636;689;450;0;414;572;572;0;1;500
60015000;6;130725;                        Torrão;807;387;420;774;360;414;292;0;255;346;346;0;0;263
60030000;6;130726;                        Toutosa;588;270;318;544;237;307;213;0;182;266;266;0;0;214
60044000;6;130727;                        Tuias;4094;1971;2123;3791;1761;2030;1412;0;1239;1876;1874;2;2;801
60086000;6;130728;                        Várzea do Douro;2098;1055;1043;1930;923;1007;660;0;612;833;833;0;0;723
60130000;6;130729;                        Várzea da Ovelha e Aliviada;2169;1081;1088;2009;964;1045;736;0;638;1038;1038;0;0;966
60206000;6;130730;                        Vila Boa do Bispo;3240;1540;1700;2986;1349;1637;1044;1;946;1509;1509;0;1;1228
60264000;6;130731;                        Vila Boa de Quires;3394;1632;1762;3124;1445;1679;1072;0;1016;1280;1279;1;0;1108
60333000;5;1309;                    Paços de Ferreira;56340;28081;28259;54798;27113;27685;17908;13;16805;21223;21204;19;16;14912
60334000;6;130901;                        Arreigada;1999;1002;997;1921;939;982;638;0;587;725;724;1;1;505
60381000;6;130902;                        Carvalhosa;4583;2266;2317;4442;2193;2249;1471;1;1384;1744;1744;0;1;1393
60454000;6;130903;                        Codessos;1011;505;506;982;485;497;318;0;308;374;374;0;1;336
60489000;6;130904;                        Eiriz;2303;1170;1133;2255;1141;1114;702;0;681;779;779;0;0;653
60542000;6;130905;                        Ferreira;4341;2155;2186;4172;2051;2121;1321;0;1291;1529;1527;2;0;1294
60659000;6;130906;                        Figueiró;2496;1237;1259;2433;1193;1240;781;0;750;922;922;0;0;752
60726000;6;130907;                        Frazão;4264;2095;2169;4173;2038;2135;1391;0;1324;1598;1597;1;0;1254
60811000;6;130908;                        Freamunde;7789;3821;3968;7533;3665;3868;2470;1;2352;2904;2897;7;4;1700
60904000;6;130909;                        Lamoso;1613;804;809;1591;790;801;540;0;489;627;626;1;0;546
60949000;6;130910;                        Meixomil;3676;1808;1868;3605;1764;1841;1184;0;1128;1425;1425;0;0;1056
61037000;6;130911;                        Modelos;1594;758;836;1558;731;827;532;0;478;516;516;0;0;421
61086000;6;130912;                        Paços de Ferreira;7491;3615;3876;7283;3491;3792;2570;2;2272;3407;3402;5;4;1385
61199000;6;130913;                        Penamaior;3819;1870;1949;3747;1826;1921;1222;0;1144;1413;1413;0;1;1104
61288000;6;130914;                        Raimonda;2576;1253;1323;2514;1213;1301;825;0;791;977;975;2;1;806
61349000;6;130915;                        Sanfins de Ferreira;3139;1513;1626;3057;1456;1601;1014;0;960;1139;1139;0;1;841
61417000;6;130916;                        Seroa;3646;2209;1437;3532;2137;1395;929;9;866;1144;1144;0;2;866
61495000;5;1310;                    Paredes;86854;42530;44324;84701;40856;43845;28114;12;26203;34274;34260;14;17;23565
61496000;6;131001;                        Aguiar de Sousa;1631;799;832;1609;783;826;511;1;503;649;649;0;1;610
61566000;6;131002;                        Astromil;1086;539;547;1041;512;529;345;0;343;400;400;0;0;303
61587000;6;131003;                        Baltar;4818;2352;2466;4679;2234;2445;1654;1;1490;2043;2040;3;1;1305
61659000;6;131004;                        Beire;2040;995;1045;2339;1134;1205;626;0;626;739;739;0;0;674
61712000;6;131005;                        Besteiros;1448;707;741;1417;686;731;469;0;434;531;531;0;0;443
61750000;6;131006;                        Bitarães;2868;1395;1473;2760;1328;1432;915;0;865;1062;1062;0;0;848
61818000;6;131007;                        Castelões de Cepeda;8755;4139;4616;8416;3950;4466;3131;2;2694;3988;3988;0;4;1499
61930000;6;131008;                        Cete;3113;1498;1615;2986;1406;1580;1058;0;980;1315;1315;0;1;814
61986000;6;131009;                        Cristelo;1891;958;933;1809;895;914;591;0;557;709;709;0;0;489
62035000;6;131010;                        Duas Igrejas;3879;1943;1936;3705;1805;1900;1166;1;1117;1365;1365;0;1;1028
62125000;6;131011;                        Gandra;6974;3448;3526;7013;3379;3634;2291;0;2116;3137;3135;2;1;2042
62267000;6;131012;                        Gondalães;1228;600;628;1206;586;620;387;0;368;481;481;0;0;357
62294000;6;131013;                        Lordelo;10025;4993;5032;9740;4802;4938;3141;3;3014;3734;3731;3;3;2713
62447000;6;131014;                        Louredo;1514;747;767;1506;740;766;489;0;450;602;602;0;0;476
62494000;6;131015;                        Madalena;1843;897;946;1774;846;928;634;0;565;774;774;0;0;383
62519000;6;131016;                        Mouriz;3026;1452;1574;2943;1389;1554;1004;0;927;1320;1320;0;0;861
62577000;6;131017;                        Parada de Todeia;1848;909;939;1770;862;908;605;0;575;768;768;0;0;542
62622000;6;131018;                        Rebordosa;9106;4458;4648;8901;4310;4591;2891;3;2663;3479;3478;1;3;2406
62741000;6;131019;                        Recarei;4631;2309;2322;4474;2202;2272;1505;0;1397;1711;1711;0;0;1447
62825000;6;131020;                        Sobreira;4300;2106;2194;4220;2032;2188;1402;0;1316;1628;1624;4;0;1298
62927000;6;131021;                        Sobrosa;2641;1243;1398;2581;1202;1379;811;1;800;958;958;0;1;796
62997000;6;131022;                        Vandoma;2363;1185;1178;2252;1106;1146;753;0;712;892;892;0;1;706
63065000;6;131023;                        Vila Cova de Carros;666;334;332;651;323;328;205;0;190;247;247;0;0;222
63088000;6;131024;                        Vilela;5160;2524;2636;4909;2344;2565;1530;0;1501;1742;1741;1;0;1303
63156000;5;1311;                    Penafiel;72265;35191;37074;70059;33371;36688;23794;10;21849;30048;30032;16;30;23346
63157000;6;131101;                        Abragão;2341;1178;1163;2246;1099;1147;753;0;716;962;962;0;0;883
63191000;6;131102;                        Boelhe;1646;796;850;1609;760;849;538;0;498;668;668;0;1;551
63238000;6;131103;                        Bustelo;1579;734;845;1528;706;822;522;0;484;675;675;0;0;643
63295000;6;131104;                        Cabeça Santa;2528;1244;1284;2394;1134;1260;787;0;752;924;920;4;0;771
63350000;6;131105;                        Canelas;1649;825;824;1573;760;813;531;2;494;693;693;0;2;630
63399000;6;131106;                        Capela;1047;510;537;1032;498;534;363;0;310;449;449;0;0;415
63433000;6;131107;                        Castelões;1397;657;740;1350;620;730;485;0;443;634;634;0;0;560
63470000;6;131108;                        Croca;1767;887;880;1912;942;970;561;0;542;685;685;0;2;599
63509000;6;131109;                        Duas Igrejas;2426;1188;1238;2311;1084;1227;799;0;729;949;949;0;0;759
63573000;6;131110;                        Eja;1110;531;579;1045;477;568;394;0;342;538;538;0;1;451
63602000;6;131111;                        Figueira;406;190;216;390;184;206;128;1;114;169;169;0;1;156
63616000;6;131112;                        Fonte Arcada;1606;784;822;1551;745;806;511;0;457;633;633;0;1;544
63672000;6;131113;                        Galegos;2673;1334;1339;2606;1285;1321;868;0;798;1053;1053;0;0;846
63734000;6;131114;                        Guilhufe;2844;1407;1437;3178;1559;1619;875;0;864;1088;1088;0;1;894
63794000;6;131115;                        Irivo;2182;1077;1105;2130;1028;1102;724;1;665;837;835;2;1;673
63851000;6;131116;                        Lagares;2457;1214;1243;2382;1159;1223;774;0;724;885;884;1;0;817
63899000;6;131117;                        Luzim;817;394;423;757;350;407;259;0;230;419;419;0;0;387
63938000;6;131118;                        Marecos;1068;542;526;1046;523;523;355;0;323;436;436;0;0;355
63969000;6;131119;                        Milhundos;1793;854;939;1714;794;920;571;2;542;726;725;1;2;479
64013000;6;131120;                        Novelas;1794;857;937;1729;812;917;599;0;554;828;827;1;0;507
64053000;6;131121;                        Oldrões;2004;957;1047;1959;920;1039;633;0;600;748;748;0;0;599
64105000;6;131122;                        Paço de Sousa;3869;1906;1963;3725;1810;1915;1275;1;1164;1656;1656;0;1;1288
64178000;6;131123;                        Paredes;1258;597;661;1204;560;644;415;0;386;522;522;0;2;378
64213000;6;131124;                        Penafiel;8761;4064;4697;8292;3793;4499;3204;2;2666;4075;4072;3;6;1793
64331000;6;131125;                        Perozelo;1346;629;717;1291;580;711;430;0;398;530;530;0;0;450
64375000;6;131126;                        Pinheiro;2431;1193;1238;2388;1131;1257;797;1;755;998;998;0;5;770
64444000;6;131127;                        Portela;1266;623;643;1200;559;641;406;0;374;560;560;0;0;499
64492000;6;131128;                        Rans;1907;944;963;1816;867;949;597;0;572;724;724;0;0;552
64542000;6;131129;                        Rio de Moinhos;2886;1434;1452;2714;1311;1403;889;0;858;1152;1152;0;0;981
64591000;6;131130;                        Santa Marta;1289;652;637;1243;614;629;436;0;399;546;545;1;0;381
64611000;6;131131;                        Santiago de Subarrifana;1006;481;525;961;450;511;338;0;312;418;418;0;0;328
64626000;6;131132;                        Recezinhos (São Mamede);1439;718;721;1361;665;696;456;0;428;684;684;0;0;587
64672000;6;131133;                        Recezinhos (São Martinho);1791;880;911;1706;809;897;599;0;534;747;747;0;3;674
64725000;6;131134;                        Sebolido;912;458;454;881;429;452;291;0;292;375;375;0;0;342
64748000;6;131135;                        Urrô;1161;566;595;1130;545;585;382;0;360;450;450;0;0;404
64776000;6;131136;                        Valpedre;1576;790;786;1553;769;784;480;0;456;562;559;3;1;475
64818000;6;131137;                        Vila Cova;819;397;422;780;371;409;283;0;264;389;389;0;0;341
64850000;6;131138;                        Rio Mau;1414;699;715;1372;669;703;486;0;450;661;661;0;0;584
64866000;5;1705;                    Mondim de Basto;7493;3598;3895;7113;3376;3737;2592;2;2179;4511;4510;1;9;4066
64867000;6;170501;                        Atei;1352;672;680;1308;652;656;454;0;382;708;708;0;1;705
64938000;6;170502;                        Bilhó;546;253;293;518;242;276;210;0;165;374;374;0;0;374
64983000;6;170503;                        Campanhó;268;126;142;247;111;136;109;0;86;227;227;0;0;225
64999000;6;170504;                        Ermelo;483;232;251;480;234;246;207;0;143;496;495;1;0;492
65034000;6;170505;                        Mondim de Basto;3273;1552;1721;3104;1454;1650;1094;2;939;1725;1725;0;8;1289
65148000;6;170506;                        Paradança;358;163;195;345;159;186;121;0;104;231;231;0;0;231
65175000;6;170507;                        Pardelhas;77;36;41;76;35;41;31;0;21;67;67;0;0;67
65183000;6;170508;                        Vilar de Ferreiros;1136;564;572;1035;489;546;366;0;339;683;683;0;0;683
65241000;5;1709;                    Ribeira de Pena;6544;3196;3348;6370;3084;3286;2465;3;1956;4910;4910;0;12;4611
65242000;6;170901;                        Alvadia;196;97;99;190;96;94;75;0;62;153;153;0;0;153
65270000;6;170902;                        Canedo;390;194;196;348;167;181;164;0;114;394;394;0;0;394
65318000;6;170903;                        Cerva;2280;1116;1164;2247;1095;1152;819;1;639;1478;1478;0;5;1427
65434000;6;170904;                        Limões;335;164;171;343;171;172;125;0;97;251;251;0;0;251
65465000;6;170905;                        Ribeira de Pena (Salvador);2417;1181;1236;2343;1123;1220;897;2;732;1747;1747;0;5;1507
65602000;6;170906;                        Santa Marinha;558;269;289;543;263;280;223;0;194;477;477;0;0;472
65658000;6;170907;                        Santo Aleixo de Além-Tâmega;368;175;193;356;169;187;162;0;118;410;410;0;2;407
65696000;5;1804;                    Cinfães;20427;9932;10495;18962;8830;10132;7254;3;6332;11604;11602;2;12;10854
65697000;6;180401;                        Alhões;196;104;92;210;110;100;81;0;61;277;277;0;0;277
65721000;6;180402;                        Bustelo;115;56;59;110;54;56;53;0;35;108;108;0;0;108
65734000;6;180403;                        Cinfães;3395;1578;1817;3160;1415;1745;1244;1;1042;1951;1950;1;4;1579
65845000;6;180404;                        Espadanedo;1318;642;676;1235;578;657;445;0;411;536;536;0;0;507
65879000;6;180405;                        Ferreiros de Tendais;695;343;352;646;317;329;266;0;206;682;682;0;4;674
65929000;6;180406;                        Fornelos;703;328;375;662;300;362;266;0;227;469;469;0;0;465
65971000;6;180407;                        Gralheira;165;82;83;157;79;78;71;0;52;218;218;0;0;217
65985000;6;180408;                        Moimenta;408;196;212;372;171;201;153;0;130;227;227;0;0;227
66015000;6;180409;                        Nespereira;1977;959;1018;1846;867;979;731;0;623;1302;1302;0;1;1254
66121000;6;180410;                        Oliveira do Douro;1529;753;776;1452;685;767;532;0;468;852;852;0;1;838
66191000;6;180411;                        Ramires;119;56;63;113;53;60;49;0;36;93;93;0;0;93
66210000;6;180412;                        Santiago de Piães;1797;877;920;1651;766;885;616;0;561;847;847;0;0;818
66279000;6;180413;                        São Cristóvão de Nogueira;1930;936;994;1776;814;962;650;1;579;910;909;1;1;853
66369000;6;180414;                        Souselo;3202;1577;1625;2913;1353;1560;1099;0;1005;1471;1471;0;0;1323
66460000;6;180415;                        Tarouquela;1242;634;608;1099;519;580;413;0;391;514;514;0;0;489
66501000;6;180416;                        Tendais;807;398;409;779;382;397;302;1;242;758;758;0;1;747
66568000;6;180417;                        Travanca;829;413;416;781;367;414;283;0;263;389;389;0;0;385
66599000;5;1813;                    Resende;11364;5523;5841;11122;5334;5788;4070;8;3396;7414;7412;2;20;6886
66600000;6;181301;                        Anreade;1114;529;585;1073;507;566;384;0;327;709;709;0;3;647
66637000;6;181302;                        Barrô;744;365;379;741;361;380;290;0;229;562;562;0;0;560
66685000;6;181303;                        Cárquere;854;418;436;819;394;425;292;0;260;483;483;0;0;462
66717000;6;181304;                        Feirão;117;54;63;108;51;57;37;0;31;127;127;0;0;124
66732000;6;181305;                        Felgueiras;319;152;167;304;145;159;107;1;86;217;217;0;1;216
66751000;6;181306;                        Freigil;431;218;213;422;212;210;159;0;139;296;296;0;0;289
66770000;6;181307;                        Miomães;359;174;185;341;153;188;133;0;111;266;266;0;2;255
66785000;6;181308;                        Ovadas;277;129;148;263;122;141;117;0;82;265;265;0;0;264
66812000;6;181309;                        Panchorra;132;65;67;131;66;65;56;0;45;185;185;0;0;184
66833000;6;181310;                        Paus;528;257;271;499;244;255;209;0;157;475;474;1;0;468
66865000;6;181311;                        Resende;3166;1539;1627;3126;1479;1647;1049;6;918;1686;1685;1;13;1311
66946000;6;181312;                        São Cipriano;771;381;390;766;376;390;281;0;227;418;418;0;0;418
66979000;6;181313;                        São João de Fontoura;700;337;363;685;327;358;254;0;213;430;430;0;0;429
67016000;6;181314;                        São Martinho de Mouros;1495;725;770;1477;715;762;571;0;468;1023;1023;0;0;988
67085000;6;181315;                        São Romão de Aregos;357;180;177;367;182;185;131;1;103;272;272;0;1;271
67108000;4;116;                Entre Douro e Vouga;274859;132784;142075;265316;127151;138165;97430;48;86704;123554;123495;59;100;89030
67109000;5;104;                    Arouca;22359;10799;11560;21375;10204;11171;7464;6;6766;10715;10695;20;21;9967
67110000;6;10401;                        Albergaria da Serra;105;49;56;101;47;54;42;0;28;68;68;0;0;68
67122000;6;10402;                        Alvarenga;1223;621;602;1180;587;593;455;0;374;844;840;4;4;837
67192000;6;10403;                        Arouca;3185;1445;1740;3050;1383;1667;1049;6;930;1458;1455;3;8;1058
67265000;6;10404;                        Burgo;1993;981;1012;1889;905;984;638;0;626;918;918;0;1;857
67318000;6;10405;                        Cabreiros;126;57;69;119;52;67;54;0;40;105;105;0;0;105
67327000;6;10406;                        Canelas;801;407;394;746;367;379;251;0;238;332;332;0;1;328
67341000;6;10407;                        Chave;1253;604;649;1192;573;619;435;0;382;639;639;0;0;628
67387000;6;10408;                        Covelo de Paivó;103;45;58;104;46;58;42;0;30;65;65;0;0;59
67396000;6;10409;                        Escariz;2222;1082;1140;2103;1008;1095;715;0;680;954;952;2;0;879
67459000;6;10410;                        Espiunca;382;194;188;345;174;171;130;0;115;223;222;1;0;222
67481000;6;10411;                        Fermedo;1340;640;700;1289;614;675;456;0;410;667;666;1;0;633
67534000;6;10412;                        Janarde;119;59;60;119;60;59;40;0;38;99;99;0;0;99
67542000;6;10413;                        Mansores;1081;529;552;1058;516;542;350;0;322;446;446;0;1;415
67586000;6;10414;                        Moldes;1257;602;655;1199;567;632;389;0;377;600;599;1;0;589
67625000;6;10415;                        Rossas;1599;788;811;1532;749;783;525;0;485;751;751;0;0;743
67675000;6;10416;                        Santa Eulália;2253;1088;1165;2176;1040;1136;747;0;691;969;962;7;1;911
67737000;6;10417;                        São Miguel do Mato;598;281;317;593;279;314;204;0;169;303;303;0;2;295
67762000;6;10418;                        Tropeço;1150;554;596;1076;517;559;405;0;348;537;537;0;0;523
67809000;6;10419;                        Urrô;1029;512;517;969;475;494;354;0;318;506;506;0;3;498
67848000;6;10420;                        Várzea;540;261;279;535;245;290;183;0;165;231;230;1;0;220
67876000;5;109;                    Santa Maria da Feira;139312;67402;71910;134822;64769;70053;48963;20;43879;60520;60499;21;34;43611
67877000;6;10901;                        Argoncilhe;8420;4093;4327;8213;3950;4263;2972;0;2635;3465;3463;2;0;2743
68001000;6;10902;                        Arrifana;6551;3184;3367;6324;3065;3259;2369;0;2140;2861;2861;0;0;1773
68075000;6;10903;                        Canedo;6044;2921;3123;5865;2806;3059;2037;0;1871;2919;2917;2;0;2365
68169000;6;10904;                        Escapães;3309;1571;1738;3205;1509;1696;1152;1;1048;1406;1405;1;1;1026
68258000;6;10905;                        Espargo;1559;752;807;1521;729;792;516;0;497;660;660;0;1;592
68304000;6;10906;                        Feira;12511;5947;6564;12032;5680;6352;4622;4;3919;5789;5789;0;9;2615
68451000;6;10907;                        Fiães;7991;3860;4131;7649;3670;3979;2821;3;2514;3266;3264;2;4;2415
68555000;6;10908;                        Fornos;3397;1656;1741;3291;1601;1690;1206;0;1106;1461;1461;0;0;1112
68616000;6;10909;                        Gião;1815;861;954;1745;823;922;606;0;565;849;849;0;0;685
68676000;6;10910;                        Guisande;1237;615;622;1218;607;611;434;0;379;579;578;1;1;535
68727000;6;10911;                        Lobão;5483;2689;2794;5336;2602;2734;1947;2;1705;2653;2652;1;3;2143
68793000;6;10912;                        Louredo;1325;626;699;1274;591;683;452;0;393;723;723;0;0;634
68845000;6;10913;                        Lourosa;8636;4167;4469;8358;3986;4372;3101;0;2756;3752;3752;0;2;2495
68969000;6;10914;                        Milheirós de Poiares;3791;1870;1921;3670;1800;1870;1276;1;1165;1536;1532;4;1;1084
69051000;6;10915;                        Mosteiró;2038;987;1051;1983;955;1028;711;1;644;854;854;0;1;744
69100000;6;10916;                        Mozelos;7142;3476;3666;6980;3376;3604;2523;1;2272;2981;2981;0;1;1746
69185000;6;10917;                        Nogueira da Regedoura;5790;2798;2992;5623;2702;2921;2029;0;1854;2339;2338;1;0;1817
69263000;6;10918;                        São Paio de Oleiros;4069;1940;2129;3966;1872;2094;1453;2;1283;1643;1643;0;2;1125
69324000;6;10919;                        Paços de Brandão;4867;2365;2502;4729;2286;2443;1802;0;1536;2068;2068;0;0;1269
69390000;6;10920;                        Pigeiros;1181;560;621;1130;533;597;406;0;362;504;504;0;0;441
69435000;6;10921;                        Rio Meão;4931;2378;2553;4801;2309;2492;1725;0;1535;2082;2080;2;2;1523
69496000;6;10922;                        Romariz;3023;1484;1539;2939;1436;1503;1035;0;931;1409;1409;0;0;1271
69579000;6;10923;                        Sanfins;1882;926;956;1814;892;922;657;0;599;825;825;0;0;656
69618000;6;10924;                        Sanguedo;3600;1735;1865;3437;1636;1801;1144;2;1088;1436;1436;0;2;1277
69706000;6;10925;                        Santa Maria de Lamas;5073;2440;2633;4944;2358;2586;1795;1;1591;2061;2059;2;1;1168
69772000;6;10926;                        São João de Ver;10579;5190;5389;10167;4947;5220;3687;1;3397;4609;4608;1;2;3145
69903000;6;10927;                        Caldas de São Jorge;2716;1330;1386;2607;1260;1347;937;0;867;1192;1192;0;0;994
69941000;6;10928;                        Souto;4696;2282;2414;4519;2182;2337;1581;1;1498;1955;1953;2;1;1802
70018000;6;10929;                        Travanca;2242;1083;1159;2161;1037;1124;761;0;687;932;932;0;0;824
70075000;6;10930;                        Vale;1903;879;1024;1865;862;1003;687;0;576;1029;1029;0;0;966
70146000;6;10931;                        Vila Maior;1511;737;774;1456;707;749;519;0;466;682;682;0;0;626
70214000;5;113;                    Oliveira de Azeméis;68611;33282;35329;66127;31830;34297;24222;13;21891;30016;30001;15;17;22502
70215000;6;11301;                        Carregosa;3419;1664;1755;3339;1608;1731;1267;0;1108;1639;1638;1;1;1367
70295000;6;11302;                        Cesar;3166;1565;1601;3073;1499;1574;1138;1;984;1419;1419;0;1;1003
70356000;6;11303;                        Fajões;3087;1493;1594;3014;1447;1567;1069;1;958;1306;1304;2;1;1130
70427000;6;11304;                        Loureiro;3531;1716;1815;3423;1654;1769;1183;0;1104;1444;1444;0;0;1283
70520000;6;11305;                        Macieira de Sarnes;1925;924;1001;1817;869;948;691;0;625;863;862;1;0;660
70567000;6;11306;                        Macinhata da Seixa;1390;697;693;1324;660;664;462;0;440;606;606;0;0;502
70607000;6;11307;                        Madail;809;406;403;785;394;391;273;0;253;336;336;0;0;249
70636000;6;11308;                        Nogueira do Cravo;2795;1357;1438;2720;1314;1406;990;0;901;1174;1174;0;0;987
70700000;6;11309;                        Oliveira de Azeméis;12204;5778;6426;11653;5447;6206;4466;4;3834;5655;5653;2;7;2469
70872000;6;11310;                        Ossela;2208;1088;1120;2114;1035;1079;789;0;695;983;983;0;0;905
70936000;6;11311;                        Palmaz;2079;1016;1063;2005;979;1026;740;0;671;964;964;0;0;920
70997000;6;11312;                        Pindelo;2595;1264;1331;2506;1217;1289;918;0;825;1133;1133;0;0;912
71052000;6;11313;                        Pinheiro da Bemposta;3324;1616;1708;3217;1557;1660;1153;1;1053;1480;1479;1;1;1344
71118000;6;11314;                        Santiago de Riba-Ul;3944;1897;2047;3806;1811;1995;1389;0;1282;1672;1670;2;0;1243
71206000;6;11315;                        São Martinho da Gândara;1985;966;1019;1957;939;1018;649;0;633;810;810;0;0;745
71267000;6;11316;                        Travanca;1804;878;926;1751;849;902;613;0;578;672;671;1;0;620
71308000;6;11317;                        Ul;2413;1175;1238;2305;1111;1194;846;0;778;1066;1066;0;0;985
71376000;6;11318;                        São Roque;5228;2566;2662;5069;2485;2584;1838;1;1701;2192;2192;0;1;1586
71476000;6;11319;                        Vila de Cucujães;10705;5216;5489;10249;4955;5294;3748;5;3468;4602;4597;5;5;3592
71701000;5;116;                    São João da Madeira;21713;10222;11491;20834;9743;11091;8292;4;6875;10465;10462;3;16;3371
71702000;6;11601;                        São João da Madeira;21713;10222;11491;20834;9743;11091;8292;4;6875;10465;10462;3;16;3371
71996000;5;119;                    Vale de Cambra;22864;11079;11785;22158;10605;11553;8489;5;7293;11838;11838;0;12;9579
71997000;6;11901;                        Arões;1459;680;779;1380;632;748;571;0;452;756;756;0;0;751
72099000;6;11902;                        São Pedro de Castelões;7254;3523;3731;7084;3406;3678;2656;3;2339;3574;3574;0;4;2712
72324000;6;11903;                        Cepelos;1313;633;680;1231;589;642;480;1;404;797;797;0;1;783
72400000;6;11904;                        Codal;946;471;475;927;460;467;341;0;314;424;424;0;0;370
72450000;6;11905;                        Junqueira;1067;510;557;1005;472;533;368;0;315;563;563;0;0;552
72535000;6;11906;                        Macieira de Cambra;4752;2291;2461;4630;2202;2428;1759;1;1495;2505;2505;0;6;2110
72726000;6;11907;                        Roge;1752;850;902;1698;811;887;636;0;577;881;881;0;0;864
72816000;6;11908;                        Vila Chã;3912;1939;1973;3796;1849;1947;1521;0;1267;2113;2113;0;1;1227
72924000;6;11909;                        Vila Cova de Perrinho;409;182;227;407;184;223;157;0;130;225;225;0;0;210
72951000;4;117;                Douro;205902;98444;107458;200334;94939;105395;78589;123;62911;139953;139842;111;325;119398
72952000;5;403;                    Carrazeda de Ansiães;6373;3066;3307;6055;2900;3155;2686;5;1964;5333;5309;24;7;5115
72953000;6;40301;                        Amedo;302;145;157;297;143;154;122;0;94;244;224;20;0;224
72982000;6;40302;                        Beira Grande;144;72;72;143;71;72;73;0;48;139;139;0;0;139
72997000;6;40303;                        Belver;322;160;162;303;151;152;125;0;102;217;217;0;0;215
73026000;6;40304;                        Carrazeda de Ansiães;1701;820;881;1626;776;850;619;1;518;993;991;2;2;826
73111000;6;40305;                        Castanheiro;427;189;238;401;174;227;191;0;133;383;383;0;0;379
73137000;6;40306;                        Fonte Longa;301;152;149;294;147;147;124;1;87;236;236;0;1;236
73174000;6;40307;                        Lavandeira;162;80;82;159;78;81;77;0;51;185;184;1;0;185
73191000;6;40308;                        Linhares;421;208;213;411;202;209;214;0;138;388;387;1;0;387
73234000;6;40309;                        Marzagão;315;146;169;228;105;123;137;0;95;248;248;0;0;248
73269000;6;40310;                        Mogo de Malta;111;49;62;112;49;63;35;1;28;81;81;0;1;82
73282000;6;40311;                        Parambos;247;125;122;227;115;112;107;0;76;222;222;0;0;210
73308000;6;40312;                        Pereiros;235;118;117;236;121;115;104;0;73;232;232;0;0;232
73323000;6;40313;                        Pinhal do Norte;263;125;138;251;118;133;118;0;84;290;290;0;0;289
73347000;6;40314;                        Pombal;324;148;176;308;146;162;139;1;89;263;263;0;1;258
73371000;6;40315;                        Ribalonga;92;46;46;92;46;46;44;0;32;116;116;0;0;116
73380000;6;40316;                        Seixo de Ansiães;290;149;141;284;145;139;138;0;94;325;325;0;1;320
73412000;6;40317;                        Selores;141;68;73;129;60;69;60;0;42;111;111;0;0;108
73430000;6;40318;                        Vilarinho da Castanheira;415;188;227;397;177;220;185;1;126;514;514;0;1;515
73477000;6;40319;                        Zedes;160;78;82;157;76;81;74;0;54;146;146;0;0;146
73491000;5;404;                    Freixo de Espada à Cinta;3780;1820;1960;3735;1799;1936;1535;7;1146;3142;3142;0;23;3060
73492000;6;40401;                        Fornos;206;104;102;206;104;102;103;0;76;361;361;0;0;354
73547000;6;40402;                        Freixo de Espada à Cinta;2188;1057;1131;2178;1056;1122;801;4;644;1329;1329;0;18;1267
73630000;6;40403;                        Lagoaça;411;193;218;402;186;216;188;1;128;543;543;0;3;534
73681000;6;40404;                        Ligares;397;183;214;387;178;209;174;1;114;355;355;0;1;351
73707000;6;40405;                        Mazouco;167;77;90;165;77;88;93;0;59;244;244;0;0;244
73733000;6;40406;                        Poiares;411;206;205;397;198;199;176;1;125;310;310;0;1;310
73776000;5;409;                    Torre de Moncorvo;8572;4106;4466;8404;4021;4383;3738;9;2694;7309;7308;1;19;6715
73777000;6;40901;                        Açoreira;524;285;239;522;284;238;202;0;174;310;310;0;1;306
73805000;6;40902;                        Adeganha;343;169;174;334;161;173;160;0;112;347;347;0;0;315
73867000;6;40903;                        Cabeça Boa;428;216;212;437;220;217;191;0;137;355;354;1;0;348
73908000;6;40904;                        Cardanha;231;104;127;228;102;126;103;0;83;254;254;0;0;252
73934000;6;40905;                        Carviçais;757;372;385;733;362;371;345;1;239;592;592;0;3;583
74005000;6;40906;                        Castedo;236;114;122;236;114;122;113;0;70;205;205;0;0;202
74029000;6;40907;                        Felgar;954;455;499;935;450;485;412;0;301;750;750;0;1;732
74117000;6;40908;                        Felgueiras;291;127;164;279;120;159;124;1;83;318;318;0;1;317
74150000;6;40909;                        Horta da Vilariça;310;154;156;311;155;156;170;0;97;315;315;0;0;313
74183000;6;40910;                        Larinho;365;184;181;371;187;184;156;1;117;326;326;0;2;325
74212000;6;40911;                        Lousa;358;161;197;341;153;188;192;0;119;596;596;0;0;596
74255000;6;40912;                        Maçores;169;76;93;155;70;85;78;0;57;173;173;0;0;172
74274000;6;40913;                        Mós;246;118;128;245;118;127;115;1;80;249;249;0;1;250
74294000;6;40914;                        Peredo dos Castelhanos;111;49;62;111;49;62;49;1;32;151;151;0;1;150
74311000;6;40915;                        Souto da Velha;93;44;49;92;44;48;50;0;30;143;143;0;0;143
74329000;6;40916;                        Torre de Moncorvo;2891;1354;1537;2829;1316;1513;1157;4;878;1870;1870;0;9;1356
74443000;6;40917;                        Urros;265;124;141;245;116;129;121;0;85;355;355;0;0;355
74481000;5;410;                    Vila Flor;6697;3212;3485;6485;3115;3370;2722;7;2074;5212;5210;2;20;4811
74482000;6;41001;                        Assares;141;69;72;128;58;70;55;0;47;98;98;0;0;97
74502000;6;41002;                        Benlhevai;234;120;114;214;108;106;95;0;66;180;180;0;0;172
74521000;6;41003;                        Candoso;158;72;86;146;65;81;73;0;49;158;158;0;0;158
74532000;6;41004;                        Carvalho de Egas;114;50;64;109;49;60;49;0;40;125;125;0;0;125
74543000;6;41005;                        Freixiel;640;303;337;617;294;323;270;1;192;547;546;1;1;542
74581000;6;41006;                        Lodões;100;57;43;96;54;42;50;0;29;113;113;0;0;113
74595000;6;41007;                        Mourão;104;53;51;101;51;50;55;0;35;151;151;0;0;151
74605000;6;41008;                        Nabo;144;75;69;140;72;68;74;0;49;206;206;0;0;206
74616000;6;41009;                        Roios;150;73;77;141;66;75;66;0;50;130;130;0;1;129
74630000;6;41010;                        Samões;338;167;171;330;166;164;139;0;102;262;262;0;2;262
74650000;6;41011;                        Sampaio;159;76;83;152;71;81;66;0;57;133;133;0;0;133
74668000;6;41012;                        Santa Comba de Vilariça;407;195;212;384;183;201;145;1;122;274;274;0;1;269
74703000;6;41013;                        Seixo de Manhoses;469;220;249;467;217;250;188;1;144;334;333;1;1;325
74721000;6;41014;                        Trindade;162;75;87;116;51;65;71;0;50;159;159;0;0;158
74744000;6;41015;                        Vale Frechoso;189;91;98;181;86;95;83;0;61;130;130;0;0;128
74768000;6;41016;                        Valtorno;260;114;146;272;121;151;123;0;76;302;302;0;1;293
74802000;6;41017;                        Vila Flor;2269;1086;1183;2252;1095;1157;839;4;686;1328;1328;0;11;989
74910000;6;41018;                        Vilarinho das Azenhas;109;51;58;104;49;55;49;0;37;79;79;0;1;79
74924000;6;41019;                        Vilas Boas;550;265;285;535;259;276;232;0;182;503;503;0;1;482
74952000;5;914;                    Vila Nova de Foz Côa;7312;3458;3854;6971;3280;3691;3025;7;2273;6489;6487;2;14;6051
74953000;6;91401;                        Almendra;386;194;192;380;191;189;163;2;118;432;432;0;2;434
75008000;6;91402;                        Castelo Melhor;228;106;122;226;103;123;111;0;75;298;298;0;0;296
75043000;6;91403;                        Cedovim;338;162;176;322;155;167;138;1;100;350;350;0;1;350
75098000;6;91404;                        Chãs;278;130;148;279;132;147;110;1;78;217;217;0;1;218
75125000;6;91405;                        Custóias;202;93;109;191;88;103;104;0;67;225;225;0;0;225
75144000;6;91406;                        Freixo de Numão;502;233;269;475;224;251;202;0;161;546;546;0;1;543
75191000;6;91407;                        Horta;242;118;124;232;111;121;93;0;81;223;223;0;2;225
75226000;6;91408;                        Mós;190;94;96;180;90;90;85;0;65;221;221;0;0;221
75251000;6;91409;                        Murça;107;46;61;98;42;56;55;0;39;116;116;0;0;116
75270000;6;91410;                        Muxagata;309;143;166;306;140;166;135;0;104;242;242;0;0;242
75308000;6;91411;                        Numão;240;106;134;238;102;136;105;0;72;236;236;0;0;236
75331000;6;91412;                        Santa Comba;208;101;107;195;95;100;97;1;64;314;313;1;1;313
75375000;6;91413;                        Santo Amaro;50;22;28;49;22;27;29;0;18;127;127;0;0;127
75389000;6;91414;                        Sebadelhe;265;125;140;249;114;135;116;1;80;253;253;0;1;254
75416000;6;91415;                        Seixas;335;167;168;312;157;155;136;0;106;305;305;0;0;305
75435000;6;91416;                        Touça;235;113;122;179;71;108;95;0;76;174;174;0;0;170
75463000;6;91417;                        Vila Nova de Foz Côa;3197;1505;1692;3060;1443;1617;1251;1;969;2210;2209;1;5;1776
75593000;5;1701;                    Alijó;11942;5772;6170;11920;5922;5998;4770;6;3708;8571;8567;4;23;8027
75594000;6;170101;                        Alijó;2635;1273;1362;2572;1212;1360;937;3;797;1477;1477;0;8;1215
75704000;6;170102;                        Amieiro;81;38;43;71;35;36;42;0;29;74;74;0;0;74
75712000;6;170103;                        Carlão;719;347;372;691;335;356;326;1;233;626;626;0;1;623
75766000;6;170104;                        Casal de Loivos;183;86;97;171;78;93;66;0;53;118;118;0;3;118
75777000;6;170105;                        Castedo;373;178;195;343;157;186;150;0;110;283;282;1;0;268
75799000;6;170106;                        Cotas;245;119;126;233;111;122;102;0;76;160;159;1;0;155
75816000;6;170107;                        Favaios;1064;508;556;1053;499;554;429;0;329;751;751;0;1;731
75886000;6;170108;                        Pegarinhos;465;230;235;871;638;233;187;0;142;404;404;0;1;395
75927000;6;170109;                        Pinhão;648;313;335;599;290;309;264;0;205;384;384;0;3;229
75948000;6;170110;                        Pópulo;277;129;148;264;123;141;115;0;86;242;242;0;0;241
75998000;6;170111;                        Ribalonga;231;105;126;219;100;119;103;0;74;220;219;1;0;219
76021000;6;170112;                        Sanfins do Douro;1495;730;765;1411;683;728;602;1;469;1086;1085;1;1;1054
76127000;6;170113;                        Santa Eugénia;333;165;168;327;158;169;148;0;112;232;232;0;1;227
76150000;6;170114;                        São Mamede de Ribatua;728;353;375;726;351;375;309;0;236;595;595;0;0;580
76183000;6;170115;                        Vale de Mendiz;249;119;130;237;115;122;97;0;79;149;149;0;2;146
76203000;6;170116;                        Vila Chã;533;267;266;531;266;265;224;0;166;403;403;0;0;397
76268000;6;170117;                        Vila Verde;622;306;316;606;303;303;268;0;185;566;566;0;1;563
76321000;6;170118;                        Vilar de Maçada;915;431;484;864;405;459;351;1;279;724;724;0;1;716
76369000;6;170119;                        Vilarinho de Cotas;146;75;71;131;63;68;50;0;48;77;77;0;0;76
76386000;5;1704;                    Mesão Frio;4433;2121;2312;4221;1986;2235;1536;3;1338;2383;2383;0;9;2215
76387000;6;170401;                        Barqueiros;701;330;371;667;308;359;241;0;217;430;430;0;1;408
76412000;6;170402;                        Cidadelhe;171;85;86;164;81;83;67;0;54;106;106;0;0;100
76424000;6;170403;                        Oliveira;391;196;195;367;182;185;136;0;119;214;214;0;4;210
76443000;6;170404;                        Mesão Frio (Santa Cristina);808;384;424;773;358;415;279;0;251;463;463;0;1;445
76474000;6;170405;                        Mesão Frio (São Nicolau);484;216;268;458;202;256;145;3;120;195;195;0;3;153
76493000;6;170406;                        Vila Jusã;635;319;316;610;303;307;213;0;197;288;288;0;0;219
76508000;6;170407;                        Vila Marim;1243;591;652;1182;552;630;455;0;380;687;687;0;0;680
76572000;5;1708;                    Peso da Régua;17131;8111;9020;16424;7649;8775;6311;7;5204;9232;9219;13;19;6736
76573000;6;170801;                        Covelinhas;222;111;111;226;112;114;94;0;69;179;179;0;0;178
76591000;6;170802;                        Fontelas;781;397;384;720;357;363;274;0;233;385;385;0;0;349
76622000;6;170803;                        Galafura;664;308;356;620;285;335;238;0;204;441;441;0;0;438
76653000;6;170804;                        Godim;4667;2190;2477;4525;2095;2430;1723;2;1439;2161;2158;3;9;1176
76718000;6;170805;                        Loureiro;1154;555;599;1067;506;561;417;0;366;658;658;0;0;650
76763000;6;170806;                        Moura Morta;525;267;258;494;241;253;180;0;167;288;288;0;0;286
76793000;6;170807;                        Peso da Régua;5292;2469;2823;5026;2268;2758;1928;3;1589;2609;2609;0;8;1204
76851000;6;170808;                        Poiares;802;373;429;837;414;423;309;1;243;513;513;0;1;506
76889000;6;170809;                        Sedielos;911;413;498;852;377;475;360;0;271;732;731;1;0;726
76936000;6;170810;                        Vilarinho dos Freires;950;458;492;937;447;490;343;0;287;541;541;0;0;508
76962000;6;170811;                        Vinhós;499;240;259;468;223;245;204;0;149;352;352;0;0;350
76977000;6;170812;                        Canelas;664;330;334;652;324;328;241;1;187;373;364;9;1;365
76996000;5;1710;                    Sabrosa;6361;3069;3292;6162;2953;3209;2452;4;1976;4642;4641;1;17;4512
76997000;6;171001;                        Celeirós;222;116;106;223;114;109;85;0;66;134;134;0;1;133
77005000;6;171002;                        Covas do Douro;444;229;215;421;219;202;168;0;138;377;377;0;3;378
77032000;6;171003;                        Gouvães do Douro;142;66;76;133;61;72;56;0;48;145;145;0;2;141
77044000;6;171004;                        Gouvinhas;267;130;137;261;127;134;108;0;90;212;212;0;0;208
77054000;6;171005;                        Parada de Pinhão;309;151;158;301;146;155;123;0;100;252;252;0;1;248
77072000;6;171006;                        Paradela de Guiães;103;47;56;100;46;54;53;0;33;134;134;0;0;134
77084000;6;171007;                        Paços;762;363;399;711;334;377;291;0;248;529;529;0;0;526
77121000;6;171008;                        Provesende;310;132;178;296;126;170;132;0;93;255;255;0;1;256
77134000;6;171009;                        Sabrosa;1202;609;593;1177;588;589;427;3;353;634;633;1;5;557
77178000;6;171010;                        São Cristovão do Douro;160;77;83;157;73;84;59;0;55;97;97;0;0;95
77191000;6;171011;                        São Lourenço de Ribapinhão;407;184;223;394;177;217;172;0;124;328;328;0;0;328
77233000;6;171012;                        São Martinho de Antas;910;427;483;879;412;467;343;1;280;760;760;0;3;725
77281000;6;171013;                        Souto Maior;487;237;250;472;227;245;191;0;149;312;312;0;0;309
77313000;6;171014;                        Torre do Pinhão;342;167;175;338;165;173;133;0;106;269;269;0;0;269
77339000;6;171015;                        Vilarinho de São Romão;294;134;160;299;138;161;111;0;93;204;204;0;1;205
77357000;5;1711;                    Santa Marta de Penaguião;7356;3463;3893;7037;3278;3759;2777;3;2233;4622;4620;2;9;4346
77358000;6;171101;                        Alvações do Corgo;477;220;257;455;210;245;192;0;154;320;320;0;0;319
77383000;6;171102;                        Cumieira;1146;536;610;1094;504;590;420;1;359;687;687;0;3;679
77458000;6;171103;                        Fontes;835;388;447;816;381;435;345;0;259;702;702;0;0;687
77530000;6;171104;                        Fornelos;241;120;121;233;116;117;99;0;75;200;200;0;0;198
77550000;6;171105;                        Louredo;428;205;223;399;186;213;167;0;129;305;305;0;0;304
77588000;6;171106;                        Medrões;505;243;262;499;241;258;202;0;150;349;349;0;0;349
77641000;6;171107;                        Sanhoane;375;180;195;360;169;191;145;0;113;244;244;0;0;240
77661000;6;171108;                        Lobrigos (São João Baptista);1270;582;688;1190;537;653;440;1;369;618;617;1;3;590
77719000;6;171109;                        Lobrigos (São Miguel);1365;647;718;1312;615;697;485;1;412;690;689;1;3;475
77754000;6;171110;                        Sever;714;342;372;679;319;360;282;0;213;507;507;0;0;505
77813000;5;1714;                    Vila Real;51850;24670;27180;52781;24794;27987;19196;18;15860;29943;29912;31;54;21167
77814000;6;171401;                        Abaças;965;465;500;898;433;465;364;0;294;759;759;0;0;759
77855000;6;171402;                        Adoufe;2155;1044;1111;2080;1012;1068;753;0;655;1139;1139;0;1;1089
77939000;6;171403;                        Andrães;1389;656;733;1351;635;716;525;0;443;1064;1064;0;0;1054
78016000;6;171404;                        Arroios;1117;540;577;1092;530;562;396;0;336;554;553;1;1;478
78043000;6;171405;                        Borbela;2652;1257;1395;2578;1204;1374;939;0;837;1286;1280;6;0;1107
78112000;6;171406;                        Campeã;1375;641;734;1347;630;717;541;0;440;1088;1088;0;4;1082
78204000;6;171407;                        Constantim;1020;470;550;973;448;525;348;0;311;536;536;0;1;509
78239000;6;171408;                        Ermida;419;197;222;397;183;214;166;0;143;299;299;0;0;298
78263000;6;171409;                        Folhadela;2261;1037;1224;2184;998;1186;814;1;692;1272;1272;0;2;1066
78318000;6;171410;                        Guiães;478;234;244;448;214;234;184;0;153;376;376;0;0;376
78333000;6;171411;                        Justes;333;167;166;318;157;161;139;0;114;256;256;0;0;256
78353000;6;171412;                        Lamares;351;172;179;345;169;176;131;0;114;251;250;1;0;247
78381000;6;171413;                        Lamas de Olo;109;43;66;111;45;66;47;0;37;114;114;0;0;111
78399000;6;171414;                        Lordelo;3169;1562;1607;3366;1669;1697;1059;2;943;1430;1429;1;3;996
78457000;6;171415;                        Mateus;3400;1624;1776;3285;1553;1732;1220;3;1002;1646;1636;10;5;871
78515000;6;171416;                        Mondrões;1065;524;541;1041;510;531;368;1;323;598;598;0;1;589
78568000;6;171417;                        Mouçós;3051;1494;1557;2989;1449;1540;1122;0;924;1720;1719;1;1;1679
78708000;6;171418;                        Nogueira;545;258;287;538;254;284;227;0;182;437;437;0;0;434
78733000;6;171419;                        Vila Real (Nossa Senhora da Conceição);8885;4221;4664;9076;4219;4857;3357;1;2757;4725;4723;2;7;1637
78865000;6;171420;                        Parada de Cunhos;1939;943;996;1873;911;962;694;0;598;991;990;1;0;655
78910000;6;171421;                        Pena;483;226;257;462;216;246;182;0;155;334;334;0;0;332
78950000;6;171422;                        Quinta;174;80;94;169;75;94;63;0;50;175;175;0;0;175
78958000;6;171423;                        Vila Real (São Dinis);3937;1855;2082;4050;1848;2202;1559;4;1170;2244;2241;3;12;789
79030000;6;171424;                        Vila Real (São Pedro);4766;2188;2578;6162;2774;3388;1960;5;1433;3027;3027;0;15;985
79103000;6;171425;                        São Tomé do Castelo;950;442;508;946;430;516;345;1;282;788;787;1;1;784
79184000;6;171426;                        Torgueda;1382;660;722;1311;615;696;498;0;433;839;835;4;0;830
79251000;6;171427;                        Vale de Nogueiras;836;395;441;819;385;434;310;0;248;620;620;0;0;616
79323000;6;171428;                        Vila Cova;162;75;87;159;73;86;74;0;50;151;151;0;0;151
79354000;6;171429;                        Vila Marim;1742;843;899;1689;809;880;573;0;524;791;791;0;0;780
79418000;6;171430;                        Vilarinho de Samardã;740;357;383;724;346;378;238;0;217;433;433;0;0;432
79468000;5;1801;                    Armamar;6297;2981;3316;5952;2799;3153;2323;6;1868;4925;4922;3;18;4780
79469000;6;180101;                        Aldeias;337;165;172;331;162;169;136;0;98;249;249;0;0;249
79493000;6;180102;                        Aricera;157;79;78;138;64;74;66;0;49;146;146;0;0;146
79517000;6;180103;                        Armamar;1268;609;659;1242;599;643;421;1;364;707;705;2;11;582
79562000;6;180104;                        Cimbres;308;148;160;292;141;151;116;0;92;284;284;0;0;283
79588000;6;180105;                        Coura;49;25;24;48;24;24;21;0;15;56;56;0;0;56
79596000;6;180106;                        Folgosa;428;212;216;397;199;198;156;0;141;267;266;1;1;267
79612000;6;180107;                        Fontelo;641;288;353;608;273;335;235;1;196;504;504;0;1;504
79648000;6;180108;                        Goujoim;58;29;29;58;29;29;30;0;18;116;116;0;0;114
79658000;6;180109;                        Queimada;285;142;143;281;139;142;98;1;77;261;261;0;2;260
79680000;6;180110;                        Queimadela;248;125;123;226;111;115;83;0;72;169;169;0;0;169
79697000;6;180111;                        Santa Cruz;206;103;103;197;99;98;77;0;63;187;187;0;0;187
79715000;6;180112;                        Santiago;139;68;71;132;62;70;57;0;41;188;188;0;0;188
79732000;6;180113;                        Santo Adrião;81;35;46;79;34;45;34;0;23;96;96;0;0;96
79741000;6;180114;                        São Cosmado;598;272;326;592;269;323;227;2;175;493;493;0;2;494
79771000;6;180115;                        São Martinho das Chãs;549;246;303;501;217;284;199;0;165;403;403;0;0;400
79812000;6;180116;                        São Romão;167;79;88;125;58;67;68;0;55;143;143;0;0;143
79829000;6;180117;                        Tões;147;64;83;133;60;73;55;0;50;97;97;0;0;95
79840000;6;180118;                        Vacalar;205;92;113;198;85;113;85;0;60;184;184;0;0;184
79855000;6;180119;                        Vila Seca;426;200;226;374;174;200;159;1;114;375;375;0;1;363
79879000;5;1805;                    Lamego;26691;12713;13978;25453;11947;13506;9855;16;8126;16331;16323;8;48;12398
79880000;6;180501;                        Lamego (Almacave);8750;4133;4617;8292;3853;4439;3279;10;2678;4596;4595;1;18;1914
80026000;6;180502;                        Avões;619;309;310;586;285;301;201;0;189;334;334;0;0;329
80040000;6;180503;                        Bigorne;46;27;19;44;24;20;18;0;15;66;66;0;0;66
80052000;6;180504;                        Britiande;934;433;501;877;408;469;342;0;296;586;586;0;4;533
80089000;6;180505;                        Cambres;2066;975;1091;1919;878;1041;761;0;628;1208;1207;1;6;1164
80156000;6;180506;                        Cepões;860;443;417;788;390;398;305;0;261;535;534;1;0;527
80195000;6;180507;                        Ferreirim;904;409;495;873;388;485;318;1;269;578;578;0;1;566
80231000;6;180508;                        Ferreiros de Avões;509;254;255;490;249;241;193;0;159;248;248;0;0;242
80254000;6;180509;                        Figueira;342;167;175;324;159;165;135;0;110;244;243;1;0;238
80272000;6;180510;                        Lalim;729;364;365;698;345;353;281;0;220;518;518;0;1;516
80299000;6;180511;                        Lazarim;521;255;266;489;235;254;207;0;165;539;539;0;0;538
80321000;6;180512;                        Magueija;591;283;308;546;253;293;228;0;174;550;550;0;0;549
80353000;6;180513;                        Meijinhos;86;42;44;80;39;41;34;0;25;116;116;0;0;114
80363000;6;180514;                        Melcões;125;59;66;125;59;66;52;0;40;149;148;1;0;149
80371000;6;180515;                        Parada do Bispo;149;73;76;149;73;76;55;0;44;80;80;0;0;80
80385000;6;180516;                        Penajóia;1023;477;546;997;458;539;388;0;325;764;763;1;1;751
80439000;6;180517;                        Penude;1666;801;865;1600;767;833;576;0;494;1072;1072;0;0;1031
80486000;6;180518;                        Pretarouca;69;32;37;71;33;38;34;0;17;101;101;0;0;101
80498000;6;180519;                        Samodães;203;105;98;207;108;99;77;0;61;168;168;0;2;166
80512000;6;180520;                        Sande;916;431;485;854;395;459;321;0;294;461;461;0;0;421
80537000;6;180521;                        Lamego (Sé);3464;1628;1836;3419;1605;1814;1297;4;1034;2140;2138;2;9;1136
80622000;6;180522;                        Valdigem;890;428;462;854;404;450;338;0;289;584;584;0;3;581
80655000;6;180523;                        Várzea de Abrunhais;405;199;206;381;182;199;149;0;123;281;281;0;1;281
80676000;6;180524;                        Vila Nova de Souto d' El-Rei;824;386;438;790;357;433;266;1;216;413;413;0;2;405
80700000;5;1807;                    Moimenta da Beira;10212;4888;5324;9768;4636;5132;3849;6;3086;7800;7791;9;10;6950
80701000;6;180701;                        Aldeia de Nacomba;107;52;55;105;51;54;43;0;33;102;102;0;0;100
80716000;6;180702;                        Alvite;1095;539;556;1003;497;506;378;1;325;649;649;0;1;646
80812000;6;180703;                        Arcozelos;674;320;354;663;309;354;249;0;197;475;467;8;1;424
80854000;6;180704;                        Ariz;107;50;57;99;45;54;52;0;35;145;145;0;0;144
80890000;6;180705;                        Baldos;201;99;102;192;95;97;72;0;60;133;133;0;0;132
80906000;6;180706;                        Cabaços;280;129;151;266;123;143;116;0;93;294;294;0;0;294
80936000;6;180707;                        Caria;507;238;269;499;239;260;203;0;156;489;489;0;0;482
81003000;6;180708;                        Castelo;245;117;128;221;104;117;102;0;83;260;260;0;0;258
81030000;6;180709;                        Leomil;1115;528;587;1084;517;567;391;1;336;798;798;0;2;779
81105000;6;180710;                        Moimenta da Beira;2888;1398;1490;2773;1327;1446;1039;3;842;1812;1812;0;4;1070
81192000;6;180711;                        Nagosa;111;43;68;104;42;62;50;0;35;139;139;0;0;136
81211000;6;180712;                        Paradinha;125;55;70;128;56;72;48;0;38;146;145;1;0;145
81233000;6;180713;                        Passô;343;159;184;336;154;182;143;0;94;280;280;0;0;276
81277000;6;180714;                        Pêra Velha;214;99;115;208;95;113;92;0;75;189;189;0;0;189
81317000;6;180715;                        Peva;418;194;224;392;179;213;174;0;127;418;418;0;0;413
81387000;6;180716;                        Rua;601;295;306;577;280;297;242;0;189;441;441;0;1;438
81427000;6;180717;                        Sarzedo;162;73;89;162;73;89;68;0;52;149;149;0;0;148
81446000;6;180718;                        Segões;101;50;51;87;41;46;45;0;30;136;136;0;0;136
81464000;6;180719;                        Sever;536;268;268;508;240;268;195;1;162;452;452;0;1;448
81506000;6;180720;                        Vilar;382;182;200;361;169;192;147;0;124;293;293;0;0;292
81533000;5;1812;                    Penedono;2952;1415;1537;2797;1326;1471;1172;3;848;2628;2628;0;3;2568
81534000;6;181201;                        Antas;184;85;99;179;84;95;93;0;56;260;260;0;0;260
81562000;6;181202;                        Beselga;321;155;166;304;147;157;129;1;88;331;331;0;1;325
81593000;6;181203;                        Castainço;161;81;80;149;73;76;70;0;53;164;164;0;0;164
81609000;6;181204;                        Granja;148;75;73;131;64;67;62;0;46;139;139;0;0;139
81622000;6;181205;                        Ourozinho;136;60;76;129;60;69;58;0;40;146;146;0;0;144
81647000;6;181206;                        Penedono;1007;478;529;945;437;508;359;1;283;715;715;0;1;665
81725000;6;181207;                        Penela da Beira;353;174;179;340;167;173;137;1;92;331;331;0;1;332
81756000;6;181208;                        Póvoa de Penela;325;151;174;315;145;170;136;0;97;278;278;0;0;277
81782000;6;181209;                        Souto;317;156;161;305;149;156;128;0;93;264;264;0;0;262
81813000;5;1815;                    São João da Pesqueira;7874;3883;3991;7604;3723;3881;3012;3;2465;5557;5555;2;7;5278
81814000;6;181501;                        Castanheiro do Sul;439;234;205;432;231;201;180;0;155;289;289;0;0;287
81832000;6;181502;                        Ervedosa do Douro;1294;612;682;1243;583;660;479;1;392;865;865;0;1;841
81881000;6;181503;                        Espinhosa;156;74;82;142;67;75;70;0;52;146;146;0;0;142
81897000;6;181504;                        Nagozelo do Douro;414;214;200;398;200;198;170;0;134;278;278;0;0;275
81917000;6;181505;                        Paredes da Beira;629;313;316;594;296;298;239;0;207;475;475;0;0;472
81946000;6;181506;                        Pereiros;84;44;40;79;39;40;35;0;26;85;85;0;0;85
81957000;6;181507;                        Riodades;462;220;242;453;217;236;198;0;153;444;443;1;0;444
81985000;6;181508;                        São João da Pesqueira;2206;1097;1109;2100;1037;1063;776;1;659;1176;1175;1;4;939
82052000;6;181509;                        Soutelo do Douro;459;225;234;454;222;232;175;0;141;344;344;0;0;343
82073000;6;181510;                        Trevões;540;260;280;522;247;275;207;1;168;415;415;0;1;416
82105000;6;181511;                        Vale de Figueira;462;236;226;459;232;227;184;0;148;464;464;0;0;464
82137000;6;181512;                        Valongo dos Azeites;227;115;112;226;112;114;90;0;73;188;188;0;0;184
82155000;6;181513;                        Várzea de Trevões;174;85;89;169;82;87;68;0;50;128;128;0;0;128
82169000;6;181514;                        Vilarouco;328;154;174;333;158;175;141;0;107;260;260;0;1;258
82199000;5;1818;                    Sernancelhe;5671;2747;2924;5512;2660;2852;2206;6;1732;4481;4477;4;7;4362
82200000;6;181801;                        Arnas;220;106;114;199;90;109;83;0;69;219;219;0;0;219
82217000;6;181802;                        Carregal;393;176;217;385;171;214;176;0;123;389;389;0;0;387
82255000;6;181803;                        Chosendo;254;127;127;260;130;130;107;0;80;226;226;0;0;225
82273000;6;181804;                        Cunha;310;159;151;286;145;141;115;0;89;270;267;3;0;270
82291000;6;181805;                        Escurquela;138;68;70;125;64;61;56;0;41;125;125;0;0;123
82308000;6;181806;                        Faia;207;97;110;184;84;100;80;0;67;142;142;0;0;140
82325000;6;181807;                        Ferreirim;457;228;229;462;231;231;191;0;143;370;370;0;0;370
82349000;6;181808;                        Fonte Arcada;270;127;143;268;126;142;112;1;75;266;266;0;1;262
82375000;6;181809;                        Freixinho;140;74;66;135;70;65;57;0;50;142;142;0;1;142
82388000;6;181810;                        Granjal;272;134;138;267;132;135;112;0;90;218;218;0;0;217
82410000;6;181811;                        Lamosa;179;86;93;170;81;89;72;1;52;167;167;0;1;168
82444000;6;181812;                        Macieira;124;64;60;117;60;57;53;0;37;91;91;0;0;91
82462000;6;181813;                        Penso;230;112;118;234;116;118;94;0;76;208;208;0;0;207
82480000;6;181814;                        Quintela;294;133;161;299;137;162;98;3;82;180;180;0;3;181
82512000;6;181815;                        Sarzeda;530;252;278;510;240;270;203;0;170;413;412;1;0;408
82552000;6;181816;                        Sernancelhe;1183;561;622;1141;541;600;418;1;345;743;743;0;1;642
82609000;6;181817;                        Vila da Ponte;470;243;227;470;242;228;179;0;143;312;312;0;0;310
82639000;5;1819;                    Tabuaço;6350;3049;3301;5761;2696;3065;2432;4;1914;4422;4417;5;10;4211
82640000;6;181901;                        Adorigo;397;200;197;345;172;173;149;0;127;276;276;0;1;271
82655000;6;181902;                        Arcos;233;109;124;228;102;126;90;0;80;219;219;0;0;219
82670000;6;181903;                        Barcos;592;294;298;588;291;297;214;1;170;394;394;0;1;388
82697000;6;181904;                        Chavães;385;191;194;303;150;153;137;0;114;343;343;0;0;334
82725000;6;181905;                        Desejosa;175;88;87;136;67;69;76;0;49;112;112;0;0;112
82739000;6;181906;                        Granja do Tedo;214;111;103;182;93;89;81;0;63;179;179;0;0;179
82750000;6;181907;                        Granjinha;57;27;30;57;27;30;30;0;16;58;58;0;0;58
82758000;6;181908;                        Longra;370;179;191;327;152;175;145;0;109;285;285;0;0;284
82775000;6;181909;                        Paradela;123;61;62;125;62;63;49;0;36;123;123;0;0;122
82788000;6;181910;                        Pereiro;138;68;70;133;63;70;53;0;41;113;113;0;0;113
82798000;6;181911;                        Pinheiros;178;88;90;172;83;89;75;0;58;189;189;0;0;189
82814000;6;181912;                        Santa Leocádia;118;57;61;111;54;57;46;0;32;101;101;0;0;101
82825000;6;181913;                        Sendim;705;327;378;614;280;334;282;2;216;539;539;0;2;538
82867000;6;181914;                        Tabuaço;1782;824;958;1641;734;907;667;1;536;921;917;4;3;752
82914000;6;181915;                        Távora;374;176;198;362;166;196;145;0;109;252;252;0;1;236
82929000;6;181916;                        Vale de Figueira;146;75;71;127;63;64;53;0;46;91;91;0;0;91
82940000;6;181917;                        Valença do Douro;363;174;189;310;137;173;140;0;112;227;226;1;2;224
82959000;5;1820;                    Tarouca;8048;3900;4148;7292;3455;3837;2992;3;2402;6931;6931;0;8;6096
82960000;6;182001;                        Dálvares;689;335;354;661;318;343;260;0;219;418;418;0;1;337
82983000;6;182002;                        Gouviães;414;199;215;355;163;192;167;0;124;336;336;0;1;334
83007000;6;182003;                        Granja Nova;396;186;210;300;136;164;155;0;123;346;346;0;0;334
83036000;6;182004;                        Mondim da Beira;786;383;403;632;296;336;277;0;224;468;468;0;0;463
83074000;6;182005;                        Salzedas;767;383;384;748;366;382;291;0;235;590;590;0;0;579
83110000;6;182006;                        São João de Tarouca;606;290;316;583;277;306;232;0;183;790;790;0;1;786
83164000;6;182007;                        Tarouca;3556;1716;1840;3269;1544;1725;1263;2;1043;2546;2546;0;3;1840
83311000;6;182008;                        Ucanha;403;194;209;355;167;188;151;0;120;319;319;0;0;306
83336000;6;182009;                        Várzea da Serra;261;129;132;251;123;128;130;1;78;899;899;0;2;898
83394000;6;182010;                        Vila Chã da Beira;170;85;85;138;65;73;66;0;53;219;219;0;0;219
83411000;4;118;                Alto Trás-os-Montes;204381;98261;106120;199352;95444;103908;81245;136;63450;150341;150273;68;417;127220
83412000;5;401;                    Alfândega da Fé;5104;2467;2637;4909;2376;2533;2024;5;1588;3856;3851;5;9;3648
83413000;6;40101;                        Agrobom;109;51;58;101;45;56;52;0;38;115;115;0;0;114
83432000;6;40102;                        Alfândega da Fé;2055;1004;1051;2039;1005;1034;771;1;629;1187;1185;2;5;986
83530000;6;40103;                        Cerejais;202;90;112;195;86;109;72;1;52;137;137;0;1;138
83549000;6;40104;                        Eucisia;128;68;60;94;49;45;53;0;40;126;126;0;0;126
83570000;6;40105;                        Ferradosa;160;68;92;156;69;87;82;0;48;180;180;0;0;180
83587000;6;40106;                        Gebelim;190;86;104;182;83;99;70;0;62;134;134;0;0;134
83604000;6;40107;                        Gouveia;122;62;60;112;58;54;52;0;42;113;113;0;0;113
83620000;6;40108;                        Parada;124;58;66;109;50;59;52;0;39;156;156;0;0;156
83632000;6;40109;                        Pombal;123;60;63;111;52;59;45;0;39;81;81;0;0;81
83645000;6;40110;                        Saldonha;92;50;42;90;49;41;37;0;29;78;78;0;0;78
83653000;6;40111;                        Sambade;475;235;240;445;221;224;197;1;155;416;414;2;1;413
83696000;6;40112;                        Sendim da Ribeira;92;40;52;84;36;48;39;0;26;82;82;0;0;81
83708000;6;40113;                        Sendim da Serra;91;41;50;93;43;50;37;0;28;78;78;0;0;77
83720000;6;40114;                        Soeima;142;72;70;133;68;65;57;0;46;135;135;0;0;135
83738000;6;40115;                        Vale Pereiro;64;32;32;62;30;32;29;0;20;86;86;0;0;85
83748000;6;40116;                        Vales;78;42;36;78;42;36;35;0;26;61;61;0;0;61
83760000;6;40117;                        Valverde;107;48;59;99;44;55;49;0;30;102;102;0;0;102
83778000;6;40118;                        Vilar Chão;259;127;132;251;123;128;104;1;79;188;187;1;1;186
83793000;6;40119;                        Vilarelhos;275;123;152;269;121;148;98;1;89;187;187;0;1;188
83810000;6;40120;                        Vilares de Vilariça;216;110;106;206;102;104;93;0;71;214;214;0;0;214
83830000;5;402;                    Bragança;35341;16966;18375;35623;16917;18706;13835;33;10711;24782;24755;27;93;16517
83831000;6;40201;                        Alfaião;173;86;87;164;80;84;72;0;54;141;141;0;0;139
83845000;6;40202;                        Aveleda;196;96;100;185;92;93;95;0;65;243;243;0;0;242
83876000;6;40203;                        Babe;238;107;131;214;98;116;108;0;74;199;199;0;1;200
83904000;6;40204;                        Baçal;484;243;241;482;243;239;188;1;147;324;324;0;3;324
83931000;6;40205;                        Calvelhe;97;40;57;96;40;56;49;0;25;125;125;0;0;123
83944000;6;40206;                        Carragosa;190;90;100;184;86;98;80;0;61;183;183;0;0;182
83971000;6;40207;                        Carrazedo;114;45;69;113;44;69;52;0;34;123;123;0;0;123
83986000;6;40208;                        Castrelos;127;63;64;126;63;63;60;0;42;155;155;0;1;156
84002000;6;40209;                        Castro de Avelãs;460;229;231;446;223;223;175;0;150;254;254;0;0;240
84022000;6;40210;                        Coelhoso;319;136;183;322;140;182;126;1;92;312;312;0;1;313
84041000;6;40211;                        Deilão;168;80;88;167;79;88;77;0;57;175;175;0;0;175
84074000;6;40212;                        Donai;446;216;230;417;200;217;168;0;138;310;301;9;0;300
84105000;6;40213;                        Espinhosela;244;130;114;237;126;111;105;0;81;240;240;0;3;243
84138000;6;40214;                        Failde;150;67;83;149;68;81;59;1;41;106;106;0;1;107
84156000;6;40215;                        França;238;104;134;249;109;140;116;0;82;238;238;0;11;247
84186000;6;40216;                        Gimonde;341;158;183;351;168;183;135;0;110;225;225;0;6;229
84207000;6;40217;                        Gondesende;194;94;100;190;91;99;79;0;64;127;127;0;6;133
84227000;6;40218;                        Gostei;425;213;212;413;206;207;159;0;135;246;246;0;0;242
84253000;6;40219;                        Grijó de Parada;296;150;146;284;140;144;126;0;94;231;230;1;0;230
84274000;6;40220;                        Izeda;1006;614;392;988;608;380;278;4;221;538;538;0;2;535
84312000;6;40221;                        Macedo do Mato;208;104;104;206;102;104;106;0;69;220;220;0;0;220
84340000;6;40222;                        Meixedo;163;75;88;166;74;92;66;0;54;141;141;0;0;141
84356000;6;40223;                        Milhão;161;76;85;152;71;81;65;0;49;120;120;0;0;120
84378000;6;40224;                        Mós;178;90;88;179;91;88;75;0;58;170;170;0;2;172
84397000;6;40225;                        Nogueira;495;244;251;484;233;251;171;1;148;228;228;0;1;228
84425000;6;40226;                        Outeiro;301;152;149;298;150;148;121;1;79;293;293;0;1;294
84456000;6;40227;                        Parada;507;243;264;493;234;259;231;0;171;557;556;1;0;557
84498000;6;40228;                        Paradinha Nova;109;53;56;103;49;54;49;0;30;143;143;0;0;142
84513000;6;40229;                        Parâmio;214;97;117;213;97;116;104;0;68;215;215;0;3;217
84542000;6;40230;                        Pinela;219;103;116;253;121;132;97;0;78;255;255;0;0;255
84569000;6;40231;                        Pombares;41;21;20;38;19;19;19;0;13;49;49;0;0;49
84575000;6;40232;                        Quintanilha;216;106;110;205;101;104;92;1;65;201;201;0;1;202
84599000;6;40233;                        Quintela de Lampaças;215;103;112;210;101;109;107;0;71;224;224;0;0;224
84618000;6;40234;                        Rabal;171;75;96;160;71;89;86;0;55;160;160;0;4;164
84638000;6;40235;                        Rebordainhos;146;72;74;141;69;72;61;0;46;128;128;0;0;125
84655000;6;40236;                        Rebordãos;546;254;292;534;248;286;208;1;172;331;331;0;1;326
84675000;6;40237;                        Rio Frio;203;96;107;210;100;110;105;0;65;250;250;0;0;249
84702000;6;40238;                        Rio de Onor;76;35;41;74;35;39;41;0;27;104;104;0;0;104
84717000;6;40239;                        Salsas;389;200;189;394;203;191;162;1;124;311;311;0;1;311
84751000;6;40240;                        Samil;1246;605;641;1203;581;622;442;1;378;687;687;0;4;544
84803000;6;40241;                        Santa Comba de Rossas;304;152;152;280;138;142;113;1;94;231;228;3;1;227
84829000;6;40242;                        Bragança (Santa Maria);3940;1905;2035;3828;1861;1967;1507;5;1157;2604;2603;1;13;1345
84921000;6;40243;                        São Julião de Palácios;232;111;121;217;102;115;110;0;77;230;230;0;0;230
84947000;6;40244;                        São Pedro de Sarracenos;366;164;202;355;158;197;120;1;109;191;191;0;2;191
84969000;6;40245;                        Bragança (Sé);17913;8452;9461;18607;8607;10000;6902;12;5415;11541;11529;12;23;4696
85285000;6;40246;                        Sendas;183;83;100;173;80;93;83;0;63;146;146;0;0;146
85305000;6;40247;                        Serapicos;208;100;108;198;93;105;101;0;68;234;234;0;0;234
85334000;6;40248;                        Sortes;296;138;158;287;130;157;107;1;87;191;191;0;1;191
85357000;6;40249;                        Zoio;189;96;93;185;94;91;77;0;54;132;132;0;0;130
85374000;5;405;                    Macedo de Cavaleiros;15776;7491;8285;15166;7152;8014;6263;11;4922;11660;11658;2;32;9847
85375000;6;40501;                        Ala;417;198;219;398;190;208;172;0;128;323;323;0;0;323
85425000;6;40502;                        Amendoeira;427;214;213;413;207;206;163;0;132;308;308;0;1;308
85465000;6;40503;                        Arcas;262;131;131;239;122;117;116;0;88;208;208;0;1;206
85495000;6;40504;                        Bagueixe;156;82;74;155;81;74;78;0;43;150;150;0;0;150
85511000;6;40505;                        Bornes;390;174;216;378;173;205;162;0;124;293;293;0;3;295
85537000;6;40506;                        Burga;53;23;30;49;22;27;27;0;17;69;69;0;0;69
85547000;6;40507;                        Carrapatas;197;97;100;196;95;101;79;0;63;139;139;0;0;137
85560000;6;40508;                        Castelãos;443;180;263;411;149;262;135;3;107;219;219;0;3;222
85581000;6;40509;                        Chacim;265;123;142;279;122;157;118;2;82;226;226;0;3;228
85604000;6;40510;                        Cortiços;296;147;149;290;145;145;133;0;102;284;284;0;0;284
85628000;6;40511;                        Corujas;168;86;82;161;84;77;71;0;55;131;131;0;0;129
85643000;6;40512;                        Edroso;95;40;55;92;38;54;39;0;32;71;71;0;0;71
85656000;6;40513;                        Espadanedo;188;100;88;186;100;86;77;0;53;162;162;0;0;162
85680000;6;40514;                        Ferreira;194;94;100;192;94;98;91;0;63;180;179;1;0;179
85703000;6;40515;                        Grijó;371;172;199;374;172;202;150;1;110;293;293;0;1;294
85726000;6;40516;                        Lagoa;312;148;164;307;144;163;144;0;108;268;268;0;0;268
85745000;6;40517;                        Lamalonga;402;199;203;401;200;201;172;0;126;367;367;0;1;363
85779000;6;40518;                        Lamas;278;139;139;273;136;137;117;0;92;183;183;0;1;181
85794000;6;40519;                        Lombo;346;165;181;325;155;170;121;1;106;166;166;0;1;164
85807000;6;40520;                        Macedo de Cavaleiros;6257;2933;3324;6018;2798;3220;2323;2;1936;4047;4046;1;9;2276
85971000;6;40521;                        Morais;644;319;325;508;245;263;244;0;199;429;429;0;1;428
86007000;6;40522;                        Murçós;134;60;74;127;56;71;65;0;44;168;168;0;0;168
86024000;6;40523;                        Olmos;208;103;105;201;98;103;80;0;70;155;155;0;0;155
86047000;6;40524;                        Peredo;258;132;126;255;128;127;106;0;86;195;195;0;1;193
86067000;6;40525;                        Podence;250;113;137;253;120;133;107;0;83;220;220;0;3;216
86084000;6;40526;                        Salselas;386;196;190;390;199;191;160;0;122;352;352;0;0;352
86126000;6;40527;                        Santa Combinha;56;28;28;58;29;29;27;0;15;47;47;0;0;47
86136000;6;40528;                        Sesulfe;263;114;149;262;114;148;103;1;79;192;192;0;1;185
86161000;6;40529;                        Soutelo Mourisco;31;17;14;31;17;14;18;0;9;85;85;0;0;85
86178000;6;40530;                        Talhas;316;151;165;306;147;159;146;0;101;269;269;0;0;269
86211000;6;40531;                        Talhinhas;173;79;94;171;80;91;79;0;56;171;171;0;0;171
86234000;6;40532;                        Vale Benfeito;181;94;87;175;92;83;85;0;55;172;172;0;0;169
86252000;6;40533;                        Vale da Porca;286;131;155;262;117;145;111;0;91;219;219;0;0;212
86264000;6;40534;                        Vale de Prados;431;200;231;422;195;227;167;1;130;298;298;0;2;295
86293000;6;40535;                        Vilar do Monte;104;49;55;86;35;51;44;0;33;99;99;0;0;98
86303000;6;40536;                        Vilarinho de Agrochão;235;109;126;236;110;126;84;0;82;157;157;0;0;154
86323000;6;40537;                        Vilarinho do Monte;67;34;33;67;34;33;32;0;24;64;64;0;0;64
86335000;6;40538;                        Vinhas;236;117;119;219;109;110;117;0;76;281;281;0;0;277
86356000;5;406;                    Miranda do Douro;7482;3667;3815;7211;3518;3693;3055;7;2360;5513;5511;2;32;5158
86357000;6;40601;                        Atenor;121;58;63;115;50;65;58;0;42;110;110;0;1;110
86374000;6;40602;                        Cicouro;95;47;48;97;48;49;43;0;26;96;96;0;0;96
86389000;6;40603;                        Constantim;109;49;60;100;47;53;56;0;39;112;112;0;0;111
86400000;6;40604;                        Duas Igrejas;599;291;308;562;271;291;266;0;192;452;451;1;0;450
86443000;6;40605;                        Genísio;186;94;92;179;92;87;89;0;66;194;194;0;0;194
86467000;6;40606;                        Ifanes;160;76;84;158;75;83;79;0;50;181;181;0;0;181
86487000;6;40607;                        Malhadas;344;170;174;343;170;173;138;0;111;246;246;0;2;248
86515000;6;40608;                        Miranda do Douro;2254;1084;1170;2237;1063;1174;850;2;690;1443;1443;0;15;1098
86620000;6;40609;                        Palaçoulo;554;284;270;515;263;252;196;1;171;309;309;0;3;309
86655000;6;40610;                        Paradela;151;75;76;146;72;74;59;0;50;97;97;0;0;97
86675000;6;40611;                        Picote;301;146;155;291;142;149;128;1;87;253;253;0;4;257
86701000;6;40612;                        Póvoa;208;106;102;210;108;102;90;0;72;144;144;0;0;144
86729000;6;40613;                        São Martinho de Angueira;307;148;159;296;142;154;144;1;96;320;320;0;1;321
86764000;6;40614;                        Sendim;1366;670;696;1285;630;655;527;2;430;976;976;0;5;961
86828000;6;40615;                        Silva;237;121;116;230;120;110;112;0;81;199;199;0;0;199
86858000;6;40616;                        Vila Chã de Braciosa;327;164;163;300;150;150;151;0;110;270;269;1;1;271
86895000;6;40617;                        Águas Vivas;163;84;79;147;75;72;69;0;47;111;111;0;0;111
86910000;5;407;                    Mirandela;23850;11353;12497;23275;11063;12212;9309;13;7445;14862;14846;16;30;11515
86911000;6;40701;                        Abambres;347;179;168;343;174;169;142;0;110;258;258;0;0;256
86926000;6;40702;                        Abreiro;257;138;119;255;137;118;110;0;76;269;269;0;0;267
86941000;6;40703;                        Aguieiras;289;133;156;288;136;152;134;0;96;253;252;1;0;252
86960000;6;40704;                        Alvites;237;120;117;231;118;113;103;0;72;192;192;0;0;192
86977000;6;40705;                        Avantos;96;43;53;91;42;49;49;0;36;107;107;0;0;106
86986000;6;40706;                        Avidagos;245;120;125;234;115;119;100;0;78;138;138;0;0;136
86999000;6;40707;                        Barcel;126;59;67;119;56;63;58;0;42;82;82;0;0;78
87009000;6;40708;                        Bouça;261;125;136;259;124;135;129;0;85;247;246;1;1;245
87022000;6;40709;                        Cabanelas;386;185;201;370;174;196;151;0;125;231;231;0;0;227
87036000;6;40710;                        Caravelas;214;107;107;207;104;103;92;0;73;146;146;0;0;145
87045000;6;40711;                        Carvalhais;1299;642;657;1255;620;635;455;1;395;673;673;0;2;628
87068000;6;40712;                        Cedães;338;161;177;329;156;173;148;0;115;280;280;0;0;277
87083000;6;40713;                        Cobro;205;92;113;192;87;105;90;0;67;107;107;0;0;106
87092000;6;40714;                        Fradizela;234;120;114;223;111;112;107;0;86;218;218;0;0;218
87102000;6;40715;                        Franco;244;120;124;238;118;120;109;0;83;165;165;0;0;165
87113000;6;40716;                        Frechas;929;444;485;888;421;467;357;1;303;530;530;0;2;526
87137000;6;40717;                        Freixeda;89;43;46;87;41;46;39;0;28;80;80;0;0;78
87147000;6;40718;                        Lamas de Orelhão;394;190;204;373;181;192;149;0;123;231;229;2;0;229
87161000;6;40719;                        Marmelos;145;66;79;141;64;77;63;0;43;142;142;0;0;142
87173000;6;40720;                        Mascarenhas;550;243;307;529;234;295;232;0;181;471;471;0;0;471
87188000;6;40721;                        Mirandela;11852;5620;6232;11721;5542;6179;4399;6;3628;6440;6431;9;16;3217
87438000;6;40722;                        Múrias;281;137;144;242;113;129;128;0;102;213;210;3;0;210
87452000;6;40723;                        Navalho;96;45;51;89;40;49;33;0;29;47;47;0;0;47
87461000;6;40724;                        Passos;423;210;213;396;196;200;167;0;137;239;239;0;0;238
87472000;6;40725;                        Pereira;190;64;126;155;59;96;55;1;43;90;90;0;1;91
87480000;6;40726;                        Romeu;280;126;154;282;128;154;100;1;82;157;157;0;1;156
87495000;6;40727;                        São Pedro Velho;329;154;175;320;151;169;145;0;106;278;278;0;0;277
87508000;6;40728;                        São Salvador;223;109;114;221;107;114;99;0;67;171;171;0;0;169
87518000;6;40729;                        Suçães;574;270;304;559;261;298;242;1;181;422;422;0;1;422
87533000;6;40730;                        Torre de Dona Chama;1105;504;601;1046;479;567;468;1;344;817;817;0;5;779
87566000;6;40731;                        Vale de Asnes;271;134;137;269;133;136;110;0;85;189;189;0;0;187
87579000;6;40732;                        Vale de Gouvinhas;319;154;165;309;148;161;136;0;106;286;286;0;0;286
87594000;6;40733;                        Vale de Salgueiro;424;209;215;427;211;216;164;1;126;254;254;0;1;254
87606000;6;40734;                        Vale de Telhas;283;132;151;276;128;148;124;0;91;216;216;0;0;215
87616000;6;40735;                        Valverde;144;71;73;140;68;72;51;0;45;76;76;0;0;76
87625000;6;40736;                        Vila Boa;90;44;46;92;46;46;43;0;31;83;83;0;0;83
87633000;6;40737;                        Vila Verde;81;40;41;79;40;39;28;0;25;64;64;0;0;64
87641000;5;408;                    Mogadouro;9542;4699;4843;9205;4544;4661;3939;5;3065;7182;7182;0;22;6712
87642000;6;40801;                        Azinhoso;307;152;155;304;150;154;136;0;108;237;237;0;0;236
87671000;6;40802;                        Bemposta;602;295;307;581;288;293;245;1;182;556;556;0;3;554
87724000;6;40803;                        Bruçó;211;102;109;203;97;106;103;1;65;195;195;0;1;196
87739000;6;40804;                        Brunhoso;216;107;109;211;105;106;80;0;63;206;206;0;0;206
87768000;6;40805;                        Brunhozinho;86;42;44;83;41;42;42;0;29;84;84;0;0;84
87782000;6;40806;                        Castanheira;77;42;35;76;41;35;34;0;24;49;49;0;0;49
87793000;6;40807;                        Castelo Branco;449;210;239;448;208;240;220;0;153;383;383;0;1;384
87844000;6;40808;                        Castro Vicente;337;162;175;323;152;171;138;0;108;238;238;0;0;237
87883000;6;40809;                        Meirinhos;287;141;146;278;139;139;120;0;96;255;255;0;0;255
87908000;6;40810;                        Mogadouro;3549;1752;1797;3365;1667;1698;1309;2;1110;2115;2115;0;14;1659
88039000;6;40811;                        Paradela;156;77;79;153;74;79;63;0;52;100;100;0;0;100
88053000;6;40812;                        Penas Roias;382;181;201;371;177;194;152;0;132;263;263;0;0;263
88111000;6;40813;                        Peredo da Bemposta;188;100;88;185;98;87;88;0;69;172;172;0;0;171
88139000;6;40814;                        Remondes;212;102;110;217;108;109;90;0;68;157;157;0;0;157
88155000;6;40815;                        Saldanha;165;79;86;165;79;86;80;0;50;143;143;0;0;143
88177000;6;40816;                        Sanhoane;126;67;59;123;65;58;51;0;43;85;85;0;0;85
88193000;6;40817;                        São Martinho do Peso;355;180;175;351;180;171;160;0;118;293;293;0;0;293
88234000;6;40818;                        Soutelo;129;63;66;121;61;60;58;0;38;94;94;0;0;93
88250000;6;40819;                        Tó;154;74;80;143;70;73;64;0;49;155;155;0;0;152
88271000;6;40820;                        Travanca;172;88;84;167;86;81;83;0;58;124;124;0;1;124
88299000;6;40821;                        Urrós;318;151;167;306;144;162;148;1;105;278;278;0;2;277
88351000;6;40822;                        Vale da Madre;156;85;71;156;86;70;62;0;53;109;109;0;0;109
88374000;6;40823;                        Vale de Porco;133;60;73;129;58;71;52;0;43;123;123;0;0;120
88397000;6;40824;                        Valverde;133;66;67;131;65;66;66;0;44;170;170;0;0;169
88413000;6;40825;                        Ventozelo;146;75;71;141;72;69;72;0;48;149;149;0;0;149
88439000;6;40826;                        Vila de Ala;234;119;115;214;109;105;105;0;73;203;203;0;0;202
88477000;6;40827;                        Vilar de Rei;72;36;36;70;35;35;33;0;21;73;73;0;0;73
88490000;6;40828;                        Vilarinho dos Galegos;190;91;99;190;89;101;85;0;63;173;173;0;0;172
88515000;5;411;                    Vimioso;4669;2283;2386;4523;2215;2308;1962;8;1441;4619;4619;0;15;4491
88516000;6;41101;                        Algoso;281;135;146;273;131;142;115;1;89;271;271;0;2;273
88547000;6;41102;                        Angueira;116;56;60;109;50;59;55;0;39;119;119;0;0;119
88568000;6;41103;                        Argozelo;701;351;350;680;341;339;265;1;210;894;894;0;1;816
88615000;6;41104;                        Avelanoso;148;72;76;164;81;83;56;1;39;203;203;0;1;204
88641000;6;41105;                        Caçarelhos;219;115;104;214;110;104;101;0;75;182;182;0;1;182
88667000;6;41106;                        Campo de Víboras;155;71;84;147;68;79;78;0;54;209;209;0;0;208
88687000;6;41107;                        Carção;419;198;221;406;193;213;170;1;120;487;487;0;1;488
88714000;6;41108;                        Matela;228;110;118;232;112;120;126;0;69;254;254;0;0;248
88748000;6;41109;                        Pinelo;222;105;117;205;95;110;99;1;65;226;226;0;1;224
88777000;6;41110;                        Santulhão;423;213;210;418;212;206;198;1;135;421;421;0;1;419
88802000;6;41111;                        Uva;131;62;69;128;63;65;65;0;47;145;145;0;0;144
88823000;6;41112;                        Vale de Frades;160;80;80;158;81;77;83;0;58;241;241;0;0;241
88858000;6;41113;                        Vilar Seco;181;96;85;173;92;81;76;0;60;134;134;0;1;135
88870000;6;41114;                        Vimioso;1285;619;666;1216;586;630;475;2;381;833;833;0;6;790
88926000;5;412;                    Vinhais;9066;4485;4581;8826;4384;4442;3769;6;2829;6986;6985;1;26;6736
88927000;6;41201;                        Agrochão;280;146;134;261;137;124;120;1;88;238;238;0;1;238
88955000;6;41202;                        Alvaredos;62;29;33;62;29;33;32;0;21;52;52;0;0;52
88961000;6;41203;                        Candedo;331;166;165;321;163;158;137;0;109;218;218;0;1;219
88992000;6;41204;                        Celas;269;144;125;289;154;135;108;0;82;260;260;0;2;261
89023000;6;41205;                        Curopos;212;95;117;204;90;114;94;0;67;171;171;0;0;169
89050000;6;41206;                        Edral;198;94;104;198;94;104;88;0;66;185;185;0;0;185
89081000;6;41207;                        Edrosa;151;75;76;150;75;75;63;0;49;130;130;0;0;130
89108000;6;41208;                        Ervedosa;376;178;198;363;171;192;159;1;118;300;300;0;1;301
89140000;6;41209;                        Fresulfe;83;36;47;80;36;44;37;0;27;74;74;0;2;76
89154000;6;41210;                        Mofreita;54;27;27;54;27;27;23;0;17;51;51;0;0;51
89168000;6;41211;                        Moimenta;168;90;78;159;86;73;60;1;45;141;141;0;2;141
89188000;6;41212;                        Montouto;110;53;57;108;51;57;51;0;29;108;108;0;4;112
89215000;6;41213;                        Nunes;134;64;70;133;63;70;55;0;47;100;100;0;0;100
89229000;6;41214;                        Ousilhão;123;56;67;120;55;65;56;0;42;83;83;0;0;83
89247000;6;41215;                        Paçó;191;96;95;188;95;93;83;0;56;128;128;0;0;126
89270000;6;41216;                        Penhas Juntas;255;128;127;252;127;125;99;0;65;218;218;0;0;217
89300000;6;41217;                        Pinheiro Novo;106;52;54;106;52;54;51;0;38;119;119;0;0;112
89328000;6;41218;                        Quirás;180;101;79;178;100;78;85;0;56;175;175;0;0;175
89376000;6;41219;                        Rebordelo;618;323;295;586;299;287;239;1;195;431;431;0;2;430
89418000;6;41220;                        Santa Cruz;57;25;32;52;23;29;29;0;17;59;59;0;0;58
89430000;6;41221;                        Santalha;254;129;125;246;124;122;114;0;77;245;245;0;0;245
89468000;6;41222;                        São Jomil;38;22;16;38;22;16;22;0;12;52;52;0;0;52
89480000;6;41223;                        Sobreiro de Baixo;307;155;152;302;155;147;114;0;95;171;170;1;0;171
89522000;6;41224;                        Soeira;87;41;46;84;39;45;43;0;28;92;92;0;0;92
89537000;6;41225;                        Travanca;114;57;57;105;52;53;41;0;35;58;58;0;3;61
89551000;6;41226;                        Tuizelo;387;193;194;376;188;188;184;0;129;303;303;0;0;303
89628000;6;41227;                        Vale das Fontes;347;178;169;344;177;167;151;0;117;272;272;0;0;271
89658000;6;41228;                        Vale de Janeiro;101;54;47;96;52;44;45;0;32;114;114;0;0;114
89676000;6;41229;                        Vila Boa de Ousilhão;184;98;86;179;95;84;74;1;52;130;130;0;1;131
89689000;6;41230;                        Vila Verde;186;91;95;180;90;90;81;0;58;151;151;0;1;151
89709000;6;41231;                        Vilar de Lomba;199;103;96;243;126;117;78;0;62;120;120;0;0;119
89730000;6;41232;                        Vilar de Ossos;269;131;138;246;124;122;108;0;82;243;243;0;0;243
89763000;6;41233;                        Vilar de Peregrinos;155;79;76;152;77;75;71;0;46;120;120;0;0;120
89783000;6;41234;                        Vilar Seco de Lomba;235;112;123;223;107;116;107;0;79;218;218;0;0;218
89826000;6;41235;                        Vinhais;2245;1064;1181;2148;1029;1119;867;1;691;1456;1456;0;6;1209
89921000;5;1702;                    Boticas;5750;2779;2971;5676;2754;2922;2300;4;1776;4631;4631;0;10;4548
89922000;6;170201;                        Alturas do Barroso;399;190;209;395;193;202;161;0;116;327;327;0;0;327
89965000;6;170202;                        Ardãos;249;136;113;245;134;111;120;0;76;270;270;0;0;270
89995000;6;170203;                        Beça;843;415;428;826;405;421;323;0;269;713;713;0;1;713
90051000;6;170204;                        Bobadela;330;151;179;333;153;180;138;0;108;282;282;0;0;282
90097000;6;170205;                        Boticas;1280;611;669;1249;598;651;441;4;371;749;749;0;6;683
90166000;6;170206;                        Cerdedo;145;69;76;141;68;73;55;0;42;98;98;0;0;97
90188000;6;170207;                        Codessoso;132;59;73;131;58;73;56;0;42;146;146;0;1;147
90206000;6;170208;                        Covas do Barroso;262;119;143;253;115;138;122;0;74;233;233;0;0;233
90230000;6;170209;                        Curros;67;33;34;67;33;34;23;0;21;62;62;0;0;62
90250000;6;170210;                        Dornelas;338;155;183;376;176;200;158;0;109;341;341;0;0;329
90301000;6;170211;                        Fiães do Tâmega;99;44;55;91;42;49;40;0;29;110;110;0;0;109
90315000;6;170212;                        Granja;230;117;113;224;113;111;94;0;79;179;179;0;1;180
90341000;6;170213;                        Pinho;401;192;209;392;187;205;172;0;130;361;361;0;0;358
90379000;6;170214;                        São Salvador de Viveiro;293;151;142;280;144;136;122;0;91;206;206;0;0;206
90407000;6;170215;                        Sapiãos;488;238;250;481;237;244;195;0;158;412;412;0;0;412
90460000;6;170216;                        Vilar;194;99;95;192;98;94;80;0;61;142;142;0;1;140
90480000;5;1703;                    Chaves;41243;19738;21505;39595;18805;20790;16163;22;12842;28318;28313;5;66;22603
90481000;6;170301;                        Águas Frias;746;361;385;723;351;372;298;0;235;557;557;0;0;556
90555000;6;170302;                        Anelhe;476;235;241;463;230;233;172;0;143;331;331;0;0;329
90579000;6;170303;                        Arcossó;323;156;167;314;150;164;132;0;101;268;268;0;1;268
90595000;6;170304;                        Bobadela;105;52;53;96;47;49;50;0;35;101;101;0;0;101
90608000;6;170305;                        Bustelo;519;261;258;489;242;247;204;0;159;397;396;1;0;390
90629000;6;170306;                        Calvão;353;159;194;348;156;192;159;1;107;429;429;0;1;427
90662000;6;170307;                        Cela;150;72;78;142;67;75;60;0;48;98;98;0;1;99
90674000;6;170309;                        Cimo de Vila da Castanheira;479;230;249;469;222;247;206;0;148;403;403;0;0;403
90714000;6;170310;                        Curalha;469;229;240;444;215;229;170;0;138;256;256;0;0;256
90743000;6;170311;                        Eiras;540;266;274;503;244;259;205;0;173;358;358;0;0;357
90780000;6;170312;                        Ervededo;646;328;318;628;319;309;270;1;208;662;662;0;1;662
90828000;6;170313;                        Faiões;873;424;449;855;418;437;326;0;263;472;472;0;0;457
90868000;6;170314;                        Lama de Arcos;316;146;170;313;146;167;135;0;107;298;298;0;0;298
90896000;6;170315;                        Loivos;553;261;292;545;258;287;219;1;176;450;450;0;1;450
90930000;6;170316;                        Mairos;344;154;190;338;149;189;135;1;90;235;235;0;1;235
90957000;6;170317;                        Moreiras;273;136;137;273;135;138;117;0;86;242;242;0;1;243
90982000;6;170318;                        Nogueira da Montanha;529;276;253;533;278;255;217;0;169;391;391;0;0;390
91052000;6;170319;                        Oucidres;194;97;97;192;95;97;81;0;68;184;184;0;0;184
91075000;6;170320;                        Oura;602;294;308;593;287;306;248;0;195;455;455;0;0;453
91106000;6;170321;                        Outeiro Seco;938;450;488;894;429;465;352;0;299;515;514;1;0;473
91144000;6;170322;                        Paradela;262;130;132;253;125;128;107;0;85;168;168;0;0;168
91159000;6;170323;                        Póvoa de Agrações;186;97;89;187;97;90;95;0;60;201;201;0;0;201
91188000;6;170324;                        Redondelo;527;278;249;538;284;254;197;0;168;355;355;0;3;352
91224000;6;170325;                        Roriz;164;73;91;162;70;92;71;0;56;162;162;0;0;162
91247000;6;170326;                        Samaiões;1318;634;684;1284;608;676;491;1;430;784;784;0;3;694
91304000;6;170327;                        Sanfins;236;105;131;242;105;137;104;0;72;286;286;0;0;285
91340000;6;170328;                        Sanjurge;334;166;168;328;167;161;131;0;101;263;263;0;0;261
91364000;6;170329;                        Santa Leocádia;324;148;176;326;149;177;142;0;112;264;262;2;1;263
91413000;6;170330;                        Santo António de Monforte;454;225;229;426;211;215;175;0;141;300;300;0;0;298
91435000;6;170331;                        Santo Estêvão;607;291;316;599;285;314;229;1;188;380;380;0;2;379
91467000;6;170332;                        São Julião de Montenegro;280;133;147;278;133;145;117;0;83;224;224;0;0;224
91490000;6;170333;                        São Pedro de Agostém;1419;684;735;1345;637;708;517;0;442;902;902;0;3;893
91601000;6;170334;                        São Vicente;227;115;112;242;125;117;114;0;75;313;313;0;0;313
91638000;6;170335;                        Seara Velha;165;81;84;165;81;84;70;0;49;144;144;0;0;144
91656000;6;170336;                        Selhariz;244;115;129;229;106;123;93;0;78;197;197;0;1;196
91678000;6;170337;                        Soutelinho da Raia;150;75;75;135;67;68;72;0;49;153;153;0;0;153
91701000;6;170338;                        Soutelo;350;172;178;327;156;171;138;0;112;239;239;0;0;239
91727000;6;170339;                        Travancas;402;179;223;377;167;210;162;1;117;317;317;0;1;318
91771000;6;170340;                        Tronco;218;105;113;287;140;147;104;0;72;232;232;0;0;221
91794000;6;170341;                        Vale de Anta;1543;772;771;1512;743;769;518;3;461;777;777;0;6;697
91854000;6;170342;                        Vidago;1204;570;634;1094;512;582;434;1;346;755;755;0;6;627
91901000;6;170343;                        Vila Verde da Raia;993;464;529;928;433;495;378;0;306;556;556;0;0;551
91946000;6;170344;                        Vilar de Nantes;2084;970;1114;1983;915;1068;762;2;644;1154;1154;0;5;892
92005000;6;170345;                        Vilarelho da Raia;558;265;293;556;261;295;252;1;180;518;518;0;1;516
92046000;6;170346;                        Vilarinho das Paranheiras;220;104;116;216;103;113;82;0;67;148;148;0;0;147
92063000;6;170347;                        Vilas Boas;195;99;96;188;96;92;84;0;57;152;152;0;1;153
92086000;6;170348;                        Vilela Seca;276;143;133;260;133;127;120;0;93;288;288;0;0;288
92107000;6;170349;                        Vilela do Tâmega;409;202;207;390;190;200;159;0;131;306;306;0;1;304
92145000;6;170350;                        Santa Maria Maior;11788;5470;6318;11104;5093;6011;4724;6;3605;7710;7710;0;19;3335
92376000;6;170351;                        Madalena;1582;760;822;1539;742;797;615;2;510;1140;1140;0;6;809
92423000;6;170352;                        Santa Cruz/Trindade;3096;1526;1570;2940;1433;1507;1150;0;1004;1828;1827;1;0;1489
92508000;5;1706;                    Montalegre;10537;5096;5441;10240;4960;5280;4232;4;3161;10521;10521;0;34;10157
92509000;6;170601;                        Cabril;553;265;288;518;251;267;212;1;158;439;439;0;1;433
92566000;6;170602;                        Cambeses do Rio;130;58;72;129;58;71;59;0;42;154;154;0;0;154
92589000;6;170603;                        Cervos;271;137;134;268;137;131;107;0;77;280;280;0;0;280
92623000;6;170604;                        Chã;748;366;382;752;371;381;293;0;230;742;742;0;10;751
92751000;6;170605;                        Contim;87;43;44;79;40;39;40;0;29;139;139;0;0;139
92775000;6;170606;                        Covelães;135;69;66;121;63;58;63;0;44;170;170;0;1;169
92804000;6;170607;                        Covelo do Gerês;194;99;95;187;95;92;73;0;56;165;165;0;0;165
92829000;6;170608;                        Donões;62;30;32;60;28;32;27;0;19;90;90;0;0;90
92854000;6;170609;                        Ferral;397;188;209;387;182;205;163;0;121;357;357;0;0;349
92911000;6;170610;                        Fervidelas;87;42;45;86;41;45;31;0;24;137;137;0;0;136
92931000;6;170611;                        Fiães do Rio;76;36;40;75;34;41;33;0;23;120;120;0;0;120
92954000;6;170612;                        Gralhas;208;98;110;227;109;118;112;0;73;353;353;0;0;353
92988000;6;170613;                        Meixedo;209;104;105;203;102;101;97;0;64;346;346;0;0;345
93032000;6;170614;                        Meixide;88;47;41;80;42;38;41;0;27;97;97;0;0;97
93052000;6;170615;                        Montalegre;1816;856;960;1739;812;927;646;1;537;1225;1225;0;6;993
93163000;6;170616;                        Morgade;228;113;115;230;114;116;94;0;70;201;201;0;0;201
93199000;6;170617;                        Mourilhe;117;58;59;118;58;60;50;0;35;184;184;0;1;185
93227000;6;170618;                        Negrões;177;80;97;173;78;95;70;0;57;174;174;0;0;172
93270000;6;170619;                        Outeiro;156;82;74;150;78;72;61;0;50;134;134;0;1;132
93300000;6;170620;                        Padornelos;124;57;67;102;43;59;52;0;38;203;203;0;0;203
93350000;6;170621;                        Padroso;107;48;59;90;42;48;45;0;33;108;108;0;0;108
93371000;6;170622;                        Paradela;145;66;79;134;61;73;63;0;40;148;148;0;2;150
93414000;6;170623;                        Pitões das Junias;161;67;94;145;62;83;68;0;48;210;210;0;2;206
93444000;6;170624;                        Pondras;131;58;73;128;57;71;55;0;41;196;196;0;0;195
93476000;6;170625;                        Reigoso;167;75;92;171;77;94;81;0;55;232;232;0;0;230
93505000;6;170626;                        Salto;1429;691;738;1424;696;728;543;1;418;1117;1117;0;2;1008
93654000;6;170627;                        Santo André;218;113;105;212;113;99;98;0;72;245;245;0;0;244
93674000;6;170628;                        Vilar de Perdizes (São Miguel);460;240;220;452;237;215;206;0;142;467;467;0;0;466
93718000;6;170629;                        Sarraquinhos;294;140;154;293;141;152;116;0;85;334;334;0;0;334
93767000;6;170630;                        Sezelhe;142;63;79;133;58;75;61;0;38;161;161;0;0;160
93796000;6;170631;                        Solveira;154;73;81;155;73;82;69;0;52;269;269;0;0;269
93838000;6;170632;                        Tourém;151;74;77;131;63;68;63;0;48;238;238;0;1;237
93854000;6;170633;                        Venda Nova;262;121;141;248;114;134;114;0;80;327;327;0;1;325
93894000;6;170634;                        Viade de Baixo;675;347;328;664;339;325;252;1;183;620;620;0;4;618
93977000;6;170635;                        Vila da Ponte;178;92;86;176;91;85;74;0;52;139;139;0;2;140
94004000;5;1707;                    Murça;5952;2900;3052;5788;2798;2990;2306;4;1825;4129;4129;0;12;3985
94005000;6;170701;                        Candedo;1002;497;505;976;479;497;407;1;303;748;748;0;1;745
94098000;6;170702;                        Carva;269;129;140;257;122;135;103;0;88;241;241;0;0;239
94139000;6;170703;                        Fiolhoso;452;220;232;497;239;258;179;1;133;467;467;0;2;468
94212000;6;170704;                        Jou;654;328;326;618;311;307;266;0;208;472;472;0;0;470
94265000;6;170705;                        Murça;2136;1021;1115;2074;982;1092;773;2;653;1137;1137;0;8;1005
94335000;6;170706;                        Noura;575;287;288;548;269;279;219;0;172;365;365;0;1;361
94359000;6;170707;                        Palheiros;332;151;181;301;136;165;134;0;98;239;239;0;0;237
94383000;6;170708;                        Valongo de Milhais;329;162;167;318;157;161;139;0;110;272;272;0;0;272
94425000;6;170709;                        Vilares;203;105;98;199;103;96;86;0;60;188;188;0;0;188
94447000;5;1712;                    Valpaços;16882;7975;8907;16516;7791;8725;6900;12;5299;13251;13245;6;21;12035
94448000;6;171201;                        Água Revés e Crasto;342;165;177;341;164;177;144;0;112;274;274;0;0;274
94476000;6;171202;                        Alvarelhos;137;59;78;185;79;106;59;0;48;121;121;0;0;121
94496000;6;171203;                        Algeriz;570;274;296;556;265;291;237;1;181;406;405;1;1;404
94542000;6;171204;                        Barreiros;177;89;88;175;90;85;74;0;53;136;136;0;0;136
94556000;6;171205;                        Bouçoães;419;189;230;473;213;260;185;0;136;344;344;0;0;343
94598000;6;171206;                        Canaveses;237;109;128;222;104;118;113;0;73;155;155;0;1;156
94617000;6;171207;                        Carrazedo de Montenegro;1620;787;833;1568;759;809;651;1;529;1159;1159;0;1;1005
94707000;6;171208;                        Curros;160;78;82;144;70;74;69;0;50;142;142;0;0;142
94720000;6;171209;                        Ervões;636;312;324;610;297;313;274;0;197;498;498;0;0;498
94769000;6;171210;                        Fiães;111;51;60;107;48;59;50;0;41;100;100;0;0;100
94783000;6;171211;                        Fornos do Pinhal;320;147;173;312;143;169;131;0;99;206;205;1;0;206
94806000;6;171212;                        Friões;619;289;330;613;287;326;288;1;187;560;560;0;2;562
94874000;6;171213;                        Lebução;562;277;285;560;277;283;206;1;173;432;432;0;1;433
94909000;6;171214;                        Nozelos;111;52;59;113;54;59;54;0;39;137;137;0;0;137
94927000;6;171215;                        Padrela e Tazem;359;164;195;354;161;193;154;0;120;343;343;0;0;343
94955000;6;171216;                        Possacos;446;211;235;429;201;228;184;0;136;343;343;0;1;344
94976000;6;171217;                        Rio Torto;362;161;201;346;156;190;169;0;113;300;300;0;0;300
95010000;6;171218;                        Sanfins;213;99;114;267;134;133;90;0;68;168;168;0;0;166
95026000;6;171219;                        Santa Maria de Emeres;406;189;217;393;183;210;175;0;129;319;319;0;1;320
95051000;6;171220;                        Santa Valha;415;198;217;406;193;213;180;0;133;323;323;0;0;323
95087000;6;171221;                        Santiago da Ribeira de Alhariz;603;288;315;593;281;312;265;0;198;602;602;0;0;602
95146000;6;171222;                        São João da Corveira;537;247;290;505;231;274;230;0;170;491;491;0;0;490
95209000;6;171223;                        São Pedro de Veiga de Lila;304;149;155;303;152;151;132;0;107;217;217;0;0;217
95228000;6;171224;                        Serapicos;246;121;125;235;114;121;103;0;77;182;182;0;0;182
95259000;6;171225;                        Sonim;273;134;139;279;139;140;118;0;91;237;237;0;0;236
95281000;6;171226;                        Tinhela;196;94;102;198;94;104;90;0;59;258;258;0;0;255
95305000;6;171227;                        Vales;257;131;126;237;122;115;118;0;78;214;214;0;0;214
95332000;6;171228;                        Valpaços;4539;2116;2423;4367;2023;2344;1679;4;1372;3273;3269;4;7;2235
95501000;6;171229;                        Vassal;460;209;251;437;201;236;184;1;138;360;360;0;2;362
95525000;6;171230;                        Veiga de Lila;261;127;134;252;126;126;103;0;88;203;203;0;1;199
95547000;6;171231;                        Vilarandelo;984;459;525;936;430;506;391;3;304;748;748;0;3;730
95608000;5;1713;                    Vila Pouca de Aguiar;13187;6362;6825;12799;6167;6632;5188;2;4186;10031;10027;4;15;9268
95609000;6;171301;                        Afonsim;183;90;93;182;91;91;76;0;58;188;188;0;0;188
95629000;6;171302;                        Alfarela de Jales;401;204;197;408;209;199;166;0;122;351;351;0;0;347
95677000;6;171303;                        Bornes de Aguiar;2057;1004;1053;1959;957;1002;790;1;655;1496;1494;2;4;1371
95770000;6;171304;                        Bragado;544;251;293;520;245;275;229;0;182;480;479;1;0;477
95805000;6;171305;                        Capeludos;440;200;240;432;199;233;199;0;136;438;438;0;0;437
95851000;6;171306;                        Gouvães da Serra;133;61;72;121;57;64;52;0;45;108;108;0;0;108
95875000;6;171307;                        Parada de Monteiros;72;30;42;72;30;42;37;0;22;94;94;0;0;94
95886000;6;171308;                        Pensalvos;278;127;151;276;128;148;125;0;96;281;281;0;0;278
95914000;6;171309;                        Santa Marta da Montanha;135;69;66;133;69;64;58;0;46;130;130;0;0;130
95932000;6;171310;                        Soutelo de Aguiar;638;296;342;607;280;327;236;0;202;513;513;0;0;506
95979000;6;171311;                        Telões;1485;723;762;1431;691;740;550;0;461;1009;1009;0;2;1006
96060000;6;171312;                        Tresminas;415;196;219;409;194;215;181;0;139;370;370;0;0;370
96099000;6;171313;                        Valoura;376;186;190;376;186;190;163;0;125;328;328;0;0;328
96113000;6;171314;                        Vila Pouca de Aguiar;3303;1577;1726;3183;1505;1678;1233;1;1040;2065;2064;1;9;1482
96212000;6;171315;                        Vreia de Bornes;652;321;331;639;315;324;259;0;208;517;517;0;0;516
96237000;6;171316;                        Vreia de Jales;967;471;496;988;478;510;398;0;301;877;877;0;0;863
96291000;6;171317;                        Sabroso de Aguiar;684;344;340;658;328;330;273;0;212;477;477;0;0;460
96319000;6;171318;                        Lixa do Alvão;424;212;212;405;205;200;163;0;136;309;309;0;0;307
