ordem,nivel,cod_dim2,Zona Geográfica,População residente - Total,População residente - H,População residente - M,População presente - Total,População presente - H,População presente - M,Famílias - Clássicas ,Famílias - Institucionais,Núcleos familiares ,Alojamentos familiares - Total ,Alojamentos familiares - Clássicos,Alojamentos familiares - Não clássicos,Alojamentos colectivos,Edifícios clássicos
96349000,6,10101,Agadão,373,173,200,368,169,199,146,0,123,207,207,0,0,204
96374000,6,10102,Aguada de Baixo,1373,643,730,1322,611,711,478,1,431,622,622,0,3,574
96430000,6,10103,Aguada de Cima,4013,1943,2070,3806,1820,1986,1455,1,1265,2018,2014,4,2,1653
96580000,6,10104,Águeda,11346,5393,5953,11106,5217,5889,4382,5,3566,5860,5855,5,12,3485
96888000,6,10105,Barrô,1836,873,963,1792,851,941,653,1,596,842,840,2,1,784
96944000,6,10106,Belazaima do Chão,599,277,322,587,270,317,216,1,194,265,263,2,1,258
96984000,6,10107,Castanheira do Vouga,639,292,347,621,283,338,229,0,197,313,313,0,0,308
97035000,6,10108,Espinhel,2482,1204,1278,2368,1149,1219,869,0,788,1067,1065,2,1,1026
97139000,6,10109,Fermentelos,3258,1599,1659,3148,1542,1606,1169,1,1043,1463,1463,0,3,1308
97204000,6,10110,Lamas do Vouga,729,352,377,691,327,364,250,0,226,318,316,2,0,302
97229000,6,10111,Macieira de Alcoba,84,38,46,82,38,44,39,0,29,83,83,0,1,84
97248000,6,10112,Macinhata do Vouga,3406,1634,1772,3310,1578,1732,1279,1,1094,1727,1727,0,2,1644
97421000,6,10113,Óis da Ribeira,716,347,369,691,335,356,251,0,227,309,309,0,0,287
97440000,6,10114,Préstimo,724,350,374,710,341,369,264,0,234,412,411,1,0,410
97507000,6,10115,Recardães,3554,1720,1834,3354,1603,1751,1321,3,1158,1686,1686,0,3,1282
97611000,6,10116,Segadães,1169,567,602,1120,540,580,404,0,375,500,500,0,0,440
97646000,6,10117,Travassô,1589,754,835,1502,706,796,561,2,507,726,725,1,2,682
97702000,6,10118,Trofa,2732,1314,1418,2678,1263,1415,996,1,867,1202,1202,0,3,947
97775000,6,10119,Valongo do Vouga,4877,2351,2526,4615,2208,2407,1685,2,1560,2156,2155,1,2,2051
97937000,6,10120,Borralha,2230,1067,1163,2150,1025,1125,806,1,713,1045,1045,0,1,843
98022000,6,10201,Albergaria-a-Velha,8528,4093,4435,8046,3793,4253,3210,3,2648,4414,4412,2,6,2615
98277000,6,10202,Alquerubim,2381,1142,1239,2362,1122,1240,866,1,744,1082,1074,8,1,1041
98380000,6,10203,Angeja,2073,1003,1070,2011,966,1045,756,0,649,979,979,0,0,944
98456000,6,10204,Branca,5621,2753,2868,5456,2658,2798,1965,6,1762,2559,2558,1,6,2417
98658000,6,10205,Frossos,887,434,453,848,415,433,333,0,286,483,481,2,1,444
98692000,6,10206,Ribeira de Fráguas,1713,832,881,1633,779,854,613,1,532,753,753,0,1,746
98790000,6,10207,São João de Loure,2009,973,1036,1964,941,1023,734,1,642,970,962,8,1,934
98880000,6,10208,Valmaior,2040,1000,1040,1941,946,995,764,0,659,1075,1075,0,0,999
98977000,6,10301,Amoreira da Gândara,1057,513,544,1023,494,529,409,1,351,578,577,1,1,572
99034000,6,10302,Ancas,624,296,328,606,285,321,241,0,204,327,326,1,0,315
99057000,6,10303,Arcos,5511,2609,2902,5361,2529,2832,2034,9,1684,2776,2775,1,12,1784
99180000,6,10304,Avelãs de Caminho,1252,631,621,1227,621,606,451,1,401,621,621,0,1,555
99215000,6,10305,Avelãs de Cima,2185,1080,1105,2113,1041,1072,764,3,657,978,977,1,3,957
99324000,6,10306,Mogofores,820,398,422,808,393,415,322,2,256,461,461,0,3,392
99348000,6,10307,Moita,2484,1200,1284,2409,1159,1250,899,1,792,1216,1215,1,1,1168
99471000,6,10308,Óis do Bairro,491,233,258,476,229,247,210,0,155,434,434,0,1,219
99492000,6,10309,Sangalhos,4068,1928,2140,3909,1835,2074,1509,4,1270,1963,1959,4,8,1644
99610000,6,10310,São Lourenço do Bairro,2414,1155,1259,2292,1083,1209,906,0,769,1253,1252,1,0,1231
99710000,6,10311,Tamengos,1602,755,847,1534,713,821,603,1,515,882,881,1,5,710
99760000,6,10312,Vila Nova de Monsarros,1713,827,886,1643,776,867,641,1,555,859,857,2,1,824
99826000,6,10313,Vilarinho do Bairro,2764,1322,1442,2682,1271,1411,1049,3,882,1583,1582,1,3,1566
99974000,6,10314,Paredes do Bairro,994,466,528,966,449,517,372,0,318,491,491,0,0,485
100008000,6,10315,Aguim,1171,554,617,1115,524,591,443,1,355,589,588,1,3,555
100055000,6,10501,Aradas,9157,4359,4798,9521,4540,4981,3791,4,2857,4888,4887,1,7,2917
100242000,6,10502,Cacia,7354,3599,3755,7059,3424,3635,2630,0,2345,3180,3139,41,2,2744
100353000,6,10503,Eirol,753,375,378,724,359,365,272,0,240,342,341,1,0,337
100379000,6,10504,Eixo,5571,2669,2902,5284,2489,2795,2045,3,1748,2523,2519,4,3,1778
100473000,6,10505,Esgueira,13431,6405,7026,12772,6023,6749,5216,6,4165,6422,6414,8,7,3258
100646000,6,10506,Glória,9099,4212,4887,12561,5925,6636,4135,12,2660,6219,6207,12,45,1630
100810000,6,10507,Nariz,1418,677,741,1356,640,716,501,0,442,656,656,0,0,632
100849000,6,10508,Oliveirinha,4817,2247,2570,4633,2137,2496,1714,5,1468,2132,2127,5,4,1937
100954000,6,10509,Requeixo,1222,610,612,1150,577,573,445,0,386,563,560,3,0,542
100992000,6,10510,São Bernardo,4960,2352,2608,4715,2206,2509,1875,7,1553,2273,2268,5,7,1503
101053000,6,10511,São Jacinto,993,486,507,896,438,458,388,0,323,637,637,0,1,520
101112000,6,10512,Vera Cruz,9657,4370,5287,9271,4158,5113,4434,3,2859,6394,6390,4,23,1758
101284000,6,10513,Santa Joana,8094,3863,4231,7756,3679,4077,3007,5,2553,3505,3495,10,5,2473
101395000,6,10514,Nossa Senhora de Fátima,1924,896,1028,1844,853,991,689,0,606,836,835,1,0,788
101449000,6,10801,Avanca,6189,2984,3205,5968,2867,3101,2122,4,1915,2535,2517,18,6,2274
101669000,6,10802,Beduído,7544,3605,3939,7179,3399,3780,2752,1,2376,3632,3632,0,7,2502
101852000,6,10803,Canelas,1438,689,749,1394,661,733,505,0,439,694,694,0,0,675
101933000,6,10804,Fermelã,1332,651,681,1270,607,663,501,0,416,682,682,0,0,677
101993000,6,10805,Pardilhó,4176,2039,2137,4073,1969,2104,1473,3,1289,2125,2121,4,3,2012
102123000,6,10806,Salreu,3815,1820,1995,3709,1752,1957,1390,2,1178,1873,1871,2,3,1780
102277000,6,10807,Veiros,2503,1224,1279,2402,1155,1247,869,1,757,1287,1281,6,1,1261
102363000,6,11001,Gafanha do Carmo,1758,874,884,1718,841,877,605,1,546,921,915,6,1,881
102408000,6,11002,Gafanha da Encarnação,5487,2654,2833,5267,2503,2764,2022,1,1710,3837,3823,14,4,2514
102551000,6,11003,Gafanha da Nazaré,14756,7088,7668,13934,6548,7386,5629,2,4655,8828,8813,15,9,5152
102824000,6,11004,Ílhavo (São Salvador),16597,7791,8806,15860,7357,8503,6341,8,5152,8369,8359,10,12,6489
103090000,6,11101,Antes,933,435,498,891,411,480,326,1,287,434,434,0,2,429
103116000,6,11102,Barcouço,2152,1052,1100,2068,999,1069,803,0,681,1011,1010,1,0,956
103172000,6,11103,Casal Comba,3183,1535,1648,3110,1483,1627,1218,1,1048,1611,1610,1,6,1540
103260000,6,11104,Luso,2593,1267,1326,2646,1286,1360,1004,1,818,1365,1364,1,14,1179
103335000,6,11105,Mealhada,4522,2125,2397,4317,2012,2305,1726,2,1386,2309,2307,2,7,1327
103424000,6,11106,Pampilhosa,4098,1967,2131,3937,1871,2066,1530,1,1320,1987,1982,5,1,1613
103511000,6,11107,Vacariça,1945,942,1003,1874,889,985,713,0,639,865,863,2,1,842
103576000,6,11108,Ventosa do Bairro,1002,500,502,958,470,488,422,0,330,555,555,0,1,548
103621000,6,11201,Bunheiro,2682,1287,1395,2571,1216,1355,926,0,824,1354,1352,2,0,1321
103750000,6,11202,Monte,1459,687,772,1377,633,744,521,1,438,878,878,0,1,819
103826000,6,11203,Murtosa,3699,1746,1953,3608,1691,1917,1421,3,1110,2093,2093,0,3,1868
103958000,6,11204,Torreira,2745,1376,1369,2536,1214,1322,969,0,819,3328,3312,16,5,1837
104094000,6,11401,Bustos,2652,1253,1399,2549,1199,1350,973,1,813,1395,1395,0,2,1224
104188000,6,11402,Mamarrosa,1406,654,752,1398,649,749,511,1,436,703,701,2,2,635
104244000,6,11403,Oiã,7722,3680,4042,7494,3518,3976,2787,3,2395,3619,3610,9,5,2802
104423000,6,11404,Oliveira do Bairro,6250,2951,3299,5968,2798,3170,2347,1,1943,3141,3130,11,6,2142
104571000,6,11405,Palhaça,2627,1251,1376,2548,1204,1344,944,2,816,1234,1232,2,2,1052
104642000,6,11406,Troviscal,2371,1126,1245,2273,1078,1195,871,0,776,1215,1215,0,0,1187
104737000,6,11501,Arada,3318,1601,1717,3178,1522,1656,1085,0,1020,1367,1367,0,2,1282
104798000,6,11502,Cortegaça,3837,1841,1996,3713,1756,1957,1336,1,1195,1841,1834,7,3,1331
104876000,6,11503,Esmoriz,11448,5544,5904,11023,5303,5720,4143,1,3578,6124,6115,9,9,3426
105081000,6,11504,Maceda,3521,1727,1794,3456,1687,1769,1172,1,1097,1480,1477,3,2,1338
105147000,6,11505,Ovar,17855,8519,9336,17084,8057,9027,6587,5,5581,10409,10389,20,14,5878
105420000,6,11506,São Vicente de Pereira Jusã,2316,1114,1202,2233,1066,1167,730,4,712,911,910,1,4,866
105489000,6,11507,Válega,6827,3302,3525,6634,3191,3443,2266,0,2120,2881,2878,3,0,2590
105622000,6,11508,São João,6276,3023,3253,6013,2871,3142,2191,0,1990,2752,2748,4,0,2378
105722000,6,11701,Cedrim,834,404,430,797,380,417,305,0,259,454,453,1,0,450
105787000,6,11702,Couto de Esteves,890,430,460,825,399,426,348,0,283,567,567,0,0,557
105860000,6,11703,Paradela,720,352,368,679,329,350,244,0,218,402,402,0,0,388
105894000,6,11704,Pessegueiro do Vouga,1852,917,935,1791,867,924,666,1,576,1023,1023,0,1,998
105976000,6,11705,Rocas do Vouga,1778,851,927,1667,788,879,668,1,553,921,919,2,1,904
106034000,6,11706,Sever do Vouga,2777,1299,1478,2633,1217,1416,1063,1,868,1606,1605,1,7,1143
106130000,6,11707,Silva Escura,1592,757,835,1512,708,804,607,0,511,1012,1012,0,2,985
106222000,6,11708,Talhadas,1187,591,596,1110,549,561,417,0,366,701,701,0,0,695
106318000,6,11709,Dornelas,726,361,365,685,332,353,278,0,225,374,374,0,0,365
106358000,6,11801,Calvão,2014,1011,1003,1965,977,988,720,0,605,941,941,0,1,892
106430000,6,11802,Covão do Lobo,986,454,532,944,432,512,341,1,314,490,490,0,1,491
106497000,6,11803,Fonte de Angeão,1179,562,617,1143,537,606,442,0,347,727,727,0,0,724
106552000,6,11804,Gafanha da Boa Hora,2625,1264,1361,2542,1214,1328,1028,0,803,3018,3018,0,2,1490
106637000,6,11805,Ouca,1805,861,944,1743,820,923,641,1,547,831,831,0,2,820
106701000,6,11806,Ponte de Vagos,1790,869,921,1742,839,903,583,1,547,797,797,0,1,774
106760000,6,11807,Sosa,3069,1495,1574,3023,1461,1562,1097,0,958,1429,1410,19,0,1385
106845000,6,11808,Vagos,4606,2196,2410,4369,2063,2306,1739,2,1420,2310,2307,3,3,1672
106936000,6,11809,Santo António de Vagos,1753,816,937,1704,783,921,614,1,528,759,759,0,1,694
106984000,6,11810,Santo André de Vagos,2033,978,1055,1975,952,1023,706,0,644,948,947,1,0,923
107051000,6,11811,Santa Catarina,991,478,513,958,455,503,331,1,300,439,439,0,1,438
107098000,6,60201,Ançã,2625,1278,1347,2550,1231,1319,980,0,837,1352,1351,1,0,1315
107152000,6,60202,Bolho,848,397,451,815,378,437,318,0,271,423,423,0,0,422
107186000,6,60203,Cadima,2963,1455,1508,2802,1344,1458,1059,0,937,1450,1447,3,0,1430
107335000,6,60204,Cantanhede,7738,3636,4102,7380,3442,3938,2997,4,2387,4110,4102,8,7,3017
107548000,6,60205,Cordinhã,1034,500,534,993,472,521,402,0,330,559,559,0,0,550
107590000,6,60206,Covões,2155,993,1162,2099,968,1131,853,1,687,1310,1310,0,1,1299
107711000,6,60207,Febres,3352,1563,1789,3236,1492,1744,1269,1,1029,2006,2006,0,1,1921
107873000,6,60208,Murtede,1431,683,748,1378,652,726,559,1,455,873,873,0,1,856
107929000,6,60209,Ourentã,1208,595,613,1153,567,586,460,0,397,700,700,0,0,687
107988000,6,60210,Outil,858,420,438,828,401,427,320,0,277,430,430,0,0,424
108023000,6,60211,Pocariça,1101,530,571,1030,481,549,391,0,342,588,588,0,0,577
108080000,6,60212,Portunhos,1187,558,629,1149,538,611,412,1,352,552,551,1,1,543
108124000,6,60213,Sepins,1076,525,551,1052,510,542,422,0,354,600,598,2,0,592
108171000,6,60214,Tocha,3992,1886,2106,3895,1847,2048,1504,4,1276,2907,2905,2,12,2401
108393000,6,60215,São Caetano,801,394,407,789,381,408,317,1,241,480,480,0,1,477
108454000,6,60216,Corticeiro de Cima,721,329,392,684,311,373,269,1,216,381,380,1,1,381
108492000,6,60217,Vilamar,780,361,419,724,326,398,272,1,220,407,407,0,1,397
108522000,6,60218,Sanguinheira,1901,899,1002,1827,850,977,675,0,600,893,892,1,0,886
108644000,6,60219,Camarneira,824,392,432,787,366,421,332,1,270,521,521,0,1,520
108698000,6,60301,Almalaguês,3111,1452,1659,3004,1385,1619,1166,0,995,1528,1528,0,0,1501
108817000,6,60302,Coimbra (Almedina),904,405,499,1219,563,656,431,9,207,866,865,1,19,444
108851000,6,60303,Ameal,1682,800,882,1628,757,871,611,0,535,712,712,0,0,694
108905000,6,60304,Antanhol,2556,1259,1297,2428,1183,1245,947,0,822,1128,1128,0,0,904
108953000,6,60305,Antuzede,2276,1098,1178,2150,1025,1125,840,0,736,976,975,1,0,905
109023000,6,60306,Arzila,655,319,336,629,308,321,253,0,211,296,296,0,0,274
109048000,6,60307,Assafarge,2746,1336,1410,2631,1262,1369,962,0,868,1185,1185,0,0,1119
109130000,6,60308,Botão,1588,750,838,1549,719,830,566,0,527,730,727,3,0,720
109201000,6,60309,Brasfemes,1969,949,1020,1864,896,968,702,0,637,859,859,0,0,792
109269000,6,60310,Castelo Viegas,1695,818,877,1746,845,901,593,2,512,728,728,0,3,659
109311000,6,60311,Ceira,3701,1792,1909,3543,1702,1841,1451,0,1226,1944,1943,1,0,1656
109423000,6,60312,Cernache,4048,1922,2126,3879,1807,2072,1471,5,1242,1944,1942,2,5,1752
109574000,6,60313,Eiras,12097,5578,6519,11524,5256,6268,5041,5,3637,6462,6455,7,6,1867
109691000,6,60314,Lamarosa,2069,1003,1066,1987,949,1038,715,0,666,975,975,0,0,957
109744000,6,60315,Ribeira de Frades,1902,908,994,1852,881,971,731,1,614,890,889,1,1,785
109785000,6,60316,Santa Clara,9929,4583,5346,9739,4472,5267,4179,2,3102,5558,5556,2,7,2460
109929000,6,60317,Coimbra (Santa Cruz),5699,2544,3155,6071,2658,3413,2634,4,1604,4031,4030,1,17,1328
110022000,6,60318,Santo António dos Olivais,38936,17659,21277,43377,19646,23731,17145,22,11461,24497,24476,21,41,6525
110535000,6,60319,Coimbra (São Bartolomeu),627,252,375,812,335,477,321,3,140,620,619,1,24,299
110567000,6,60320,São João do Campo,2073,1010,1063,1970,936,1034,744,0,669,844,844,0,0,808
110604000,6,60321,São Martinho de Árvore,1033,512,521,995,487,508,345,0,334,421,420,1,0,414
110631000,6,60322,São Martinho do Bispo,14147,6618,7529,14562,6568,7994,5454,7,4440,7148,7144,4,11,4445
110829000,6,60323,São Paulo de Frades,5824,2744,3080,5601,2612,2989,2185,0,1850,2627,2625,2,0,1595
110936000,6,60324,São Silvestre,3122,1564,1558,2986,1480,1506,1074,1,1006,1271,1270,1,2,1083
111004000,6,60325,Coimbra (Sé Nova),6741,3133,3608,9870,4317,5553,3008,27,1695,5437,5435,2,62,1538
111105000,6,60326,Souselas,3092,1514,1578,2948,1420,1528,1115,2,1000,1411,1408,3,3,1313
111195000,6,60327,Taveiro,1948,923,1025,1857,866,991,734,0,621,874,872,2,0,752
111245000,6,60328,Torre de Vilela,1242,607,635,1179,567,612,437,1,387,491,491,0,1,466
111273000,6,60329,Torres do Mondego,2402,1142,1260,2337,1106,1231,952,0,793,1246,1246,0,1,1149
111362000,6,60330,Trouxemil,2712,1324,1388,2648,1276,1372,989,2,850,1178,1178,0,3,1071
111431000,6,60331,Vil de Matos,870,423,447,840,407,433,305,0,287,372,372,0,0,366
111473000,6,60401,Anobra,1316,645,671,1258,612,646,502,0,428,658,657,1,0,637
111528000,6,60402,Belide,245,116,129,237,111,126,102,0,73,134,134,0,0,121
111537000,6,60403,Bem da Fé,112,59,53,102,51,51,45,0,39,60,60,0,0,59
111547000,6,60404,Condeixa-a-Nova,5136,2262,2874,4940,2138,2802,1785,7,1474,2300,2297,3,7,1127
111646000,6,60405,Condeixa-a-Velha,3472,1670,1802,3331,1563,1768,1282,0,1094,1712,1712,0,0,1296
111751000,6,60406,Ega,2835,1335,1500,2728,1265,1463,1056,1,873,1439,1438,1,2,1392
111851000,6,60407,Furadouro,206,96,110,200,92,108,82,0,69,132,132,0,0,132
111873000,6,60408,Sebal,2478,1233,1245,2381,1162,1219,919,0,794,1184,1184,0,0,1007
111955000,6,60409,Vila Seca,876,396,480,850,375,475,332,1,269,527,526,1,1,527
111994000,6,60410,Zambujal,402,189,213,377,175,202,161,0,129,342,342,0,0,339
112020000,6,60501,Alhadas,4082,1942,2140,3920,1842,2078,1540,1,1276,2107,2104,3,1,1953
112134000,6,60502,Alqueidão,1752,843,909,1679,794,885,701,1,559,971,970,1,1,958
112192000,6,60503,Brenha,912,425,487,887,405,482,349,0,293,469,469,0,0,439
112230000,6,60504,Buarcos,8602,3999,4603,7960,3632,4328,3507,4,2681,9542,9541,1,12,3493
112456000,6,60505,Ferreira-a-Nova,1488,716,772,1391,645,746,536,0,487,650,650,0,0,631
112536000,6,60506,Lavos,3999,1882,2117,3702,1674,2028,1468,5,1257,2131,2128,3,5,2061
112674000,6,60507,Maiorca,2634,1289,1345,2523,1210,1313,999,1,835,1317,1316,1,1,1297
112764000,6,60508,Marinha das Ondas,3179,1551,1628,2965,1401,1564,1161,1,998,1605,1605,0,1,1477
112867000,6,60509,Paião,2268,1047,1221,2136,972,1164,834,4,712,1148,1148,0,5,1068
112946000,6,60510,Quiaios,2901,1413,1488,2781,1354,1427,1118,1,911,2370,2370,0,7,1922
113061000,6,60511,São Julião da Figueira da Foz,9686,4329,5357,9061,3961,5100,4356,6,2939,9160,9156,4,33,2719
113271000,6,60512,Tavarede,9441,4576,4865,8769,4175,4594,3668,1,3012,5390,5385,5,2,2010
113392000,6,60513,Vila Verde,2968,1440,1528,2797,1332,1465,1155,1,955,1595,1594,1,1,1310
113457000,6,60514,São Pedro,2910,1421,1489,2906,1353,1553,1151,2,898,2051,2049,2,7,934
113548000,6,60515,Bom Sucesso,2133,999,1134,2032,925,1107,747,3,668,1077,1077,0,3,1020
113635000,6,60516,Santana,1058,503,555,969,442,527,384,0,341,623,623,0,0,588
113669000,6,60517,Borda do Campo,847,406,441,815,384,431,313,1,273,402,402,0,1,403
113700000,6,60518,Moinhos da Gândara,1265,594,671,1205,555,650,461,0,406,612,611,1,0,610
113762000,6,60801,Mira,7367,3450,3917,7045,3256,3789,2828,4,2336,4240,4237,3,9,3888
114064000,6,60802,Seixo,1234,568,666,1218,551,667,471,1,366,828,828,0,1,814
114120000,6,60803,Carapelhos,717,358,359,708,352,356,260,0,212,421,421,0,0,419
114164000,6,60804,Praia de Mira,3147,1526,1621,2983,1409,1574,1162,2,1014,3120,3117,3,9,1882
114272000,6,61001,Abrunheira,637,291,346,639,281,358,262,1,210,445,445,0,1,437
114297000,6,61002,Arazede,5508,2680,2828,5170,2466,2704,1992,1,1776,2645,2642,3,1,2573
114512000,6,61003,Carapinheira,2898,1370,1528,2757,1267,1490,1086,1,924,1473,1471,2,1,1345
114615000,6,61004,Gatões,516,263,253,495,248,247,202,0,162,272,272,0,0,271
114641000,6,61005,Liceia,1254,608,646,1149,526,623,475,0,417,562,561,1,0,553
114691000,6,61006,Meãs do Campo,1853,889,964,1778,837,941,683,1,583,868,868,0,1,766
114745000,6,61007,Montemor-o-Velho,3154,1501,1653,3048,1420,1628,1191,2,973,1695,1695,0,5,1297
114870000,6,61008,Pereira,3265,1612,1653,3124,1510,1614,1309,0,1109,1669,1668,1,0,1165
114941000,6,61009,Santo Varão,1969,936,1033,1914,892,1022,740,0,624,927,927,0,0,723
114991000,6,61010,Seixo de Gatões,1449,685,764,1357,619,738,514,0,480,618,618,0,0,605
115047000,6,61011,Tentúgal,2141,1056,1085,2031,984,1047,797,1,671,1101,1101,0,1,1048
115141000,6,61012,Verride,587,275,312,545,246,299,227,1,184,420,420,0,1,413
115171000,6,61013,Vila Nova da Barca,291,135,156,280,124,156,129,0,91,178,178,0,0,168
115191000,6,61014,Ereira,649,315,334,621,296,325,266,0,217,341,341,0,0,333
115208000,6,61301,Carvalho,846,399,447,834,397,437,335,0,278,583,583,0,0,579
115306000,6,61302,Figueira de Lorvão,2737,1307,1430,2647,1223,1424,1003,2,868,1207,1206,1,2,1164
115415000,6,61303,Friúmes,645,303,342,613,281,332,235,1,194,438,437,1,1,436
115469000,6,61304,Lorvão,3898,1851,2047,3769,1771,1998,1497,1,1232,1993,1993,0,1,1869
115625000,6,61305,Oliveira do Mondego,658,304,354,567,240,327,266,0,205,399,399,0,0,379
115671000,6,61306,Paradela,225,108,117,216,101,115,83,0,70,163,163,0,0,163
115685000,6,61307,Penacova,3254,1532,1722,3111,1449,1662,1261,3,1033,1781,1781,0,9,1567
115865000,6,61308,São Paio de Mondego,211,92,119,202,89,113,80,0,65,144,144,0,0,142
115879000,6,61309,São Pedro de Alva,1607,748,859,1520,698,822,636,1,504,1025,1025,0,1,990
115967000,6,61310,Sazes do Lorvão,749,365,384,702,330,372,285,0,243,375,374,1,0,368
116028000,6,61311,Travanca do Mondego,421,199,222,398,184,214,160,0,138,235,235,0,0,219
116065000,6,61501,Alfarelos,1439,699,740,1388,657,731,559,3,435,816,816,0,3,768
116144000,6,61502,Brunhós,180,83,97,177,82,95,76,0,62,103,103,0,0,97
116162000,6,61503,Degracias,453,211,242,424,199,225,197,0,140,278,278,0,1,272
116234000,6,61504,Figueiró do Campo,1507,718,789,1453,678,775,597,0,485,770,770,0,0,734
116305000,6,61505,Gesteira,974,464,510,913,419,494,398,1,301,617,617,0,1,609
116349000,6,61506,Granja do Ulmeiro,1866,866,1000,1764,800,964,736,1,599,1055,1055,0,1,717
116408000,6,61507,Pombalinho,807,386,421,802,382,420,345,0,281,650,650,0,1,647
116492000,6,61508,Samuel,1254,611,643,1208,577,631,535,0,406,823,822,1,0,817
116604000,6,61509,Soure,7917,3778,4139,7595,3586,4009,3056,6,2502,4787,4785,2,10,4240
116993000,6,61510,Tapéus,338,165,173,329,158,171,140,0,111,216,215,1,0,214
117044000,6,61511,Vila Nova de Anços,1113,525,588,1063,501,562,445,1,357,669,669,0,1,653
117101000,6,61512,Vinha da Rainha,1397,660,737,1329,620,709,602,1,439,941,941,0,2,929
117206000,6,100401,Batalha,8548,4202,4346,8248,4037,4211,3241,2,2643,4260,4259,1,15,3477
117506000,6,100402,Reguengo do Fetal,2169,1018,1151,2062,961,1101,803,1,667,1257,1257,0,2,1241
117626000,6,100403,São Mamede,3560,1695,1865,3432,1621,1811,1413,0,1128,2087,2084,3,1,2009
117939000,6,100404,Golpilheira,1528,733,795,1467,710,757,568,0,466,732,732,0,0,711
118000000,6,100901,Amor,4747,2384,2363,4545,2261,2284,1681,4,1451,2119,2115,4,4,2055
118142000,6,100902,Arrabal,2684,1328,1356,2541,1253,1288,966,1,804,1318,1317,1,2,1277
118258000,6,100903,Azoia,2276,1094,1182,2192,1051,1141,870,0,717,1082,1082,0,0,906
118331000,6,100904,Barosa,2156,1066,1090,2071,1018,1053,801,1,694,1020,1018,2,1,955
118399000,6,100905,Barreira,4102,1996,2106,3857,1866,1991,1623,0,1283,2066,2064,2,1,1330
118511000,6,100906,Boa Vista,1745,838,907,1645,779,866,662,1,538,934,933,1,1,845
118589000,6,100907,Caranguejeira,4691,2282,2409,4477,2165,2312,1706,1,1460,2482,2480,2,1,2440
118749000,6,100908,Carvide,2820,1357,1463,2726,1320,1406,1066,2,890,1441,1441,0,2,1410
118842000,6,100909,Coimbrão,1735,853,882,1643,806,837,670,2,525,2794,2794,0,7,1396
118974000,6,100910,Colmeias,3278,1556,1722,3118,1458,1660,1245,2,1000,2010,2008,2,2,1979
119097000,6,100911,Cortes,3001,1492,1509,2833,1392,1441,1090,1,936,1492,1491,1,2,1424
119201000,6,100912,Leiria,14909,6828,8081,15854,7231,8623,6619,16,4267,9436,9426,10,37,2190
119497000,6,100913,Maceira,9914,4840,5074,9400,4549,4851,3708,3,3145,4395,4390,5,4,4273
119769000,6,100914,Marrazes,22528,10746,11782,21164,9972,11192,8881,6,6883,11856,11849,7,8,4597
120111000,6,100915,Milagres,3071,1522,1549,2915,1437,1478,1123,0,934,1486,1480,6,0,1448
120215000,6,100916,Monte Real,2936,1397,1539,3014,1432,1582,1084,3,888,1613,1612,1,11,1243
120311000,6,100917,Monte Redondo,4398,2178,2220,4210,2065,2145,1584,1,1347,2172,2172,0,3,2048
120536000,6,100918,Ortigosa,1971,944,1027,1855,874,981,704,0,620,905,905,0,1,891
120610000,6,100919,Parceiros,4664,2271,2393,4550,2196,2354,1790,1,1456,2367,2365,2,1,1482
120708000,6,100920,Pousos,9763,4724,5039,9535,4565,4970,3719,5,2983,4821,4817,4,7,2960
120890000,6,100921,Regueira de Pontes,2221,1097,1124,2160,1051,1109,787,1,692,956,951,5,1,927
120984000,6,100922,Santa Catarina da Serra,4098,2006,2092,3854,1863,1991,1411,3,1203,1878,1876,2,7,1838
121143000,6,100923,Santa Eufémia,2327,1148,1179,2191,1081,1110,841,0,708,1187,1186,1,1,1155
121243000,6,100924,Souto da Carpalhosa,3863,1905,1958,3670,1801,1869,1362,2,1172,1835,1832,3,2,1801
121408000,6,100925,Bajouca,2004,1021,983,1898,952,946,697,0,593,924,924,0,0,920
121480000,6,100926,Bidoeira de Cima,2250,1113,1137,2139,1042,1097,814,1,700,1096,1094,2,1,1076
121570000,6,100927,Memória,807,367,440,770,344,426,325,1,235,658,658,0,1,658
121619000,6,100930,Carreira,1166,563,603,1098,521,577,411,2,359,575,573,2,2,557
121669000,6,100931,Chainça,772,403,369,748,382,366,283,0,229,383,383,0,0,370
121705000,6,101001,Marinha Grande,31413,15147,16266,30007,14359,15648,12639,9,10020,16940,16927,13,24,10835
122458000,6,101002,Vieira de Leiria,5845,2774,3071,5568,2624,2944,2310,5,1831,4399,4397,2,11,3204
122706000,6,101003,Moita,1423,702,721,1368,667,701,506,0,454,605,605,0,0,573
122753000,6,101501,Abiul,2729,1220,1509,2627,1153,1474,1159,2,814,2160,2158,2,2,2152
123034000,6,101502,Albergaria dos Doze,1765,846,919,1717,815,902,703,3,525,1318,1318,0,4,1222
123157000,6,101503,Almagreira,3076,1467,1609,2940,1389,1551,1185,2,994,1880,1880,0,2,1871
123372000,6,101504,Carnide,1647,795,852,1571,742,829,578,1,496,862,862,0,1,849
123504000,6,101505,Carriço,3653,1799,1854,3486,1703,1783,1346,1,1153,1900,1897,3,3,1855
123689000,6,101506,Louriçal,4720,2264,2456,4453,2106,2347,1777,3,1493,2655,2653,2,4,2502
123957000,6,101507,Mata Mourisca,1835,920,915,1763,868,895,707,0,582,1047,1047,0,1,1046
124111000,6,101508,Pelariga,2176,1047,1129,2089,989,1100,834,1,686,1268,1261,7,2,1250
124250000,6,101509,Pombal,17187,8195,8992,16400,7697,8703,6585,12,5241,10052,10048,4,20,6732
125035000,6,101510,Redinha,2117,1002,1115,2052,962,1090,840,0,665,1383,1382,1,0,1366
125200000,6,101511,Santiago de Litém,2237,1040,1197,2132,969,1163,901,3,681,2006,2006,0,3,1983
125376000,6,101512,São Simão de Litém,1382,656,726,1344,639,705,575,1,423,1261,1260,1,1,1247
125549000,6,101513,Vermoil,2656,1273,1383,2517,1200,1317,1014,2,804,1794,1793,1,3,1751
125769000,6,101514,Vila Cã,1659,758,901,1634,740,894,665,3,516,1094,1094,0,3,1092
125951000,6,101515,Meirinhas,1775,870,905,1687,820,867,662,0,538,955,955,0,0,821
126045000,6,101516,Guia,2672,1320,1352,2556,1248,1308,1008,2,806,1487,1487,0,4,1275
126211000,6,101517,Ilha,1931,950,981,1849,900,949,684,1,577,954,954,0,1,883
126341000,6,101601,Alcaria,244,110,134,247,111,136,106,0,74,226,226,0,1,227
126367000,6,101602,Alqueidão da Serra,1755,873,882,1676,827,849,669,2,526,973,973,0,2,965
126423000,6,101603,Alvados,497,235,262,491,227,264,210,0,150,301,301,0,3,302
126445000,6,101604,Arrimal,774,396,378,751,384,367,262,0,224,377,377,0,0,376
126487000,6,101605,Calvaria de Cima,2462,1203,1259,2342,1131,1211,940,1,787,1237,1236,1,1,1083
126537000,6,101606,Juncal,3316,1622,1694,3195,1553,1642,1191,3,1025,1640,1640,0,4,1575
126609000,6,101607,Mendiga,930,464,466,904,452,452,351,0,282,498,498,0,2,480
126649000,6,101608,Mira de Aire,3775,1802,1973,3564,1671,1893,1568,1,1186,2179,2179,0,3,1469
126780000,6,101609,Pedreiras,2705,1322,1383,2568,1237,1331,983,1,810,1278,1274,4,1,1250
126889000,6,101610,São Bento,835,393,442,805,384,421,340,0,263,540,540,0,1,539
126960000,6,101611,Porto de Mós (São João Baptista),3144,1536,1608,2979,1435,1544,1251,1,934,1598,1598,0,2,1311
127056000,6,101612,Porto de Mós (São Pedro),2879,1400,1479,2704,1306,1398,1112,0,878,1660,1660,0,3,1129
127126000,6,101613,Serro Ventoso,1026,508,518,930,457,473,368,1,318,516,516,0,1,514
127172000,6,60101,Anceriz,146,64,82,145,62,83,68,0,46,160,160,0,0,160
127185000,6,60102,Arganil,4002,1883,2119,3838,1779,2059,1538,3,1223,2450,2444,6,4,1791
127333000,6,60103,Barril de Alva,281,149,132,284,152,132,139,0,90,258,258,0,0,255
127350000,6,60104,Benfeita,394,182,212,379,177,202,202,0,126,697,695,2,1,691
127395000,6,60105,Celavisa,182,83,99,176,83,93,85,0,59,339,339,0,0,330
127420000,6,60106,Cepos,135,62,73,133,62,71,67,0,45,217,217,0,1,213
127441000,6,60107,Cerdeira,324,156,168,315,145,170,126,1,100,286,284,2,2,277
127465000,6,60108,Coja,1427,680,747,1370,646,724,564,1,453,1098,1098,0,3,1047
127540000,6,60109,Folques,356,166,190,351,157,194,152,1,94,468,468,0,1,467
127581000,6,60110,Moura da Serra,115,58,57,109,55,54,63,0,39,308,308,0,0,307
127605000,6,60111,Piódão,178,93,85,222,112,110,92,0,51,459,458,1,2,457
127641000,6,60112,Pomares,513,248,265,524,255,269,226,0,175,826,824,2,2,811
127708000,6,60113,Pombeiro da Beira,1010,478,532,965,449,516,424,0,322,902,899,3,0,893
127799000,6,60114,São Martinho da Cortiça,1319,645,674,1243,592,651,510,0,422,930,930,0,0,923
127883000,6,60115,Sarzedo,685,318,367,663,301,362,264,1,211,545,542,3,2,497
127913000,6,60116,Secarias,430,200,230,403,185,218,169,0,141,283,278,5,0,277
127933000,6,60117,Teixeira,135,71,64,127,70,57,68,0,43,249,249,0,0,249
127956000,6,60118,Vila Cova de Alva,513,252,261,485,237,248,227,0,166,444,441,3,0,430
128003000,6,60601,Alvares,812,364,448,769,344,425,351,2,234,1673,1673,0,3,1662
128147000,6,60602,Cadafaz,190,94,96,179,88,91,97,0,57,382,382,0,0,382
128182000,6,60603,Colmeal,158,71,87,161,70,91,92,0,41,494,494,0,0,480
128224000,6,60604,Góis,2171,1034,1137,2069,981,1088,857,2,685,1812,1811,1,4,1624
128386000,6,60605,Vila Nova de Ceira,929,440,489,927,438,489,390,1,282,807,805,2,1,786
128480000,6,60701,Casal de Ermio,376,187,189,373,187,186,135,1,109,213,212,1,2,214
128504000,6,60702,Foz de Arouce,1062,520,542,1006,487,519,411,0,341,670,670,0,0,649
128568000,6,60703,Lousã,10163,4886,5277,9684,4596,5088,4022,8,3154,6030,6028,2,11,3353
128832000,6,60704,Serpins,1802,864,938,1729,814,915,703,0,586,1197,1197,0,0,1039
128976000,6,60705,Vilarinho,2893,1421,1472,2804,1370,1434,1109,0,927,1688,1687,1,0,1276
129061000,6,60706,Gândaras,1308,640,668,1262,615,647,499,0,403,776,774,2,0,737
129098000,6,60901,Lamas,838,396,442,801,374,427,342,0,267,479,479,0,0,467
129138000,6,60902,Miranda do Corvo,7614,3642,3972,7231,3416,3815,2797,8,2290,4078,4076,2,11,2960
129399000,6,60903,Rio Vide,813,383,430,781,371,410,332,0,259,508,508,0,0,506
129456000,6,60904,Semide,2863,1417,1446,2741,1330,1411,1030,2,862,1517,1516,1,2,1487
129620000,6,60905,Vila Nova,970,473,497,929,447,482,386,0,319,783,783,0,2,781
129698000,6,61101,Aldeia das Dez,531,245,286,518,238,280,215,1,155,569,569,0,4,568
129760000,6,61102,Alvoco das Várzeas,320,138,182,311,132,179,130,1,97,328,326,2,2,311
129789000,6,61103,Avô,595,289,306,568,272,296,223,1,167,422,422,0,3,401
129822000,6,61104,Bobadela,759,371,388,717,344,373,278,1,244,420,420,0,2,364
129859000,6,61105,Ervedal,929,443,486,894,422,472,362,1,282,729,729,0,3,721
129928000,6,61106,Lagares,1398,648,750,1340,617,723,523,1,426,822,821,1,1,712
129983000,6,61107,Lagos da Beira,782,374,408,744,352,392,302,0,250,452,451,1,0,432
130030000,6,61108,Lajeosa,553,261,292,533,246,287,214,1,168,336,336,0,1,324
130060000,6,61109,Lourosa,555,268,287,547,262,285,232,0,175,527,526,1,0,514
130117000,6,61110,Meruge,555,258,297,550,253,297,244,0,172,423,423,0,0,409
130151000,6,61111,Nogueira do Cravo,2309,1120,1189,2200,1045,1155,823,2,721,1256,1256,0,3,1173
130254000,6,61112,Oliveira do Hospital,4717,2275,2442,4559,2158,2401,1774,1,1470,2660,2660,0,4,1242
130381000,6,61113,Penalva de Alva,926,438,488,885,418,467,364,0,302,607,606,1,1,602
130447000,6,61114,Santa Ovaia,597,291,306,562,266,296,205,1,173,361,361,0,1,331
130475000,6,61115,São Gião,425,206,219,409,193,216,180,0,135,508,508,0,2,500
130520000,6,61116,São Paio de Gramaços,991,489,502,933,455,478,357,1,309,517,517,0,1,440
130559000,6,61117,São Sebastião da Feira,197,84,113,186,77,109,87,0,66,162,162,0,0,155
130580000,6,61118,Seixo da Beira,1600,780,820,1511,725,786,629,0,507,1045,1045,0,0,1026
130676000,6,61119,Travanca de Lagos,1296,637,659,1220,596,624,495,1,411,860,860,0,1,830
130754000,6,61120,Vila Pouca da Beira,355,165,190,335,155,180,140,0,111,334,334,0,1,334
130776000,6,61121,Vila Franca da Beira,465,227,238,448,212,236,203,0,147,346,346,0,1,337
130802000,6,61201,Cabril,231,110,121,225,107,118,119,0,73,452,451,1,0,442
130838000,6,61202,Dornelas do Zêzere,682,323,359,621,285,336,275,3,196,452,452,0,4,450
130863000,6,61203,Fajão,233,106,127,215,100,115,118,1,69,544,544,0,3,525
130892000,6,61204,Janeiro de Baixo,669,332,337,620,305,315,326,0,226,675,675,0,2,669
130924000,6,61205,Machio,126,59,67,118,55,63,63,0,50,227,227,0,1,228
130938000,6,61206,Pampilhosa da Serra,1389,602,787,1396,614,782,573,2,409,1764,1764,0,5,1608
131035000,6,61207,Pessegueiro,228,99,129,240,108,132,114,0,82,370,370,0,5,372
131058000,6,61208,Portela do Fojo,381,174,207,372,171,201,180,0,130,539,539,0,0,538
131083000,6,61209,Unhais-o-Velho,458,224,234,455,220,235,215,0,160,486,486,0,2,486
131109000,6,61210,Vidual,84,36,48,84,36,48,46,0,25,150,150,0,0,137
131116000,6,61401,Cumeeira,1072,503,569,995,466,529,421,0,328,827,827,0,1,820
131166000,6,61402,Espinhal,775,357,418,747,337,410,314,4,220,788,788,0,4,782
131248000,6,61403,Podentes,485,235,250,469,228,241,198,0,160,343,343,0,0,342
131294000,6,61404,Rabaçal,291,145,146,274,135,139,127,0,98,232,232,0,1,233
131336000,6,61405,Penela (Santa Eufémia),1760,813,947,1755,798,957,644,5,509,1222,1221,1,6,1116
131486000,6,61406,Penela (São Miguel),1600,788,812,1554,751,803,657,0,487,1286,1286,0,1,1258
131651000,6,61601,Ázere,686,320,366,662,303,359,231,1,187,532,532,0,1,527
131705000,6,61602,Candosa,689,330,359,668,319,349,267,1,220,429,428,1,1,424
131766000,6,61603,Carapinha,402,190,212,389,184,205,147,0,122,265,265,0,1,262
131792000,6,61604,Covas,1085,529,556,1043,499,544,414,0,341,912,910,2,1,893
131877000,6,61605,Covelo,247,120,127,233,110,123,85,0,76,172,172,0,0,170
131894000,6,61606,Espariz,633,314,319,613,314,299,241,0,204,454,454,0,0,433
131938000,6,61607,Meda de Mouros,213,106,107,201,97,104,81,0,66,169,169,0,0,168
131956000,6,61608,Midões,1725,832,893,1660,791,869,673,0,539,1211,1211,0,1,1181
132060000,6,61609,Mouronho,840,405,435,780,377,403,313,0,263,676,676,0,0,674
132141000,6,61610,Pinheiro de Coja,308,142,166,306,143,163,133,0,95,270,268,2,0,263
132162000,6,61611,Póvoa de Midões,582,274,308,553,258,295,210,0,182,393,393,0,0,391
132188000,6,61612,São João da Boa Vista,453,229,224,443,221,222,182,0,143,329,329,0,0,325
132227000,6,61613,Sinde,373,173,200,370,168,202,166,0,116,302,302,0,0,301
132271000,6,61614,Tábua,3542,1641,1901,3444,1565,1879,1285,4,1057,2318,2318,0,8,1551
132428000,6,61615,Vila Nova de Oliveirinha,293,138,155,278,125,153,126,0,94,297,295,2,1,293
132456000,6,61701,Arrifana,1440,683,757,1348,633,715,570,0,457,960,960,0,0,958
132548000,6,61702,Lavegadas,204,93,111,198,91,107,90,0,65,196,196,0,0,196
132566000,6,61703,Poiares (Santo André),4306,2062,2244,4120,1918,2202,1591,4,1284,2570,2564,6,6,1972
132746000,6,61704,São Miguel de Poiares,1331,647,684,1280,615,665,500,2,405,830,829,1,2,800
132838000,6,100201,Almoster,674,309,365,646,295,351,316,0,202,574,574,0,0,571
132936000,6,100202,Alvaiázere,1693,780,913,1581,708,873,662,3,490,1141,1136,5,4,954
133086000,6,100203,Maçãs de Caminho,356,176,180,342,169,173,149,0,105,317,317,0,0,314
133142000,6,100204,Maçãs de Dona Maria,1835,859,976,1766,828,938,746,3,539,1362,1362,0,3,1354
133330000,6,100205,Pelmá,736,356,380,712,338,374,334,0,228,852,850,2,0,847
133456000,6,100206,Pussos,1139,520,619,1093,495,598,467,0,353,819,819,0,0,788
133586000,6,100207,Rego da Murta,854,406,448,839,396,443,343,0,273,657,657,0,1,644
133685000,6,100301,Alvorge,1227,566,661,1164,530,634,459,2,374,731,731,0,2,730
133816000,6,100302,Ansião,2728,1296,1432,2554,1199,1355,1038,1,835,1573,1572,1,7,1267
133985000,6,100303,Avelar,2169,1028,1141,2084,980,1104,846,3,683,1306,1304,2,5,985
134068000,6,100304,Chão de Couce,1992,921,1071,1975,883,1092,768,2,602,1257,1256,1,2,1227
134242000,6,100305,Lagarteira,504,228,276,488,216,272,187,0,153,247,246,1,0,246
134288000,6,100306,Pousaflores,950,439,511,916,418,498,402,0,303,823,822,1,0,819
134395000,6,100307,Santiago da Guarda,3147,1516,1631,3007,1447,1560,1295,1,966,2296,2296,0,2,2244
134639000,6,100308,Torre de Vale de Todos,411,193,218,404,187,217,159,0,124,200,200,0,0,200
134686000,6,100701,Castanheira de Pêra,3091,1467,1624,3001,1409,1592,1288,4,970,2501,2501,0,12,2306
134993000,6,100702,Coentral,100,53,47,98,51,47,44,0,31,216,215,1,1,215
135033000,6,100801,Aguda,1106,517,589,1067,499,568,470,0,343,972,971,1,0,956
135155000,6,100802,Arega,870,408,462,850,393,457,358,1,254,632,632,0,2,632
135234000,6,100803,Campelo,278,128,150,267,120,147,140,0,85,693,692,1,0,689
135302000,6,100804,Figueiró dos Vinhos,3428,1615,1813,3285,1528,1757,1394,4,1066,2184,2184,0,11,1910
135537000,6,100805,Bairradas,487,224,263,464,211,253,219,0,150,377,377,0,0,373
135610000,6,101301,Graça,786,381,405,771,373,398,353,0,246,792,791,1,0,780
135773000,6,101302,Pedrógão Grande,2550,1196,1354,2486,1149,1337,1054,1,763,2266,2260,6,6,2066
136010000,6,101303,Vila Facaia,579,274,305,563,263,300,261,0,180,598,598,0,0,590
136134000,6,90101,Aguiar da Beira,1473,702,771,1427,675,752,515,5,437,998,998,0,6,834
136240000,6,90102,Carapito,442,206,236,423,195,228,162,0,133,320,320,0,0,319
136283000,6,90103,Cortiçada,341,157,184,340,157,183,146,0,107,470,470,0,0,466
136315000,6,90104,Coruche,158,74,84,156,72,84,71,0,57,307,307,0,0,307
136329000,6,90105,Dornelas,690,329,361,668,317,351,245,2,189,573,573,0,1,574
136378000,6,90106,Eirado,230,106,124,217,100,117,89,0,69,198,198,0,0,198
136404000,6,90107,Forninhos,222,101,121,223,101,122,99,0,76,228,228,0,2,230
136434000,6,90108,Gradiz,159,78,81,157,79,78,66,0,49,188,188,0,0,187
136448000,6,90109,Pena Verde,813,379,434,791,370,421,306,1,242,578,575,3,1,573
136499000,6,90110,Pinheiro,232,113,119,224,108,116,102,0,77,254,254,0,1,253
136532000,6,90111,Sequeiros,262,123,139,246,115,131,113,0,84,266,265,1,3,266
136551000,6,90112,Souto de Aguiar da Beira,297,139,158,294,138,156,138,0,90,291,291,0,0,291
136576000,6,90113,Valverde,154,73,81,148,71,77,59,0,49,207,207,0,0,206
136595000,6,180201,Beijós,975,477,498,903,434,469,394,0,307,710,710,0,0,701
136641000,6,180202,Cabanas de Viriato,1533,710,823,1448,661,787,589,1,490,1129,1129,0,1,1100
136698000,6,180203,Currelos,2447,1168,1279,2377,1121,1256,903,4,734,1510,1510,0,5,1070
136765000,6,180204,Oliveira do Conde,3122,1469,1653,3024,1390,1634,1204,2,976,2062,2061,1,3,1979
136889000,6,180205,Papízios,679,325,354,645,301,344,262,0,219,508,508,0,0,506
136935000,6,180206,Parada,806,387,419,767,367,400,312,1,251,574,574,0,1,574
136975000,6,180207,Sobral,273,128,145,264,125,139,108,0,92,179,179,0,0,175
137001000,6,180301,Almofala,228,111,117,210,100,110,104,0,71,265,265,0,0,261
137037000,6,180302,Alva,479,231,248,463,219,244,196,0,153,348,348,0,2,347
137070000,6,180303,Cabril,414,204,210,392,193,199,171,0,125,442,442,0,0,439
137097000,6,180304,Castro Daire,4674,2210,2464,4425,2072,2353,1649,3,1390,3044,3035,9,7,2197
137297000,6,180305,Cujó,299,136,163,288,131,157,126,0,92,279,279,0,0,277
137347000,6,180306,Ermida,257,124,133,256,124,132,116,0,81,292,292,0,0,285
137382000,6,180307,Ester,220,108,112,222,111,111,98,0,65,250,250,0,0,248
137412000,6,180308,Gafanhão,128,59,69,130,60,70,63,0,39,207,207,0,0,206
137432000,6,180309,Gosende,426,200,226,423,195,228,189,0,125,599,599,0,2,601
137481000,6,180310,Mamouros,679,327,352,729,334,395,243,0,208,456,456,0,3,422
137535000,6,180311,Mezio,484,259,225,428,216,212,165,0,129,349,349,0,0,348
137587000,6,180312,Mões,1844,891,953,1794,857,937,709,0,584,1525,1525,0,2,1525
137696000,6,180313,Moledo,1215,585,630,1183,567,616,515,0,408,1092,1092,0,0,1088
137774000,6,180314,Monteiras,481,239,242,450,222,228,189,0,142,455,455,0,0,455
137835000,6,180315,Moura Morta,134,64,70,122,57,65,56,0,39,129,129,0,0,127
137856000,6,180316,Parada de Ester,654,327,327,614,305,309,276,0,197,600,600,0,0,600
137913000,6,180317,Pepim,334,163,171,320,157,163,145,0,105,260,260,0,0,255
137936000,6,180318,Picão,278,132,146,278,129,149,98,0,76,234,234,0,0,232
137956000,6,180319,Pinheiro,730,340,390,722,333,389,350,1,230,700,700,0,1,693
138008000,6,180320,Reriz,755,365,390,739,356,383,278,0,226,537,537,0,0,535
138062000,6,180321,Ribolhos,266,123,143,253,114,139,103,0,85,170,170,0,0,169
138081000,6,180322,São Joaninho,360,172,188,332,162,170,132,0,106,307,306,1,0,307
138111000,6,180601,Abrunhosa-a-Velha,563,266,297,550,260,290,237,0,180,396,396,0,1,395
138147000,6,180602,Alcafache,921,441,480,857,405,452,337,0,303,607,607,0,3,603
138183000,6,180603,Chãs de Tavares,1040,493,547,1003,472,531,427,0,315,831,831,0,1,829
138237000,6,180604,Cunha Alta,139,57,82,134,55,79,59,0,47,115,115,0,0,114
138250000,6,180605,Cunha Baixa,884,423,461,842,399,443,371,0,288,711,711,0,0,706
138313000,6,180606,Espinho,984,478,506,943,452,491,377,0,325,752,751,1,0,748
138370000,6,180607,Fornos de Maceira Dão,1459,718,741,1395,683,712,541,0,480,898,897,1,0,888
138446000,6,180608,Freixiosa,257,114,143,253,113,140,97,1,77,263,263,0,1,264
138465000,6,180609,Lobelhe do Mato,259,126,133,251,121,130,98,0,84,181,181,0,0,180
138477000,6,180610,Mangualde,9389,4534,4855,8830,4165,4665,3608,3,2903,5378,5368,10,8,3914
138767000,6,180611,Mesquitela,879,436,443,817,399,418,308,0,253,527,527,0,0,511
138811000,6,180612,Moimenta de Maceira Dão,514,255,259,507,252,255,188,0,161,268,268,0,0,264
138830000,6,180613,Póvoa de Cervães,188,96,92,169,85,84,81,0,59,156,156,0,0,156
138849000,6,180614,Quintela de Azurara,542,256,286,503,232,271,206,0,178,360,360,0,1,351
138882000,6,180615,Santiago de Cassurrães,1226,564,662,1177,528,649,461,1,376,978,976,2,2,965
138958000,6,180616,São João da Fresta,208,99,109,227,106,121,95,0,62,225,225,0,0,225
138983000,6,180617,Travanca de Tavares,114,53,61,106,48,58,50,0,36,185,185,0,0,181
138997000,6,180618,Várzea de Tavares,314,150,164,299,138,161,125,0,102,296,296,0,0,295
139024000,6,180801,Almaça,84,37,47,120,56,64,39,0,29,227,227,0,1,152
139036000,6,180802,Cercosa,303,148,155,282,136,146,113,0,100,203,203,0,0,203
139060000,6,180803,Cortegaça,437,208,229,430,205,225,182,0,145,264,264,0,0,259
139104000,6,180804,Espinho,1105,528,577,1061,502,559,451,0,366,746,746,0,0,742
139231000,6,180805,Marmeleira,503,233,270,484,222,262,186,1,153,323,323,0,1,323
139277000,6,180806,Mortágua,2793,1333,1460,2622,1233,1389,1130,2,869,1636,1634,2,3,1290
139400000,6,180807,Pala,1016,508,508,968,480,488,386,0,319,567,567,0,0,561
139486000,6,180808,Sobral,2311,1117,1194,2237,1072,1165,847,1,732,1331,1329,2,2,1298
139598000,6,180809,Trezói,377,188,189,356,174,182,157,0,122,269,269,0,0,269
139641000,6,180810,Vale de Remígio,678,321,357,650,312,338,282,0,228,446,445,1,0,445
139693000,6,180901,Canas de Senhorim,3509,1681,1828,3301,1555,1746,1329,2,1112,2021,2021,0,8,1728
139805000,6,180902,Carvalhal Redondo,974,468,506,953,456,497,384,0,319,642,642,0,0,642
139845000,6,180903,Nelas,4702,2264,2438,4686,2242,2444,1787,4,1456,2816,2795,21,15,1799
139986000,6,180904,Santar,1042,496,546,1028,486,542,405,0,327,701,701,0,1,670
140042000,6,180905,Senhorim,1156,515,641,1132,500,632,458,0,370,837,837,0,0,836
140140000,6,180906,Vilar Seco,745,371,374,732,362,370,317,0,244,514,514,0,0,507
140191000,6,180907,Aguieira,558,258,300,542,249,293,229,0,183,356,356,0,0,355
140219000,6,180908,Lapa do Lobo,756,349,407,729,329,400,281,1,226,408,408,0,1,404
140243000,6,180909,Moreira,595,274,321,572,259,313,229,0,189,458,458,0,0,457
140283000,6,181001,Arca,359,177,182,335,167,168,130,0,112,204,204,0,0,204
140326000,6,181002,Arcozelo das Maias,1364,659,705,1316,621,695,466,0,434,671,671,0,0,653
140446000,6,181003,Destriz,347,161,186,325,147,178,118,0,106,214,214,0,0,214
140486000,6,181004,Oliveira de Frades,2882,1367,1515,2743,1287,1456,1040,3,871,1610,1608,2,5,962
140598000,6,181005,Pinheiro,1277,609,668,1222,576,646,445,0,381,702,702,0,1,650
140712000,6,181006,Reigoso,341,156,185,331,153,178,118,0,99,186,186,0,0,184
140749000,6,181007,Ribeiradio,1011,470,541,976,450,526,362,0,301,633,633,0,0,630
140845000,6,181008,São João da Serra,524,236,288,487,215,272,196,0,165,308,308,0,0,308
140890000,6,181009,São Vicente de Lafões,756,355,401,718,337,381,265,0,236,387,387,0,1,388
140955000,6,181010,Sejães,200,103,97,182,96,86,66,0,52,131,131,0,2,132
140980000,6,181011,Souto de Lafões,841,401,440,876,393,483,284,0,250,375,374,1,1,330
141032000,6,181012,Varzielas,359,174,185,350,167,183,138,0,108,248,248,0,0,243
141086000,6,181101,Antas,284,134,150,257,120,137,118,0,80,276,276,0,0,274
141118000,6,181102,Castelo de Penalva,914,440,474,910,434,476,353,1,288,630,630,0,2,622
141208000,6,181103,Esmolfe,417,200,217,407,194,213,167,0,131,313,313,0,0,306
141239000,6,181104,Germil,427,207,220,403,188,215,146,1,125,260,260,0,1,261
141271000,6,181105,Ínsua,2045,968,1077,1944,904,1040,757,3,631,1238,1238,0,6,971
141356000,6,181106,Lusinde,189,88,101,175,80,95,79,0,62,162,162,0,0,161
141387000,6,181107,Mareco,106,45,61,104,44,60,51,0,34,111,111,0,0,111
141408000,6,181108,Matela,189,93,96,177,85,92,79,0,64,229,229,0,0,229
141424000,6,181109,Pindo,1916,949,967,1814,889,925,707,0,590,1101,1099,2,0,1086
141505000,6,181110,Real,263,123,140,253,117,136,111,0,91,179,179,0,0,176
141524000,6,181111,Sezures,726,345,381,706,334,372,279,0,217,570,570,0,0,565
141574000,6,181112,Trancozelos,269,121,148,264,120,144,103,0,85,157,157,0,0,155
141596000,6,181113,Vila Cova do Covelo,211,102,109,193,90,103,104,0,74,217,217,0,0,215
141624000,6,181401,Couto do Mosteiro,1186,565,621,1145,539,606,464,0,382,713,713,0,0,683
141705000,6,181402,Ovoa,837,392,445,797,367,430,319,0,276,513,511,2,0,506
141754000,6,181403,Pinheiro de Ázere,937,444,493,869,391,478,359,0,299,593,593,0,0,585
141800000,6,181404,Santa Comba Dão,3386,1597,1789,3253,1500,1753,1256,3,1052,1892,1892,0,4,1316
141894000,6,181405,São Joaninho,1075,497,578,1025,465,560,409,1,326,624,624,0,1,622
141968000,6,181406,São João de Areias,1939,915,1024,1856,857,999,755,1,601,1245,1242,3,3,1233
142061000,6,181407,Treixedo,987,471,516,946,444,502,391,0,328,705,704,1,0,701
142097000,6,181408,Vimieiro,803,376,427,768,348,420,318,1,245,495,495,0,2,482
142147000,6,181409,Nagozela,447,209,238,430,201,229,180,0,150,306,306,0,0,306
142171000,6,181601,Baiões,286,145,141,266,136,130,102,0,83,157,157,0,2,158
142194000,6,181602,Bordonhos,547,269,278,517,253,264,184,0,165,295,295,0,0,290
142238000,6,181603,Candal,118,52,66,118,54,64,55,0,38,123,123,0,0,123
142254000,6,181604,Carvalhais,1436,694,742,1412,648,764,548,0,456,1011,1007,4,4,988
142352000,6,181605,Covas do Rio,120,55,65,120,56,64,54,0,41,122,122,0,0,122
142370000,6,181606,Figueiredo de Alva,816,395,421,744,347,397,306,0,258,488,488,0,0,486
142439000,6,181607,Manhouce,647,279,368,613,256,357,232,0,196,377,377,0,3,378
142495000,6,181608,Pindelo dos Milagres,659,291,368,633,281,352,275,0,213,473,473,0,0,465
142533000,6,181609,Pinho,777,362,415,753,353,400,302,0,248,434,432,2,0,431
142592000,6,181610,Santa Cruz da Trapa,1313,608,705,1240,560,680,500,0,408,869,868,1,4,808
142674000,6,181611,São Cristóvão de Lafões,191,93,98,178,89,89,70,0,57,134,134,0,0,134
142697000,6,181612,São Félix,390,186,204,379,180,199,147,0,122,231,231,0,1,228
142733000,6,181613,São Martinho das Moitas,251,118,133,248,115,133,112,0,86,389,389,0,0,386
142775000,6,181614,São Pedro do Sul,3697,1724,1973,3567,1673,1894,1337,2,1104,2173,2172,1,8,1554
142915000,6,181615,Serrazes,1001,463,538,984,446,538,378,0,310,679,679,0,3,680
142998000,6,181616,Sul,1090,507,583,1038,479,559,489,0,348,1092,1091,1,1,1082
143113000,6,181617,Valadares,805,357,448,722,307,415,323,0,247,635,635,0,0,628
143181000,6,181618,Várzea,1745,827,918,2165,946,1219,657,0,519,1328,1327,1,61,876
143263000,6,181619,Vila Maior,962,466,496,904,430,474,336,1,305,564,564,0,1,557
143356000,6,181701,Águas Boas,172,87,85,167,81,86,73,0,55,170,170,0,0,170
143373000,6,181702,Avelal,529,228,301,503,215,288,145,2,127,272,272,0,2,271
143398000,6,181703,Decermilo,205,91,114,196,86,110,68,1,57,167,167,0,1,168
143413000,6,181704,Ferreira de Aves,2464,1166,1298,2316,1075,1241,990,0,759,1740,1736,4,3,1725
143574000,6,181705,Forles,65,35,30,62,32,30,33,0,22,76,76,0,0,76
143583000,6,181706,Mioma,1217,586,631,1150,547,603,420,1,360,793,778,15,1,751
143654000,6,181707,Rio de Moinhos,942,430,512,901,407,494,379,1,290,752,752,0,1,752
143723000,6,181708,Romãs,868,406,462,809,376,433,346,0,275,1062,1062,0,0,1059
143797000,6,181709,São Miguel de Vila Boa,1334,651,683,1281,614,667,452,0,408,938,938,0,0,936
143860000,6,181710,Sátão,4007,1896,2111,3855,1794,2061,1388,1,1194,2638,2638,0,3,1848
144038000,6,181711,Silvã de Cima,455,241,214,449,236,213,183,0,146,431,430,1,1,429
144078000,6,181712,Vila Longa,186,88,98,190,91,99,80,0,66,242,242,0,0,239
144098000,6,182101,Barreiro de Besteiros,975,460,515,937,439,498,376,0,318,562,562,0,0,561
144151000,6,182102,Campo de Besteiros,1474,723,751,1398,680,718,570,2,465,841,841,0,6,695
144212000,6,182103,Canas de Santa Maria,1806,857,949,1745,821,924,665,1,565,1095,1094,1,1,1085
144280000,6,182104,Caparrosa,805,381,424,765,355,410,310,1,243,514,514,0,1,515
144325000,6,182105,Castelões,1542,703,839,1479,665,814,611,1,469,1049,1049,0,1,1044
144416000,6,182106,Dardavaz,782,374,408,729,342,387,311,0,255,493,493,0,1,488
144462000,6,182107,Ferreirós do Dão,441,210,231,371,174,197,182,0,136,328,328,0,0,328
144481000,6,182108,Guardão,1490,706,784,1492,702,790,466,5,372,775,775,0,7,709
144538000,6,182109,Lajeosa,1940,942,998,1877,901,976,754,0,615,1237,1236,1,2,1236
144606000,6,182110,Lobão da Beira,1124,547,577,1079,518,561,441,0,352,636,635,1,0,631
144649000,6,182111,Molelos,2346,1098,1248,2222,1039,1183,897,0,763,1458,1458,0,0,1424
144754000,6,182112,Mosteirinho,217,108,109,200,98,102,81,0,70,98,98,0,0,98
144773000,6,182113,Mosteiro de Fráguas,590,273,317,563,259,304,232,0,185,348,347,1,0,343
144789000,6,182114,Mouraz,878,408,470,862,394,468,352,0,290,620,620,0,0,613
144838000,6,182115,Nandufe,622,294,328,585,277,308,242,0,208,330,330,0,0,318
144864000,6,182116,Parada de Gonta,754,358,396,711,336,375,287,0,250,514,514,0,0,514
144887000,6,182117,Sabugosa,545,265,280,526,251,275,215,0,175,377,377,0,0,377
144899000,6,182118,Santiago de Besteiros,1331,657,674,1287,632,655,489,1,414,830,827,3,1,822
144958000,6,182119,São João do Monte,862,429,433,805,395,410,337,0,269,576,576,0,0,575
145003000,6,182120,São Miguel do Outeiro,913,435,478,867,411,456,329,0,293,511,511,0,0,508
145030000,6,182121,Silvares,136,63,73,131,61,70,60,0,43,208,208,0,0,208
145042000,6,182122,Tonda,984,459,525,926,426,500,381,0,301,631,631,0,0,607
145088000,6,182123,Tondela,4508,2087,2421,4360,2008,2352,1741,3,1379,2515,2515,0,6,1517
145194000,6,182124,Vila Nova da Rainha,476,226,250,465,219,246,186,0,149,314,314,0,0,312
145217000,6,182125,Vilar de Besteiros,893,421,472,868,402,466,338,0,288,539,539,0,0,527
145251000,6,182126,Tourigo,512,246,266,496,238,258,185,0,161,274,274,0,0,273
145278000,6,182201,Alhais,522,246,276,503,236,267,200,0,162,430,430,0,0,425
145324000,6,182202,Fráguas,217,105,112,232,111,121,91,0,69,315,315,0,0,310
145357000,6,182203,Pendilhe,546,282,264,510,257,253,201,0,159,422,422,0,1,416
145409000,6,182204,Queiriga,575,266,309,551,254,297,245,1,183,790,790,0,1,787
145460000,6,182205,Touro,918,425,493,863,389,474,341,0,276,701,701,0,0,698
145521000,6,182206,Vila Cova à Coelheira,1109,533,576,916,419,497,401,1,314,805,805,0,1,803
145595000,6,182207,Vila Nova de Paiva,1289,606,683,1249,584,665,465,1,371,915,915,0,4,713
145661000,6,182301,Abraveses,8539,4083,4456,8110,3817,4293,3100,2,2628,4133,4133,0,3,2393
145780000,6,182302,Barreiros,300,142,158,294,138,156,121,0,95,240,240,0,0,240
145814000,6,182303,Boa Aldeia,518,248,270,506,241,265,205,1,156,332,332,0,1,333
145845000,6,182304,Bodiosa,3047,1474,1573,2913,1399,1514,1097,0,946,1604,1603,1,0,1556
145957000,6,182305,Calde,1469,699,770,1438,672,766,555,1,473,1032,1032,0,1,1026
146045000,6,182306,Campo,5025,2480,2545,4752,2321,2431,1784,2,1555,2603,2601,2,4,2257
146160000,6,182307,Cavernães,1348,650,698,1303,625,678,475,0,434,784,784,0,1,771
146209000,6,182308,Cepões,1284,599,685,1235,574,661,502,0,416,919,919,0,0,917
146309000,6,182309,Viseu (Coração de Jesus),11245,5094,6151,11249,5074,6175,4725,8,3325,7008,7006,2,16,1222
146410000,6,182310,Cota,974,447,527,963,443,520,379,1,306,833,833,0,1,832
146510000,6,182311,Couto de Baixo,756,347,409,727,332,395,275,1,230,436,436,0,1,434
146549000,6,182312,Couto de Cima,851,420,431,793,386,407,315,1,273,506,506,0,1,503
146596000,6,182313,Fail,664,340,324,634,322,312,239,0,215,363,363,0,0,359
146611000,6,182314,Farminhão,750,339,411,726,324,402,271,1,235,429,429,0,1,427
146647000,6,182315,Fragosela,2662,1299,1363,2561,1247,1314,925,0,834,1142,1142,0,0,1047
146699000,6,182316,Lordosa,1791,804,987,1771,788,983,662,1,565,1052,1052,0,2,1047
146801000,6,182317,Silgueiros,3250,1521,1729,3153,1453,1700,1184,1,1051,1904,1902,2,3,1890
146904000,6,182318,Mundão,2385,1190,1195,2298,1138,1160,828,0,739,1103,1103,0,0,873
146975000,6,182319,Orgens,3489,1675,1814,3308,1571,1737,1220,0,1084,1542,1541,1,1,1409
147055000,6,182320,Povolide,1747,836,911,1692,807,885,642,1,554,1091,1091,0,3,1064
147123000,6,182321,Ranhados,4949,2332,2617,5038,2328,2710,1882,2,1496,2555,2549,6,4,1039
147213000,6,182322,Ribafeita,1227,587,640,1146,541,605,467,0,401,861,860,1,0,853
147273000,6,182323,Rio de Loba,9348,4526,4822,8836,4229,4607,3214,3,2870,4245,4242,3,6,3379
147434000,6,182324,Viseu (Santa Maria de Viseu),6790,3088,3702,7468,3298,4170,2708,11,1904,4210,4208,2,20,1422
147535000,6,182325,Santos Evos,1569,711,858,1524,685,839,584,0,512,873,873,0,0,853
147587000,6,182326,São Cipriano,1283,611,672,1225,572,653,440,0,395,648,648,0,1,642
147639000,6,182327,São João de Lourosa,4702,2281,2421,4494,2162,2332,1605,0,1465,2217,2197,20,1,2166
147746000,6,182328,Viseu (São José),5395,2459,2936,5302,2349,2953,2251,3,1676,3285,3284,1,4,1410
147826000,6,182329,São Pedro de France,1370,637,733,1326,611,715,516,1,414,808,808,0,2,807
147899000,6,182330,São Salvador,3807,1789,2018,3706,1727,1979,1408,1,1156,1777,1777,0,1,964
147941000,6,182331,Torredeita,1555,715,840,1476,666,810,602,1,451,994,983,11,1,960
148002000,6,182332,Vil de Souto,667,308,359,646,298,348,237,0,207,335,335,0,0,325
148039000,6,182333,Vila Chã de Sá,2009,982,1027,1891,916,975,669,0,630,880,880,0,1,806
148080000,6,182334,Repeses,2509,1202,1307,2741,1335,1406,965,2,757,1316,1316,0,4,594
148119000,6,182401,Alcofra,1025,495,530,959,457,502,371,0,328,732,732,0,0,727
148193000,6,182402,Cambra,1244,588,656,1170,545,625,474,1,356,837,833,4,3,834
148255000,6,182403,Campia,1542,748,794,1421,682,739,550,0,468,842,840,2,1,840
148323000,6,182404,Carvalhal de Vermilhas,215,105,110,202,99,103,73,0,69,227,227,0,0,227
148338000,6,182405,Fataunços,751,354,397,700,320,380,269,0,238,444,443,1,0,438
148376000,6,182406,Figueiredo das Donas,352,173,179,342,163,179,136,0,115,210,210,0,0,209
148397000,6,182407,Fornelo do Monte,288,137,151,288,137,151,113,0,91,278,278,0,0,277
148422000,6,182408,Paços de Vilharigues,647,315,332,603,292,311,230,0,206,336,336,0,0,336
148459000,6,182409,Queirã,1432,680,752,1350,623,727,521,0,445,880,878,2,0,877
148546000,6,182410,São Miguel do Mato,924,457,467,880,428,452,349,0,297,611,610,1,1,600
148601000,6,182411,Ventosa,794,376,418,753,358,395,310,0,249,568,568,0,0,567
148661000,6,182412,Vouzela,1350,603,747,1346,591,755,486,3,402,739,735,4,7,525
148696000,6,50601,Álvaro,237,110,127,222,103,119,117,0,79,296,296,0,2,298
148723000,6,50602,Amieira,116,55,61,118,56,62,58,0,41,202,202,0,0,201
148741000,6,50603,Cambas,309,143,166,292,132,160,158,0,111,454,454,0,0,454
148784000,6,50604,Estreito,897,439,458,845,405,440,400,1,302,730,730,0,2,725
148863000,6,50605,Isna,209,102,107,163,76,87,89,0,68,145,145,0,0,145
148887000,6,50606,Madeirã,171,77,94,164,72,92,80,0,50,194,193,1,1,194
148906000,6,50607,Mosteiro,307,152,155,278,137,141,148,0,88,308,308,0,0,308
148939000,6,50608,Oleiros,2306,1102,1204,1995,945,1050,919,2,715,1577,1577,0,9,1322
149100000,6,50609,Orvalho,678,298,380,643,275,368,276,1,186,533,533,0,1,518
149137000,6,50610,Sarnadas de São Simão,217,100,117,215,98,117,111,0,66,259,259,0,0,259
149160000,6,50611,Sobral,160,82,78,156,78,78,73,0,50,129,129,0,0,128
149179000,6,50612,Vilar Barroco,114,61,53,114,61,53,52,0,37,148,148,0,0,147
149198000,6,50801,Alvito da Beira,362,173,189,343,163,180,189,0,116,440,440,0,0,436
149258000,6,50802,Montes da Senhora,748,335,413,726,319,407,361,0,228,814,814,0,0,809
149366000,6,50803,Peral,674,337,337,624,303,321,264,0,221,387,387,0,1,384
149431000,6,50804,Proença-a-Nova,4295,2060,2235,3999,1881,2118,1583,5,1254,2615,2614,1,7,2087
149663000,6,50805,São Pedro do Esteval,527,262,265,493,246,247,222,0,173,324,324,0,0,324
149736000,6,50806,Sobreira Formosa,1708,818,890,1603,762,841,763,1,539,1687,1687,0,4,1662
149943000,6,50901,Cabeçudo,957,452,505,910,432,478,384,0,285,653,653,0,0,641
149998000,6,50902,Carvalhal,465,203,262,451,196,255,203,0,140,342,342,0,0,335
150038000,6,50903,Castelo,1046,505,541,896,418,478,420,0,316,786,786,0,0,780
150112000,6,50904,Cernache do Bonjardim,3052,1451,1601,2886,1359,1527,1234,3,937,2496,2494,2,3,2224
150289000,6,50905,Cumeada,503,247,256,479,233,246,217,0,160,410,410,0,0,410
150327000,6,50906,Ermida,218,112,106,199,99,100,95,0,77,162,161,1,0,161
150354000,6,50907,Figueiredo,205,90,115,205,92,113,98,0,71,210,210,0,0,210
150369000,6,50908,Marmeleiro,228,101,127,205,90,115,105,0,72,215,215,0,0,214
150392000,6,50909,Nesperal,305,146,159,286,134,152,121,0,96,261,261,0,1,260
150421000,6,50910,Palhais,268,122,146,263,120,143,132,0,87,452,452,0,0,449
150463000,6,50911,Pedrógão Pequeno,753,359,394,723,352,371,348,0,239,645,645,0,1,643
150555000,6,50912,Sertã,6196,2946,3250,5899,2784,3115,2376,3,1865,4007,4003,4,4,3085
150799000,6,50913,Troviscal,864,422,442,857,422,435,373,0,259,686,685,1,0,679
150872000,6,50914,Várzea dos Cavaleiros,820,390,430,783,368,415,392,0,254,636,636,0,0,634
150933000,6,51001,Fundada,638,311,327,612,296,316,286,1,181,636,636,0,1,634
151053000,6,51002,São João do Peso,204,79,125,187,69,118,63,1,40,178,178,0,1,172
151086000,6,51003,Vila de Rei,2610,1192,1418,2557,1160,1397,981,6,729,2142,2142,0,11,2038
151481000,6,141301,Aboboreira,513,251,262,504,247,257,209,0,164,435,435,0,0,430
151546000,6,141302,Amêndoa,515,251,264,483,236,247,244,2,151,611,611,0,2,608
151657000,6,141303,Cardigos,1086,499,587,1089,491,598,481,3,328,1161,1161,0,4,1149
151846000,6,141304,Carvoeiro,620,303,317,588,282,306,252,1,192,498,498,0,1,497
151960000,6,141305,Envendos,984,468,516,953,453,500,426,2,297,1107,1106,1,2,1099
152149000,6,141306,Mação,2228,1055,1173,2151,1012,1139,895,1,691,1847,1847,0,2,1532
152341000,6,141307,Ortiga,590,278,312,579,271,308,246,1,183,455,454,1,3,453
152383000,6,141308,Penhascoso,802,382,420,759,355,404,362,1,234,889,889,0,1,880
152474000,6,90501,Algodres,349,168,181,334,163,171,148,0,107,308,308,0,0,306
152498000,6,90502,Casal Vasco,227,106,121,222,103,119,88,1,63,198,198,0,1,198
152519000,6,90503,Cortiçô,144,72,72,146,72,74,57,0,45,121,121,0,0,119
152529000,6,90504,Figueiró da Granja,414,206,208,401,191,210,165,0,124,355,355,0,3,343
152554000,6,90505,Fornos de Algodres,1627,742,885,1541,697,844,616,2,497,961,961,0,4,733
152622000,6,90506,Fuinhas,92,46,46,88,43,45,41,0,31,109,109,0,0,107
152634000,6,90507,Infias,242,119,123,228,111,117,83,0,73,171,171,0,0,168
152654000,6,90508,Juncais,284,137,147,272,132,140,121,0,87,253,253,0,1,246
152674000,6,90509,Maceira,229,112,117,216,109,107,100,0,73,263,263,0,0,263
152691000,6,90510,Matança,243,109,134,225,98,127,112,0,72,219,218,1,0,215
152708000,6,90511,Muxagata,241,114,127,231,109,122,87,1,71,240,240,0,1,241
152721000,6,90512,Queiriz,260,118,142,250,112,138,107,1,75,193,193,0,1,194
152743000,6,90513,Sobral Pichorro,208,109,99,191,99,92,90,0,68,207,207,0,0,207
152761000,6,90514,Vila Chã,82,38,44,79,37,42,33,0,25,79,78,1,0,78
152772000,6,90515,Vila Ruiva,168,72,96,167,71,96,70,1,52,189,189,0,2,190
152795000,6,90516,Vila Soeiro do Chão,179,85,94,172,80,92,77,0,63,179,178,1,0,179
152812000,6,90601,Aldeias,328,145,183,297,132,165,136,1,97,270,269,1,5,269
152841000,6,90602,Arcozelo,717,316,401,708,308,400,300,1,202,643,643,0,1,635
152883000,6,90603,Cativelos,724,331,393,720,322,398,319,1,239,683,683,0,4,687
152939000,6,90604,Figueiró da Serra,263,116,147,248,110,138,109,0,89,366,366,0,1,367
152961000,6,90605,Folgosinho,499,234,265,490,229,261,209,1,139,541,541,0,12,550
153028000,6,90606,Freixo da Serra,99,47,52,88,41,47,39,1,24,144,144,0,2,146
153043000,6,90607,Lagarinhos,443,204,239,427,199,228,180,0,138,366,366,0,0,365
153084000,6,90608,Mangualde da Serra,164,78,86,161,75,86,71,0,53,162,162,0,2,160
153106000,6,90609,Melo,498,242,256,472,229,243,212,2,163,494,494,0,3,493
153143000,6,90610,Moimenta da Serra,652,292,360,637,283,354,241,3,180,384,384,0,3,377
153176000,6,90611,Nabais,405,188,217,391,183,208,154,1,125,339,339,0,1,338
153200000,6,90612,Nespereira,758,364,394,726,345,381,297,1,246,562,562,0,1,539
153251000,6,90613,Paços da Serra,601,293,308,567,272,295,250,0,193,459,459,0,6,447
153287000,6,90614,Ribamondego,317,143,174,303,134,169,122,1,97,245,245,0,1,246
153310000,6,90615,Rio Torto,463,204,259,439,195,244,178,1,139,421,421,0,2,421
153334000,6,90616,Gouveia (São Julião),1622,767,855,1687,787,900,622,4,502,947,946,1,7,660
153399000,6,90617,São Paio,828,386,442,799,366,433,341,1,263,673,673,0,1,652
153438000,6,90618,Gouveia (São Pedro),1850,834,1016,1751,781,970,786,3,587,1349,1349,0,13,788
153515000,6,90619,Vila Cortês da Serra,267,125,142,244,114,130,117,0,85,260,260,0,0,257
153543000,6,90620,Vila Franca da Serra,262,119,143,254,114,140,105,0,87,192,191,1,1,191
153564000,6,90621,Vila Nova de Tazem,1708,811,897,1587,743,844,665,1,512,1275,1275,0,2,1208
153651000,6,90622,Vinhó,578,261,317,555,253,302,228,1,181,412,412,0,2,409
153680000,6,91201,Alvoco da Serra,466,214,252,415,190,225,204,0,144,562,562,0,4,539
153712000,6,91202,Cabeça,178,80,98,166,75,91,89,0,48,213,212,1,0,209
153721000,6,91203,Carragozela,380,172,208,353,155,198,137,0,118,190,190,0,2,192
153740000,6,91204,Folhadosa,327,139,188,277,124,153,109,1,86,214,214,0,1,214
153762000,6,91205,Girabolhos,317,151,166,307,143,164,153,0,106,389,389,0,0,389
153786000,6,91206,Lajes,273,124,149,261,116,145,116,0,90,210,210,0,0,209
153803000,6,91207,Loriga,1053,521,532,1004,493,511,431,1,309,910,910,0,4,639
153851000,6,91208,Paranhos,1503,706,797,1504,696,808,573,2,466,979,979,0,3,947
153909000,6,91209,Pinhanços,716,352,364,696,345,351,291,0,234,501,500,1,1,463
153938000,6,91210,Sabugueiro,478,247,231,458,232,226,178,1,141,333,333,0,34,363
153969000,6,91211,Sameice,367,176,191,350,168,182,146,0,120,271,271,0,0,266
153992000,6,91212,Sandomil,917,433,484,892,415,477,381,1,276,704,702,2,1,693
154056000,6,91213,Santa Comba,834,392,442,792,371,421,300,1,257,488,482,6,3,472
154098000,6,91214,Santa Eulália,271,125,146,265,122,143,109,0,82,198,198,0,1,198
154122000,6,91215,Santa Marinha,991,490,501,916,442,474,360,2,299,647,646,1,2,639
154166000,6,91216,Santiago,1205,575,630,1193,563,630,445,1,372,687,687,0,2,652
154224000,6,91217,São Martinho,638,311,327,609,294,315,255,0,208,437,437,0,0,436
154255000,6,91218,São Romão,2743,1324,1419,2574,1227,1347,1014,4,837,1599,1596,3,9,1181
154339000,6,91219,Sazes da Beira,283,131,152,288,130,158,107,1,73,298,298,0,3,301
154357000,6,91220,Seia,6342,2993,3349,6217,2896,3321,2436,5,2032,3869,3869,0,43,2082
154519000,6,91221,Teixeira,187,90,97,177,84,93,87,0,57,240,240,0,2,227
154543000,6,91222,Torrozelo,481,228,253,445,206,239,200,1,154,399,399,0,3,371
154577000,6,91223,Tourais,1440,678,762,1372,642,730,551,1,455,989,988,1,2,957
154652000,6,91224,Travancinha,472,219,253,457,212,245,189,0,144,400,400,0,0,400
154680000,6,91225,Valezim,310,150,160,302,145,157,135,0,101,263,263,0,3,249
154698000,6,91226,Várzea de Meruge,249,122,127,246,118,128,96,0,82,194,194,0,0,194
154717000,6,91227,Vide,583,283,300,567,274,293,266,1,171,986,986,0,2,975
154782000,6,91228,Vila Cova à Coelheira,404,195,209,384,183,201,176,0,127,304,304,0,1,287
154799000,6,91229,Lapa dos Dinheiros,294,135,159,281,128,153,127,0,97,234,234,0,2,233
154817000,6,90201,Ade,73,33,40,72,31,41,34,0,25,108,108,0,0,108
154834000,6,90202,Aldeia Nova,33,14,19,34,15,19,18,0,8,52,52,0,0,52
154860000,6,90203,Almeida,1314,613,701,1257,585,672,508,2,405,824,823,1,8,771
154923000,6,90204,Amoreira,178,81,97,172,81,91,78,0,59,129,129,0,1,129
154967000,6,90205,Azinhal,63,31,32,63,31,32,26,0,19,61,61,0,0,61
154985000,6,90206,Cabreira,91,41,50,94,41,53,31,4,25,112,112,0,5,117
155000000,6,90207,Castelo Bom,216,93,123,213,90,123,80,1,52,208,208,0,1,209
155022000,6,90208,Castelo Mendo,87,36,51,85,34,51,47,0,24,111,111,0,1,111
155037000,6,90209,Freineda,238,110,128,234,109,125,111,1,71,229,229,0,1,230
155069000,6,90210,Freixo,182,88,94,180,86,94,72,0,51,147,147,0,2,147
155092000,6,90211,Junça,124,65,59,118,62,56,55,0,44,131,131,0,0,131
155113000,6,90212,Leomil,104,52,52,103,52,51,55,0,36,118,118,0,0,118
155137000,6,90213,Malhada Sorda,334,138,196,334,136,198,132,2,88,552,552,0,2,554
155180000,6,90214,Malpartida,172,87,85,174,87,87,79,1,52,172,172,0,1,172
155221000,6,90215,Mesquitela,45,22,23,46,22,24,18,0,15,80,80,0,0,80
155237000,6,90216,Mido,46,20,26,52,23,29,29,0,14,71,71,0,0,71
155252000,6,90217,Miuzela,368,187,181,351,177,174,169,0,111,446,446,0,0,445
155308000,6,90218,Monte Perobolço,61,27,34,59,27,32,38,0,18,140,140,0,0,140
155324000,6,90219,Nave de Haver,358,158,200,347,152,195,158,1,108,514,514,0,1,512
155395000,6,90220,Naves,68,36,32,69,37,32,33,0,21,55,55,0,0,55
155418000,6,90221,Parada,114,58,56,111,56,55,55,0,38,193,193,0,0,193
155444000,6,90222,Peva,168,69,99,157,66,91,49,1,35,110,110,0,1,111
155465000,6,90223,Porto de Ovelha,47,21,26,47,21,26,28,0,17,198,198,0,0,195
155489000,6,90224,São Pedro de Rio Seco,181,80,101,177,78,99,87,0,59,188,188,0,0,188
155516000,6,90225,Senouras,38,18,20,38,18,20,23,0,14,58,58,0,0,58
155530000,6,90226,Vale de Coelha,43,22,21,40,19,21,18,0,13,49,49,0,0,49
155550000,6,90227,Vale da Mula,182,97,85,181,96,85,85,0,62,185,185,0,0,181
155584000,6,90228,Vale Verde,95,45,50,90,41,49,46,0,28,118,118,0,0,117
155614000,6,90229,Vilar Formoso,2219,1053,1166,2060,956,1104,882,1,708,1305,1305,0,11,1113
155739000,6,90301,Açores,352,151,201,337,143,194,134,1,106,264,264,0,1,265
155766000,6,90302,Baraçal,227,110,117,229,111,118,95,1,64,214,213,1,1,207
155791000,6,90303,Cadafaz,140,65,75,136,63,73,64,1,41,153,153,0,4,156
155809000,6,90304,Carrapichana,216,99,117,208,95,113,102,0,69,220,219,1,0,219
155832000,6,90305,Cortiçô da Serra,171,73,98,160,69,91,79,0,50,172,172,0,0,171
155849000,6,90306,Forno Telheiro,735,347,388,714,330,384,278,2,219,502,502,0,3,490
155892000,6,90307,Lajeosa do Mondego,698,327,371,665,303,362,264,2,218,441,441,0,5,426
155927000,6,90308,Linhares,259,114,145,261,119,142,118,0,79,312,312,0,6,318
155971000,6,90309,Maçal do Chão,160,81,79,163,83,80,62,0,47,152,152,0,0,152
155990000,6,90310,Mesquitela,238,111,127,238,110,128,104,0,75,280,280,0,2,282
156021000,6,90311,Minhocal,175,82,93,167,75,92,69,0,55,157,157,0,0,157
156036000,6,90312,Prados,180,86,94,174,85,89,72,1,56,240,240,0,1,240
156059000,6,90313,Rapa,162,77,85,166,81,85,66,1,48,146,146,0,3,149
156074000,6,90314,Ratoeira,303,139,164,292,132,160,113,1,87,217,217,0,1,218
156093000,6,90315,Salgueirais,114,56,58,112,54,58,47,0,35,146,146,0,0,146
156109000,6,90316,Celorico (Santa Maria),895,424,471,868,410,458,373,0,296,701,701,0,2,495
156152000,6,90317,Celorico (São Pedro),1383,645,738,1345,632,713,510,2,422,869,861,8,4,672
156216000,6,90318,Vale de Azares,400,191,209,385,182,203,169,1,124,360,360,0,1,361
156248000,6,90319,Velosa,114,53,61,114,53,61,44,0,32,95,95,0,0,94
156264000,6,90320,Vide entre Vinhas,165,77,88,150,68,82,79,0,50,180,180,0,0,180
156281000,6,90321,Vila Boa do Mondego,107,47,60,109,49,60,48,1,33,136,136,0,1,136
156296000,6,90322,Casas do Soeiro,499,256,243,477,243,234,176,0,165,343,343,0,1,336
156322000,6,90401,Algodres,294,132,162,276,123,153,120,1,86,319,319,0,1,319
156363000,6,90402,Almofala,181,80,101,178,79,99,95,0,60,273,273,0,0,273
156408000,6,90403,Castelo Rodrigo,517,253,264,515,253,262,153,2,133,252,252,0,5,249
156445000,6,90404,Cinco Vilas,94,45,49,89,43,46,45,0,28,95,95,0,0,95
156463000,6,90405,Colmeal,42,23,19,44,24,20,25,0,11,90,90,0,0,89
156480000,6,90406,Escalhão,770,355,415,751,343,408,307,1,228,706,706,0,2,696
156533000,6,90407,Escarigo,99,39,60,99,39,60,47,0,34,108,108,0,0,108
156557000,6,90408,Figueira de Castelo Rodrigo,2211,1095,1116,2109,1041,1068,850,0,703,1408,1406,2,6,1172
156660000,6,90409,Freixeda do Torrão,262,120,142,253,114,139,113,1,73,248,248,0,1,246
156686000,6,90410,Mata de Lobos,383,174,209,361,164,197,145,1,97,394,394,0,1,392
156748000,6,90411,Penha de Águia,111,48,63,106,44,62,59,0,40,131,131,0,0,131
156766000,6,90412,Quintã de Pêro Martins,145,70,75,145,72,73,66,0,51,179,179,0,1,180
156792000,6,90413,Reigada,303,146,157,287,135,152,118,0,100,257,257,0,0,257
156824000,6,90414,Vale de Afonsinho,83,41,42,82,40,42,38,0,31,100,100,0,0,100
156839000,6,90415,Vermiosa,394,189,205,371,180,191,165,0,128,340,335,5,0,335
156887000,6,90416,Vilar de Amargo,158,80,78,152,78,74,76,0,48,215,215,0,1,215
156908000,6,90417,Vilar Torpim,213,106,107,212,105,107,91,0,59,289,288,1,2,289
156955000,6,90701,Adão,233,110,123,229,107,122,100,1,76,248,248,0,1,249
156988000,6,90702,Albardo,143,71,72,133,64,69,61,0,43,190,190,0,0,188
157006000,6,90703,Aldeia do Bispo,220,104,116,207,102,105,82,0,65,113,112,1,1,113
157037000,6,90704,Aldeia Viçosa,341,166,175,330,159,171,137,1,103,421,421,0,2,417
157060000,6,90705,Alvendre,210,102,108,206,100,106,84,0,68,166,166,0,1,165
157083000,6,90706,Arrifana,661,326,335,654,325,329,221,1,185,311,311,0,5,302
157132000,6,90707,Avelãs de Ambom,69,24,45,72,24,48,32,0,18,81,81,0,0,81
157145000,6,90708,Avelãs da Ribeira,196,96,100,197,94,103,81,0,62,164,164,0,0,164
157182000,6,90709,Benespera,297,137,160,284,131,153,134,1,87,255,255,0,1,254
157212000,6,90710,Carvalhal Meão,51,24,27,51,24,27,26,0,19,117,117,0,0,117
157228000,6,90711,Casal de Cinza,561,274,287,506,249,257,215,0,174,369,369,0,0,368
157274000,6,90712,Castanheira,345,161,184,329,152,177,173,0,108,378,378,0,0,376
157330000,6,90713,Cavadoude,324,172,152,314,168,146,113,1,93,239,239,0,1,240
157352000,6,90714,Codesseiro,205,95,110,188,90,98,81,0,60,165,165,0,0,165
157384000,6,90715,Corujeira,118,59,59,117,59,58,48,0,36,100,100,0,0,100
157397000,6,90716,Faia,227,95,132,225,94,131,107,0,76,326,326,0,8,326
157420000,6,90717,Famalicão,615,294,321,608,290,318,273,0,199,475,475,0,1,446
157458000,6,90718,Fernão Joanes,269,123,146,261,119,142,105,1,80,272,272,0,2,269
157487000,6,90719,Gagos,127,64,63,124,61,63,59,0,37,145,145,0,0,144
157510000,6,90720,Gonçalo,1083,518,565,1062,510,552,472,0,363,797,797,0,2,686
157562000,6,90721,Gonçalo Bocas,227,109,118,212,102,110,96,0,69,144,144,0,0,141
157580000,6,90722,João Antão,160,78,82,152,75,77,69,0,52,151,151,0,0,151
157602000,6,90723,Maçainhas,1081,531,550,1028,498,530,401,0,345,588,588,0,0,558
157670000,6,90724,Marmeleiro,361,187,174,342,176,166,177,0,114,503,503,0,0,500
157729000,6,90725,Meios,197,101,96,195,101,94,80,0,58,130,130,0,0,129
157745000,6,90726,Mizarela,135,66,69,131,65,66,61,0,47,190,190,0,1,191
157759000,6,90727,Monte Margarida,36,18,18,36,18,18,21,0,13,64,63,1,0,64
157773000,6,90728,Panoias de Cima,608,305,303,579,285,294,237,0,182,447,447,0,0,437
157820000,6,90729,Pega,161,79,82,163,79,84,77,1,48,350,350,0,1,351
157861000,6,90730,Pêra do Moço,831,400,431,798,385,413,323,1,247,575,575,0,1,569
157925000,6,90731,Pêro Soares,70,35,35,69,35,34,31,0,20,61,61,0,0,61
157939000,6,90732,Porto da Carne,385,175,210,353,157,196,117,2,96,187,186,1,2,169
157958000,6,90733,Pousada,118,52,66,113,49,64,63,0,33,202,201,1,0,201
157979000,6,90734,Ramela,218,105,113,211,102,109,99,0,73,206,206,0,0,206
158005000,6,90735,Ribeira dos Carinhos,108,51,57,106,52,54,45,0,34,105,105,0,0,103
158022000,6,90736,Rocamondo,89,46,43,83,41,42,31,0,26,70,70,0,0,70
158035000,6,90737,Rochoso,264,107,157,263,105,158,106,1,61,281,281,0,2,283
158084000,6,90738,Santana da Azinha,459,230,229,453,226,227,164,2,134,424,424,0,2,424
158122000,6,90739,Jarmelo (São Miguel),187,86,101,204,100,104,73,0,59,158,158,0,0,158
158145000,6,90740,Jarmelo (São Pedro),184,91,93,176,86,90,90,0,55,197,197,0,0,197
158185000,6,90741,Guarda (São Vicente),11679,5444,6235,10857,5007,5850,4486,11,3577,6584,6579,5,12,2633
158412000,6,90742,Guarda (Sé),6958,3345,3613,6893,3331,3562,2574,10,2051,3835,3835,0,22,1746
158606000,6,90743,Seixo Amarelo,84,42,42,79,39,40,47,0,27,119,119,0,0,119
158617000,6,90744,Sobral da Serra,242,117,125,241,115,126,111,0,71,265,265,0,0,265
158644000,6,90745,Trinta,406,201,205,394,195,199,179,0,129,375,375,0,2,349
158674000,6,90746,Vale de Estrela,394,186,208,380,174,206,147,1,123,205,205,0,1,203
158699000,6,90747,Valhelhas,396,201,195,366,179,187,170,0,125,388,388,0,2,356
158729000,6,90748,Vela,490,226,264,471,213,258,174,1,133,423,423,0,1,418
158759000,6,90749,Videmonte,478,214,264,449,200,249,176,1,135,350,350,0,3,350
158783000,6,90750,Vila Cortês do Mondego,298,141,157,291,137,154,106,1,88,169,169,0,1,156
158797000,6,90751,Vila Fernando,500,245,255,479,238,241,196,0,150,436,434,2,0,432
158854000,6,90752,Vila Franca do Deão,153,76,77,154,77,77,64,0,47,104,104,0,0,103
158882000,6,90753,Vila Garcia,320,153,167,305,145,160,126,0,102,243,243,0,0,240
158910000,6,90754,Vila Soeiro,41,18,23,39,17,22,25,0,12,65,65,0,1,66
158921000,6,90755,São Miguel da Guarda,7928,3843,4085,7564,3611,3953,2856,4,2433,3882,3881,1,7,1807
159079000,6,90801,Sameiro,343,162,181,335,156,179,151,0,118,289,289,0,1,283
159109000,6,90802,Manteigas (Santa Maria),1418,680,738,1344,640,704,582,0,448,956,956,0,7,753
159173000,6,90803,Manteigas (São Pedro),1446,670,776,1637,754,883,563,2,422,1056,1056,0,8,908
159236000,6,90804,Vale de Amoreira,223,110,113,218,103,115,95,1,75,302,302,0,2,292
159262000,6,90901,Aveloso,207,107,100,200,103,97,85,0,57,162,162,0,0,160
159278000,6,90902,Barreira,177,77,100,172,76,96,89,0,60,247,247,0,0,247
159302000,6,90903,Carvalhal,109,49,60,103,46,57,50,0,32,115,115,0,0,113
159321000,6,90904,Casteição,119,56,63,113,53,60,58,0,38,204,204,0,0,203
159346000,6,90905,Coriscada,208,95,113,203,88,115,97,1,66,282,282,0,1,283
159393000,6,90906,Fonte Longa,130,54,76,130,54,76,72,0,40,174,174,0,0,174
159415000,6,90907,Longroiva,286,124,162,286,123,163,139,0,95,304,304,0,3,302
159460000,6,90908,Marialva,255,121,134,238,110,128,127,0,88,270,270,0,3,272
159487000,6,90909,Meda,1987,949,1038,1906,909,997,738,3,596,1328,1326,2,6,1127
159594000,6,90910,Outeiro de Gatos,347,174,173,333,166,167,143,0,100,331,331,0,0,318
159643000,6,90911,Pai Penela,67,27,40,61,24,37,33,0,22,88,87,1,0,88
159658000,6,90912,Poço do Canto,443,213,230,424,199,225,203,0,138,416,416,0,0,413
159696000,6,90913,Prova,187,83,104,189,84,105,86,0,57,212,212,0,0,208
159733000,6,90914,Rabaçal,278,126,152,286,135,151,124,0,92,267,267,0,2,269
159762000,6,90915,Ranhados,252,131,121,250,130,120,114,0,89,335,335,0,0,334
159803000,6,90916,Vale Flor,150,74,76,150,74,76,78,0,44,211,211,0,0,211
159833000,6,91001,Alverca da Beira,463,212,251,446,204,242,203,0,152,446,445,1,0,445
159864000,6,91002,Atalaia,99,51,48,99,51,48,52,0,36,187,187,0,0,187
159878000,6,91003,Azevo,195,89,106,193,88,105,104,1,60,276,276,0,1,277
159897000,6,91004,Bogalhal,37,16,21,36,16,20,19,0,11,65,65,0,0,65
159904000,6,91005,Bouça Cova,104,53,51,94,45,49,46,0,34,93,93,0,0,93
159921000,6,91006,Cerejo,132,67,65,131,69,62,71,0,45,186,186,0,0,186
159935000,6,91007,Cidadelhe,40,20,20,39,20,19,23,0,14,62,61,1,0,61
159946000,6,91008,Ervas Tenras,142,69,73,131,64,67,53,0,40,93,93,0,0,92
159960000,6,91009,Ervedosa,190,83,107,189,84,105,84,0,62,126,126,0,0,125
159983000,6,91010,Freixedas,905,421,484,891,413,478,365,1,279,914,914,0,1,909
160063000,6,91011,Gouveia,314,155,159,319,157,162,135,0,99,265,265,0,0,264
160122000,6,91012,Lamegal,253,128,125,223,112,111,118,0,75,253,253,0,0,252
160153000,6,91013,Lameiras,290,136,154,277,131,146,122,0,84,240,240,0,0,240
160171000,6,91014,Manigoto,186,88,98,168,79,89,82,1,56,166,166,0,1,166
160219000,6,91015,Pala,543,247,296,523,236,287,221,1,167,430,430,0,1,426
160237000,6,91016,Pereiro,150,74,76,151,74,77,69,0,49,180,180,0,0,180
160255000,6,91017,Pinhel,3518,1688,1830,3331,1594,1737,1289,2,1078,2117,2116,1,4,1691
160429000,6,91018,Pínzio,453,200,253,450,199,251,192,1,136,471,471,0,1,465
160491000,6,91019,Pomares,120,58,62,119,57,62,58,0,40,144,144,0,0,144
160506000,6,91020,Póvoa d' El-Rei,53,28,25,53,27,26,23,0,19,49,49,0,0,49
160516000,6,91021,Safurdão,108,55,53,103,53,50,50,0,34,121,121,0,0,121
160536000,6,91022,Santa Eufémia,172,83,89,156,72,84,79,0,56,229,229,0,0,229
160565000,6,91023,Sorval,80,36,44,79,35,44,41,0,23,93,93,0,0,93
160580000,6,91024,Souro Pires,588,286,302,588,286,302,224,0,184,465,465,0,0,457
160615000,6,91025,Valbom,214,103,111,204,96,108,92,0,73,174,174,0,0,174
160631000,6,91026,Vale de Madeira,92,47,45,91,46,45,42,0,30,109,109,0,0,109
160651000,6,91027,Vascoveiro,186,91,95,182,89,93,78,0,61,179,179,0,0,179
160669000,6,91101,Águas Belas,175,81,94,175,82,93,77,0,57,283,283,0,0,283
160695000,6,91102,Aldeia do Bispo,286,125,161,286,124,162,111,1,75,350,350,0,1,350
160722000,6,91103,Aldeia da Ponte,317,152,165,302,143,159,127,1,95,500,500,0,1,501
160759000,6,91104,Aldeia da Ribeira,131,67,64,127,65,62,69,0,47,275,275,0,0,275
160784000,6,91105,Aldeia de Santo António,798,384,414,764,363,401,287,1,245,599,599,0,1,596
160825000,6,91106,Aldeia Velha,431,205,226,417,192,225,194,1,122,539,539,0,2,537
160878000,6,91107,Alfaiates,331,163,168,326,158,168,133,1,97,709,709,0,2,710
160925000,6,91108,Badamalos,96,53,43,90,48,42,45,0,27,140,140,0,0,140
160940000,6,91109,Baraçal,190,88,102,169,78,91,83,0,55,251,249,2,0,251
160966000,6,91110,Bendada,580,268,312,551,255,296,244,1,180,613,613,0,1,604
161000000,6,91111,Bismula,193,86,107,190,83,107,73,1,46,208,208,0,1,209
161019000,6,91112,Casteleiro,365,167,198,366,166,200,176,1,108,486,486,0,1,487
161053000,6,91113,Cerdeira,229,105,124,231,99,132,91,1,57,229,229,0,1,226
161081000,6,91114,Fóios,362,162,200,358,159,199,157,1,115,323,323,0,1,323
161114000,6,91115,Forcalhos,88,44,44,86,42,44,43,0,31,212,212,0,0,212
161132000,6,91116,Lajeosa,201,84,117,203,85,118,88,1,51,333,333,0,1,334
161163000,6,91117,Lomba,57,29,28,57,29,28,28,0,18,104,104,0,0,104
161177000,6,91118,Malcata,332,149,183,324,146,178,147,1,94,482,481,1,1,483
161198000,6,91119,Moita,103,54,49,103,55,48,58,0,34,173,173,0,0,168
161218000,6,91120,Nave,230,105,125,233,103,130,111,1,58,385,385,0,1,386
161255000,6,91121,Pena Lobo,141,72,69,133,67,66,65,0,47,143,143,0,0,143
161268000,6,91122,Pousafoles do Bispo,277,120,157,266,114,152,117,1,85,261,261,0,1,259
161310000,6,91123,Quadrazais,457,220,237,458,220,238,216,1,132,750,750,0,2,750
161375000,6,91124,Quinta de São Bartolomeu,180,89,91,166,86,80,75,0,50,269,269,0,0,268
161392000,6,91125,Rapoula do Côa,195,101,94,193,104,89,77,1,52,254,254,0,1,253
161407000,6,91126,Rebolosa,222,110,112,215,101,114,97,1,58,249,249,0,1,249
161429000,6,91127,Rendo,278,130,148,262,119,143,126,0,83,462,462,0,0,462
161460000,6,91128,Ruivós,70,27,43,89,41,48,27,0,22,98,98,0,0,97
161472000,6,91129,Ruvina,112,46,66,102,45,57,41,1,26,142,140,2,1,142
161486000,6,91130,Sabugal,1943,908,1035,1812,843,969,771,1,598,1603,1599,4,6,1417
161618000,6,91131,Santo Estêvão,310,147,163,303,146,157,139,1,91,429,429,0,1,430
161646000,6,91132,Seixo do Côa,171,85,86,153,78,75,83,0,54,276,276,0,0,276
161672000,6,91133,Sortelha,444,211,233,428,207,221,200,1,137,548,548,0,10,556
161709000,6,91134,Souto,1224,577,647,1159,541,618,464,2,351,1057,1057,0,2,1022
161787000,6,91135,Vale das Éguas,39,17,22,38,17,21,25,0,12,78,78,0,0,78
161794000,6,91136,Vale de Espinho,393,173,220,390,172,218,180,1,116,598,598,0,1,599
161822000,6,91137,Vale Longo,47,23,24,55,27,28,28,0,9,102,102,0,0,102
161834000,6,91138,Vila Boa,243,120,123,233,118,115,103,0,76,308,308,0,0,307
161848000,6,91139,Vila do Touro,183,84,99,177,81,96,76,1,51,269,269,0,1,270
161870000,6,91140,Vilar Maior,120,54,66,117,53,64,71,0,30,240,240,0,2,240
161894000,6,91301,Aldeia Nova,332,153,179,325,149,176,131,1,93,323,323,0,1,324
161930000,6,91302,Carnicães,153,64,89,149,63,86,65,0,50,142,141,1,0,141
161947000,6,91303,Castanheira,194,105,89,244,117,127,73,0,62,105,105,0,0,105
161963000,6,91304,Cogula,195,94,101,194,93,101,77,1,51,204,204,0,1,204
161982000,6,91305,Cótimos,220,107,113,224,105,119,90,0,76,212,212,0,0,211
162011000,6,91306,Feital,65,31,34,64,30,34,27,0,19,99,99,0,2,101
162024000,6,91307,Fiães,273,135,138,272,134,138,114,0,90,239,239,0,0,237
162053000,6,91308,Freches,456,213,243,439,209,230,191,0,141,420,420,0,0,418
162083000,6,91309,Granja,151,75,76,141,68,73,65,0,45,204,204,0,0,204
162109000,6,91310,Guilheiro,184,91,93,184,91,93,77,0,56,207,207,0,0,201
162129000,6,91311,Moimentinha,229,106,123,209,96,113,98,0,74,184,184,0,0,184
162147000,6,91312,Moreira de Rei,508,233,275,501,231,270,231,0,168,466,466,0,0,466
162205000,6,91313,Palhais,196,90,106,171,77,94,75,0,67,152,152,0,1,151
162224000,6,91314,Póvoa do Concelho,276,132,144,265,131,134,110,0,82,238,238,0,0,237
162246000,6,91315,Reboleiro,324,146,178,289,123,166,90,3,61,150,150,0,2,150
162261000,6,91316,Rio de Mel,323,164,159,323,163,160,132,0,105,221,221,0,0,217
162287000,6,91317,Trancoso (Santa Maria),1577,771,806,1529,741,788,605,1,470,1101,1101,0,4,941
162391000,6,91318,Trancoso (São Pedro),1712,780,932,1684,759,925,582,4,488,1106,1106,0,5,886
162498000,6,91319,Sebadelhe da Serra,130,66,64,130,66,64,63,0,47,140,140,0,0,140
162517000,6,91320,Souto Maior,131,62,69,131,62,69,66,0,42,175,175,0,0,175
162535000,6,91321,Tamanhos,250,120,130,237,108,129,107,0,83,274,274,0,0,273
162561000,6,91322,Terrenho,113,55,58,110,52,58,47,0,37,119,119,0,2,120
162582000,6,91323,Torre do Terrenho,158,68,90,158,68,90,66,0,47,169,169,0,0,169
162610000,6,91324,Torres,137,62,75,135,60,75,63,0,40,168,168,0,0,168
162632000,6,91325,Valdujo,185,84,101,182,82,100,92,0,61,297,297,0,0,297
162660000,6,91326,Vale do Seixo,127,56,71,127,56,71,57,0,42,147,147,0,0,146
162678000,6,91327,Vila Franca das Naves,965,475,490,921,450,471,394,0,292,689,689,0,2,643
162721000,6,91328,Vila Garcia,118,61,57,116,59,57,60,0,41,168,168,0,0,168
162742000,6,91329,Vilares,196,87,109,193,85,108,87,0,64,208,208,0,0,206
162770000,6,50201,Alcains,5022,2463,2559,4777,2331,2446,1984,3,1582,3110,3109,1,5,2373
162893000,6,50202,Almaceda,677,310,367,614,274,340,332,1,201,576,575,1,1,576
162979000,6,50203,Benquerenças,720,357,363,692,341,351,322,1,239,651,651,0,1,643
163015000,6,50204,Cafede,263,122,141,257,118,139,116,0,88,211,211,0,0,210
163036000,6,50205,Castelo Branco,35242,16645,18597,34318,15998,18320,14023,19,10899,19711,19692,19,39,7020
163605000,6,50206,Cebolais de Cima,1026,485,541,993,467,526,457,1,329,733,733,0,2,698
163647000,6,50207,Escalos de Baixo,746,350,396,734,342,392,334,0,244,692,692,0,1,676
163688000,6,50208,Escalos de Cima,938,462,476,883,428,455,397,0,298,681,677,4,0,659
163708000,6,50209,Freixial do Campo,468,226,242,441,213,228,196,1,151,342,342,0,1,335
163735000,6,50210,Juncal do Campo,355,158,197,338,147,191,175,0,119,476,475,1,0,473
163768000,6,50211,Lardosa,961,446,515,968,447,521,408,2,307,851,851,0,3,829
163791000,6,50212,Louriçal do Campo,636,313,323,607,292,315,280,1,188,587,586,1,1,574
163833000,6,50213,Lousa,621,304,317,612,295,317,294,0,209,498,498,0,0,484
163847000,6,50214,Malpica do Tejo,517,242,275,526,246,280,273,0,157,742,742,0,2,743
163886000,6,50215,Mata,470,226,244,451,215,236,224,0,159,492,491,1,1,490
163910000,6,50216,Monforte da Beira,378,184,194,381,185,196,201,0,117,634,631,3,0,631
163936000,6,50217,Ninho do Açor,380,194,186,392,200,192,166,0,129,327,327,0,0,321
163950000,6,50218,Póvoa de Rio de Moinhos,663,330,333,623,306,317,294,0,217,597,597,0,0,584
163973000,6,50219,Retaxo,843,402,441,803,376,427,372,0,284,605,605,0,1,583
164021000,6,50220,Salgueiro do Campo,891,411,480,864,397,467,376,2,266,745,744,1,2,741
164078000,6,50221,Santo André das Tojeiras,747,345,402,725,336,389,400,0,255,968,968,0,0,968
164178000,6,50222,São Vicente da Beira,1259,609,650,1191,575,616,521,1,372,1389,1388,1,4,1365
164257000,6,50223,Sarzedas,1335,613,722,1317,602,715,671,1,437,1664,1663,1,1,1664
164457000,6,50224,Sobral do Campo,366,174,192,353,168,185,165,0,117,447,447,0,0,443
164479000,6,50225,Tinalhas,585,290,295,576,280,296,263,0,193,587,587,0,1,586
164507000,6,50501,Alcafozes,202,94,108,215,99,116,106,0,64,347,347,0,1,348
164531000,6,50502,Aldeia de Santa Margarida,292,144,148,289,142,147,139,0,98,427,426,1,1,427
164546000,6,50503,Idanha-a-Nova,2352,1125,1227,2419,1135,1284,906,3,679,1881,1881,0,9,1733
164647000,6,50504,Idanha-a-Velha,63,30,33,61,28,33,33,0,23,93,93,0,1,94
164654000,6,50505,Ladoeiro,1290,622,668,1291,614,677,551,1,415,1100,1098,2,2,1097
164726000,6,50506,Medelim,272,126,146,263,121,142,135,0,85,379,379,0,1,373
164749000,6,50507,Monfortinho,536,251,285,494,232,262,267,0,180,631,631,0,6,609
164792000,6,50508,Monsanto,829,369,460,884,389,495,412,1,250,1260,1260,0,1,1253
164877000,6,50509,Oledo,355,162,193,352,160,192,176,0,109,422,422,0,0,419
164898000,6,50510,Penha Garcia,748,361,387,726,347,379,363,1,242,1069,1069,0,1,1059
164961000,6,50511,Proença-a-Velha,224,104,120,228,108,120,103,1,74,370,370,0,1,371
164988000,6,50512,Rosmaninhal,537,261,276,531,265,266,268,0,184,982,982,0,3,985
165082000,6,50513,Salvaterra do Extremo,170,79,91,169,80,89,91,0,58,455,455,0,0,454
165116000,6,50514,São Miguel de Acha,560,272,288,584,286,298,266,0,185,582,582,0,1,579
165146000,6,50515,Segura,176,87,89,171,85,86,95,0,62,312,312,0,0,312
165173000,6,50516,Toulões,237,113,124,231,108,123,132,0,88,454,454,0,0,454
165203000,6,50517,Zebreira,873,421,452,868,417,451,344,1,271,1071,1063,8,1,1063
165281000,6,50701,Águas,300,148,152,290,145,145,154,0,100,395,395,0,0,395
165302000,6,50702,Aldeia do Bispo,676,333,343,583,291,292,307,0,220,783,783,0,0,778
165330000,6,50703,Aldeia de João Pires,195,97,98,184,89,95,102,0,70,329,329,0,0,329
165357000,6,50704,Aranhas,353,180,173,346,177,169,184,0,106,450,450,0,0,450
165375000,6,50705,Bemposta,120,59,61,111,54,57,59,0,42,199,199,0,0,197
165394000,6,50706,Benquerença,575,277,298,548,262,286,285,0,186,820,820,0,0,819
165428000,6,50707,Meimão,280,139,141,267,131,136,141,0,97,300,300,0,0,299
165448000,6,50708,Meimoa,373,179,194,351,170,181,178,0,122,417,417,0,0,415
165474000,6,50709,Pedrógão de São Pedro,500,243,257,484,236,248,242,0,165,498,498,0,0,498
165517000,6,50710,Penamacor,1577,752,825,1474,695,779,630,3,472,1412,1412,0,10,1272
165601000,6,50711,Salvador,476,237,239,466,231,235,231,0,150,557,557,0,0,556
165627000,6,50712,Vale da Senhora da Póvoa,257,116,141,250,115,135,136,0,81,365,365,0,0,365
165645000,6,51101,Fratel,608,284,324,586,272,314,289,2,185,848,848,0,3,849
165751000,6,51102,Perais,510,247,263,508,244,264,250,0,177,488,487,1,0,474
165810000,6,51103,Sarnadas de Ródão,637,289,348,620,281,339,254,2,179,559,557,2,2,555
165879000,6,51104,Vila Velha de Ródão,1766,824,942,1797,822,975,767,3,558,1515,1515,0,8,1489
166031000,6,50101,Belmonte,3183,1497,1686,3067,1436,1631,1193,3,963,2063,2062,1,6,1512
166160000,6,50102,Caria,1921,937,984,1842,890,952,807,0,639,1424,1423,1,3,1303
166278000,6,50103,Colmeal da Torre,729,358,371,707,341,366,289,0,231,512,512,0,0,485
166322000,6,50104,Inguias,670,336,334,660,330,330,296,0,223,618,618,0,0,603
166385000,6,50105,Maçainhas,356,166,190,355,163,192,164,0,111,311,311,0,0,307
166427000,6,50301,Vila do Carvalho,1741,853,888,1657,805,852,707,1,553,1093,1093,0,1,793
166480000,6,50302,Aldeia de São Francisco de Assis,632,303,329,578,278,300,266,1,191,504,504,0,2,506
166535000,6,50303,Aldeia do Souto,240,111,129,231,105,126,97,2,73,198,198,0,3,197
166558000,6,50304,Barco,473,211,262,468,207,261,202,1,147,457,457,0,1,441
166599000,6,50305,Boidobra,3246,1606,1640,3183,1570,1613,1251,1,1021,1622,1622,0,3,938
166663000,6,50306,Casegas,425,179,246,395,162,233,197,2,120,578,577,1,2,578
166712000,6,50307,Covilhã (Conceição),7175,3382,3793,7513,3528,3985,3070,0,2293,4511,4509,2,8,1450
166829000,6,50308,Cortes do Meio,884,430,454,865,414,451,357,1,265,1077,1077,0,6,961
166904000,6,50309,Dominguizo,1119,554,565,1073,531,542,443,2,352,682,682,0,3,510
166938000,6,50310,Erada,709,342,367,672,325,347,309,0,234,655,655,0,0,622
166999000,6,50311,Ferro,1700,816,884,1652,791,861,676,1,509,1173,1173,0,2,1085
167051000,6,50312,Orjais,806,386,420,782,372,410,332,0,268,532,532,0,1,491
167097000,6,50313,Ourondo,372,164,208,354,152,202,154,1,104,356,356,0,1,354
167140000,6,50314,Paul,1624,772,852,1551,728,823,651,2,497,1147,1147,0,3,1061
167219000,6,50315,Peraboa,953,440,513,952,433,519,374,1,287,616,615,1,1,587
167270000,6,50316,Peso,737,344,393,715,330,385,292,0,231,597,597,0,0,556
167306000,6,50317,Covilhã (Santa Maria),3220,1448,1772,3911,1759,2152,1408,5,911,2689,2689,0,7,583
167374000,6,50318,São Jorge da Beira,633,304,329,599,286,313,279,1,200,670,670,0,1,653
167412000,6,50319,Covilhã (São Martinho),4165,1960,2205,5590,2715,2875,1744,3,1260,2981,2980,1,11,1040
167475000,6,50320,Covilhã (São Pedro),2225,1056,1169,2162,1019,1143,884,4,660,1278,1278,0,7,587
167538000,6,50321,Sarzedo,130,59,71,127,58,69,67,0,39,232,232,0,0,232
167554000,6,50322,Sobral de São Miguel,418,190,228,398,183,215,197,1,115,492,492,0,1,490
167588000,6,50323,Teixoso,4360,2108,2252,4217,2023,2194,1739,1,1390,2386,2384,2,3,1533
167682000,6,50324,Tortosendo,5624,2742,2882,5362,2586,2776,2166,3,1752,3156,3156,0,3,1975
167790000,6,50325,Unhais da Serra,1398,672,726,1433,684,749,596,1,438,999,999,0,3,791
167833000,6,50326,Vale Formoso,574,270,304,560,261,299,228,0,190,496,495,1,0,481
167868000,6,50327,Verdelhos,664,329,335,637,311,326,280,1,198,790,790,0,2,763
167917000,6,50328,Vales do Rio,674,333,341,649,321,328,268,0,202,442,442,0,0,410
167956000,6,50329,Coutada,406,191,215,377,182,195,173,0,134,365,365,0,0,358
167993000,6,50330,Cantar-Galo,2233,1095,1138,2149,1039,1110,936,0,737,1314,1314,0,0,688
168029000,6,50331,Canhoso,2237,1075,1162,2129,1007,1122,877,0,727,1139,1133,6,1,369
168067000,6,50401,Alcaide,616,300,316,607,290,317,261,0,193,546,546,0,0,526
168111000,6,50402,Alcaria,1180,575,605,1146,556,590,462,2,351,763,763,0,4,674
168173000,6,50403,Alcongosta,497,234,263,476,219,257,211,0,153,385,385,0,0,369
168195000,6,50404,Aldeia de Joanes,1333,645,688,1263,607,656,476,2,413,707,707,0,3,493
168241000,6,50405,Aldeia Nova do Cabo,600,296,304,578,288,290,260,1,185,458,457,1,2,445
168269000,6,50406,Alpedrinha,1087,523,564,1020,484,536,410,1,322,819,819,0,4,755
168320000,6,50407,Atalaia do Campo,546,271,275,523,264,259,251,0,183,478,478,0,0,469
168344000,6,50408,Barroca,496,244,252,470,224,246,228,0,161,590,590,0,0,582
168388000,6,50409,Bogas de Baixo,194,95,99,188,91,97,105,0,68,310,310,0,0,310
168423000,6,50410,Bogas de Cima,347,162,185,338,163,175,150,0,112,361,360,1,0,356
168458000,6,50411,Capinha,494,234,260,489,234,255,215,1,152,561,561,0,1,558
168495000,6,50412,Castelejo,656,299,357,633,283,350,282,0,208,474,474,0,0,469
168550000,6,50413,Castelo Novo,406,194,212,392,185,207,157,0,125,464,464,0,2,465
168593000,6,50414,Donas,863,419,444,905,435,470,336,1,273,538,538,0,2,500
168620000,6,50415,Escarigo,224,100,124,215,96,119,113,0,79,297,297,0,0,293
168641000,6,50416,Fatela,564,266,298,536,249,287,225,0,175,490,489,1,0,486
168668000,6,50417,Fundão,9236,4421,4815,8735,4160,4575,3606,6,2806,5219,5208,11,17,2030
168858000,6,50418,Janeiro de Cima,306,140,166,299,136,163,136,0,99,320,320,0,2,319
168892000,6,50419,Lavacolhos,236,119,117,235,118,117,109,0,73,274,274,0,0,273
168914000,6,50420,Orca,650,323,327,640,320,320,324,0,209,801,797,4,4,802
168987000,6,50421,Pêro Viseu,728,347,381,751,370,381,305,0,230,675,675,0,0,671
169051000,6,50422,Póvoa de Atalaia,642,295,347,593,276,317,295,0,203,531,531,0,0,527
169106000,6,50423,Salgueiro,690,329,361,670,321,349,313,1,220,612,611,1,3,609
169148000,6,50424,Silvares,968,478,490,931,454,477,394,0,310,850,850,0,9,827
169205000,6,50425,Soalheira,891,439,452,867,420,447,365,1,264,688,688,0,1,667
169265000,6,50426,Souto da Casa,807,372,435,786,362,424,362,0,257,754,754,0,0,726
169328000,6,50427,Telhado,618,298,320,607,293,314,262,0,198,471,469,2,0,456
169365000,6,50428,Vale de Prazeres,1267,587,680,1246,572,674,571,0,400,1229,1227,2,0,1220
169453000,6,50429,Valverde,1402,669,733,1329,620,709,518,0,449,752,752,0,0,711
169514000,6,50430,Mata da Rainha,149,67,82,148,67,81,81,0,57,232,232,0,0,230
169527000,6,50431,Enxames,520,265,255,491,248,243,212,0,163,355,355,0,0,350
169557000,6,100101,Alcobaça,5751,2624,3127,5394,2429,2965,2405,6,1704,3405,3404,1,11,1009
169641000,6,100102,Alfeizerão,3854,1867,1987,3746,1806,1940,1514,2,1207,2509,2508,1,4,2274
169815000,6,100103,Alpedriz,777,389,388,737,362,375,314,0,241,440,436,4,0,412
169858000,6,100104,Bárrio,1523,762,761,1466,733,733,597,0,503,821,821,0,0,786
169909000,6,100105,Benedita,8635,4190,4445,8233,3968,4265,3077,5,2526,3894,3890,4,8,3057
170187000,6,100106,Cela,3264,1599,1665,3094,1497,1597,1242,1,1024,1720,1720,0,1,1682
170306000,6,100107,Coz,1895,910,985,1811,868,943,744,0,607,1003,1002,1,0,960
170369000,6,100108,Évora de Alcobaça,4485,2200,2285,4312,2089,2223,1670,3,1375,2315,2315,0,5,2256
170537000,6,100109,Maiorga,2050,978,1072,1912,911,1001,816,0,665,1154,1152,2,0,1033
170600000,6,100110,Pataias,5451,2692,2759,5214,2554,2660,2199,2,1768,3865,3857,8,6,3039
170820000,6,100111,Aljubarrota (Prazeres),4235,2055,2180,4013,1932,2081,1651,1,1341,2286,2268,18,1,1882
170944000,6,100112,São Martinho do Porto,2868,1351,1517,2791,1303,1488,1210,1,860,4891,4889,2,13,2427
171091000,6,100113,Aljubarrota (São Vicente),2404,1180,1224,2321,1124,1197,917,0,728,1286,1286,0,1,1247
171195000,6,100114,Turquel,4561,2229,2332,4360,2108,2252,1636,3,1366,2265,2261,4,3,1951
171392000,6,100115,Vestiaria,1258,612,646,1211,585,626,507,2,395,740,740,0,3,661
171428000,6,100116,Vimeiro,1948,980,968,1886,934,952,727,1,606,1068,1067,1,1,1056
171513000,6,100118,Martingança,1145,557,588,1098,535,563,444,0,358,598,598,0,2,566
171558000,6,100119,Montes,589,282,307,556,263,293,238,0,187,365,364,1,0,365
171585000,6,100501,Bombarral,5664,2665,2999,5398,2502,2896,2222,4,1749,3430,3428,2,6,2076
171758000,6,100502,Carvalhal,2634,1272,1362,2527,1203,1324,1055,1,842,1711,1711,0,3,1675
171888000,6,100503,Roliça,2808,1406,1402,2680,1320,1360,1107,3,875,1684,1681,3,3,1583
172014000,6,100504,Vale Covo,1157,566,591,1107,533,574,484,1,377,697,697,0,1,665
172083000,6,100505,Pó,930,444,486,881,417,464,343,0,297,503,499,4,0,490
172129000,6,100601,A dos Francos,1701,815,886,1661,791,870,610,5,521,875,873,2,5,854
172215000,6,100602,Alvorninha,2987,1451,1536,2893,1398,1495,1103,5,914,1672,1672,0,5,1642
172392000,6,100603,Caldas da Rainha (Nossa Senhora do Pópulo),16114,7418,8696,15342,6987,8355,6763,17,4812,9730,9725,5,89,3541
172653000,6,100604,Carvalhal Benfeito,1279,623,656,1239,606,633,473,0,403,666,665,1,0,653
172727000,6,100605,Coto,1344,645,699,1274,609,665,485,0,420,659,659,0,1,622
172772000,6,100606,Foz do Arelho,1339,643,696,1347,640,707,590,1,399,1721,1720,1,8,923
172839000,6,100607,Landal,1051,506,545,1012,487,525,384,0,334,540,540,0,0,538
172911000,6,100608,Nadadouro,1904,941,963,1823,886,937,696,5,568,1212,1210,2,5,1143
172979000,6,100609,Salir de Matos,2583,1259,1324,2488,1204,1284,956,2,817,1462,1462,0,2,1442
173094000,6,100610,Salir do Porto,797,373,424,756,350,406,352,0,256,898,897,1,0,766
173149000,6,100611,Santa Catarina,3029,1481,1548,2860,1384,1476,1069,4,904,1422,1421,1,4,1374
173276000,6,100612,São Gregório,955,458,497,937,440,497,354,3,296,535,535,0,3,530
173312000,6,100613,Serra do Bouro,703,344,359,686,330,356,298,0,237,592,591,1,0,591
173364000,6,100614,Tornada,3561,1737,1824,3417,1640,1777,1327,3,1109,1947,1946,1,3,1790
173453000,6,100615,Vidais,1159,578,581,1121,553,568,461,1,368,799,799,0,1,787
173511000,6,100616,Caldas da Rainha (Santo Onofre),11223,5233,5990,10694,4898,5796,4629,2,3513,6204,6194,10,3,2006
173666000,6,101101,Famalicão,1740,837,903,1671,795,876,685,1,540,1225,1221,4,1,1139
173759000,6,101102,Nazaré,10309,4906,5403,10026,4694,5332,4115,4,3197,10324,10312,12,26,5093
174163000,6,101103,Valado dos Frades,3109,1494,1615,2979,1415,1564,1187,1,997,1570,1566,4,2,1396
174254000,6,101201,A dos Negros,1489,732,757,1415,683,732,565,1,461,870,870,0,1,854
174308000,6,101202,Amoreira,989,478,511,1189,588,601,428,0,314,1641,1640,1,2,1312
174363000,6,101203,Olho Marinho,1279,642,637,1245,619,626,519,1,399,893,892,1,3,880
174419000,6,101204,Óbidos (Santa Maria),2032,977,1055,1969,930,1039,753,2,604,1279,1277,2,9,1255
174576000,6,101205,Óbidos (São Pedro),1308,618,690,1293,604,689,500,0,395,852,852,0,15,825
174670000,6,101206,Sobral da Lagoa,439,206,233,432,200,232,182,0,144,340,340,0,0,336
174700000,6,101207,Vau,952,481,471,915,461,454,378,0,307,1444,1442,2,0,1341
174777000,6,101208,Gaeiras,2331,1127,1204,2222,1062,1160,909,1,728,1150,1149,1,1,976
174835000,6,101209,Usseira,953,463,490,970,484,486,362,0,297,527,527,0,0,507
174874000,6,101401,Peniche (Ajuda),7989,3830,4159,7781,3649,4132,3159,3,2469,4851,4800,51,14,1964
175022000,6,101402,Atouguia da Baleia,8954,4386,4568,8547,4143,4404,3378,4,2811,7201,7194,7,17,5122
175428000,6,101403,Peniche (Conceição),4643,2230,2413,4462,2116,2346,1934,0,1477,2794,2790,4,5,1457
175537000,6,101404,Peniche (São Pedro),2117,1032,1085,1986,961,1025,886,2,677,1423,1421,2,8,988
175609000,6,101405,Serra d' El-Rei,1401,685,716,1334,643,691,571,0,448,935,935,0,3,897
175710000,6,101406,Ferrel,2649,1281,1368,2559,1222,1337,1043,2,825,3958,3955,3,13,2901
175945000,6,110101,Abrigada,3320,1593,1727,3206,1531,1675,1304,5,1035,1979,1978,1,5,1917
176103000,6,110102,Aldeia Galega da Merceana,2079,996,1083,2007,948,1059,820,1,617,1221,1218,3,1,1062
176213000,6,110103,Aldeia Gavinha,1142,546,596,1117,525,592,476,0,370,662,661,1,0,648
176256000,6,110104,Cabanas de Torres,989,480,509,951,458,493,394,0,308,587,587,0,0,572
176316000,6,110105,Cadafais,1734,836,898,1661,793,868,696,1,556,915,912,3,1,702
176364000,6,110106,Carnota,1678,820,858,1629,794,835,642,1,541,938,936,2,1,921
176459000,6,110107,Meca,1719,847,872,1662,808,854,651,0,558,939,939,0,0,911
176529000,6,110108,Olhalvo,1907,901,1006,1833,859,974,716,2,591,992,992,0,2,975
176586000,6,110109,Ota,1289,645,644,2069,1238,831,512,1,421,647,647,0,1,524
176627000,6,110110,Pereiro de Palhacana,577,296,281,557,286,271,236,1,189,434,434,0,3,433
176672000,6,110111,Alenquer (Santo Estêvão),6687,3217,3470,6479,3087,3392,2594,1,2098,3741,3739,2,4,2100
176793000,6,110112,Alenquer (Triana),4134,2016,2118,3973,1917,2056,1609,0,1307,2113,2113,0,3,1396
176886000,6,110113,Ventosa,2173,1039,1134,2087,993,1094,866,2,679,1467,1466,1,2,1410
177013000,6,110114,Vila Verde dos Francos,1162,586,576,1136,567,569,448,0,384,697,697,0,0,694
177082000,6,110115,Carregado,11707,5770,5937,11093,5386,5707,4403,2,3531,5589,5585,4,3,1460
177219000,6,110116,Ribafria,970,478,492,942,459,483,383,0,308,626,626,0,0,607
177272000,6,110201,Arranhó,2381,1180,1201,2352,1155,1197,904,0,760,1176,1176,0,0,1051
177389000,6,110202,Arruda dos Vinhos,8656,4258,4398,8385,4076,4309,3236,7,2627,4281,4280,1,9,2507
177573000,6,110203,Cardosas,836,400,436,815,385,430,321,1,255,462,462,0,1,445
177615000,6,110204,Santiago dos Velhos,1518,733,785,1486,711,775,586,1,459,786,785,1,1,749
177698000,6,110401,Alguber,957,460,497,932,436,496,337,1,302,553,552,1,1,549
177764000,6,110402,Cadaval,3113,1459,1654,2977,1382,1595,1217,1,970,1661,1657,4,2,961
177854000,6,110403,Cercal,560,266,294,449,199,250,236,2,185,427,427,0,2,411
177893000,6,110404,Figueiros,690,333,357,669,323,346,263,0,222,431,431,0,0,424
177929000,6,110405,Lamas,3072,1478,1594,2962,1414,1548,1213,2,958,1961,1958,3,3,1918
178066000,6,110406,Painho,1320,634,686,1267,610,657,522,1,423,724,720,4,1,701
178121000,6,110407,Peral,905,467,438,878,447,431,368,0,284,647,647,0,2,626
178172000,6,110408,Pêro Moniz,639,321,318,612,308,304,263,0,199,430,425,5,1,421
178228000,6,110409,Vermelha,1288,619,669,1228,577,651,510,1,407,851,851,0,1,822
178304000,6,110410,Vilar,1684,834,850,1646,813,833,651,2,511,1064,1063,1,2,1045
178409000,6,110801,Lourinhã,9897,4703,5194,9431,4458,4973,3947,3,3041,7409,7393,16,12,4573
178809000,6,110802,Miragaia,1822,905,917,1744,853,891,705,0,568,1010,1009,1,0,983
178909000,6,110803,Moita dos Ferreiros,1734,845,889,1676,801,875,702,1,537,1133,1128,5,2,1071
179012000,6,110804,Moledo,472,232,240,461,226,235,188,0,143,318,317,1,0,309
179048000,6,110805,Reguengo Grande,1626,793,833,1547,748,799,632,1,506,1077,1074,3,2,1016
179127000,6,110806,Santa Bárbara,1943,943,1000,1815,864,951,688,1,583,984,982,2,1,932
179219000,6,110807,São Bartolomeu dos Galegos,1011,495,516,971,471,500,400,1,316,748,747,1,3,727
179290000,6,110808,Vimeiro,1470,742,728,1410,705,705,594,2,441,932,932,0,2,755
179370000,6,110809,Marteleira,1761,873,888,1686,827,859,677,1,528,1007,1006,1,1,931
179464000,6,110810,Ribamar,2141,1081,1060,2026,995,1031,846,0,663,1253,1252,1,2,953
179523000,6,110811,Atalaia,1858,906,952,1765,851,914,694,1,569,1164,1164,0,2,1056
179582000,6,111201,Santo Quintino,3706,1843,1863,3677,1800,1877,1427,1,1155,2071,2071,0,1,1839
179775000,6,111202,Sapataria,3044,1534,1510,2958,1485,1473,1121,2,898,1483,1482,1,2,1248
179919000,6,111203,Sobral de Monte Agraço,3406,1626,1780,3270,1562,1708,1311,2,1042,1743,1741,2,3,1026
180030000,6,111301,A dos Cunhados,8459,4190,4269,8001,3907,4094,3123,8,2604,5691,5683,8,10,4353
180348000,6,111302,Campelos,2827,1378,1449,2706,1293,1413,1035,1,885,1367,1364,3,1,1224
180443000,6,111303,Carmões,831,398,433,809,387,422,313,1,247,533,533,0,1,525
180484000,6,111304,Carvoeira,1583,734,849,1534,709,825,628,0,494,1045,1045,0,0,1015
180564000,6,111305,Dois Portos,2124,1012,1112,1995,948,1047,847,0,665,1484,1482,2,0,1434
180679000,6,111306,Freiria,2461,1219,1242,2429,1194,1235,882,1,744,1225,1216,9,1,1164
180771000,6,111307,Matacães,1087,513,574,1047,497,550,394,1,324,593,593,0,1,578
180832000,6,111308,Maxial,2751,1315,1436,2633,1230,1403,1053,2,870,1454,1452,2,2,1415
180956000,6,111309,Monte Redondo,795,371,424,772,363,409,287,2,238,417,417,0,2,386
180991000,6,111310,Ponte do Rol,2444,1163,1281,2379,1120,1259,905,1,759,1090,1090,0,2,910
181057000,6,111311,Ramalhal,3472,1725,1747,3353,1650,1703,1296,1,1080,1675,1673,2,1,1539
181193000,6,111312,Runa,1004,476,528,977,458,519,353,1,290,491,491,0,1,438
181221000,6,111313,Torres Vedras (Santa Maria do Castelo e São Miguel),6665,3180,3485,6444,3033,3411,2669,1,2089,3552,3551,1,2,2066
181393000,6,111314,São Pedro da Cadeira,5077,2557,2520,4938,2464,2474,1788,2,1546,2587,2583,4,3,2341
181559000,6,111315,Torres Vedras (São Pedro e Santiago),17965,8327,9638,17354,7996,9358,7093,9,5494,9282,9276,6,17,3514
181889000,6,111316,Silveira,8530,4180,4350,8182,3972,4210,3207,0,2645,6768,6765,3,6,4564
182244000,6,111317,Turcifal,3342,1628,1714,3351,1625,1726,1269,2,1057,2002,2002,0,5,1742
182381000,6,111318,Ventosa,5276,2639,2637,5117,2544,2573,1938,0,1642,2427,2425,2,1,2336
182559000,6,111319,Outeiro da Cabeça,840,412,428,823,398,425,336,0,268,453,453,0,0,391
182594000,6,111320,Maceira,1932,951,981,1974,958,1016,748,0,612,1149,1148,1,9,881
182655000,6,140101,Aldeia do Mato,441,203,238,420,192,228,207,0,141,610,610,0,2,562
182702000,6,140102,Alferrarede,3884,1857,2027,3718,1767,1951,1538,4,1208,2264,2262,2,4,1644
182799000,6,140103,Alvega,1499,734,765,1455,697,758,616,1,483,1094,1093,1,3,1080
182869000,6,140104,Bemposta,1795,878,917,1709,816,893,741,1,597,1303,1302,1,2,1297
182926000,6,140105,Martinchel,604,299,305,571,276,295,249,0,200,462,462,0,1,458
182964000,6,140106,Mouriscas,1832,878,954,1873,919,954,756,8,558,1472,1470,2,9,1455
183070000,6,140107,Pego,2431,1189,1242,2348,1139,1209,1016,2,788,1650,1649,1,5,1573
183119000,6,140108,Rio de Moinhos,1202,583,619,1133,544,589,487,1,376,779,779,0,4,728
183165000,6,140109,Rossio ao Sul do Tejo,2012,955,1057,2018,951,1067,811,1,617,1186,1185,1,2,766
183208000,6,140110,São Facundo,927,471,456,908,458,450,399,0,295,691,689,2,0,680
183247000,6,140111,Abrantes (São João),1699,767,932,1622,717,905,673,4,491,1064,1064,0,6,593
183299000,6,140112,São Miguel do Rio Torto,2869,1371,1498,2743,1296,1447,1225,1,947,1984,1976,8,3,1804
183385000,6,140113,Abrantes (São Vicente),11622,5594,6028,10964,5208,5756,4520,5,3608,6088,6085,3,9,3016
183589000,6,140114,Souto,418,200,218,405,197,208,194,0,140,604,604,0,0,600
183631000,6,140115,Tramagal,3500,1679,1821,3391,1619,1772,1464,2,1147,2008,2007,1,3,1921
183741000,6,140116,Vale das Mós,588,300,288,559,282,277,250,0,186,428,427,1,0,403
183765000,6,140117,Concavada,653,343,310,606,312,294,252,0,200,426,426,0,1,406
183794000,6,140118,Fontes,627,299,328,611,293,318,283,0,194,711,711,0,0,708
183839000,6,140119,Carvalhal,722,350,372,700,333,367,315,0,230,680,679,1,0,674
183889000,6,140201,Alcanena,4131,2003,2128,3789,1814,1975,1652,2,1270,2262,2260,2,6,1493
184036000,6,140202,Bugalhos,1084,537,547,1048,515,533,406,0,331,588,588,0,0,565
184102000,6,140203,Espinheiro,553,260,293,522,241,281,245,0,177,379,379,0,0,369
184148000,6,140204,Louriceira,583,294,289,559,281,278,239,0,185,353,353,0,0,348
184203000,6,140205,Malhou,773,388,385,760,381,379,309,0,245,527,527,0,0,515
184280000,6,140206,Minde,3293,1551,1742,3139,1463,1676,1272,1,1009,1833,1833,0,1,1422
184433000,6,140207,Moitas Venda,866,408,458,826,388,438,351,0,258,576,576,0,2,554
184476000,6,140208,Monsanto,886,436,450,852,415,437,376,0,276,523,522,1,0,508
184543000,6,140209,Serra de Santo António,725,341,384,765,359,406,289,1,212,454,454,0,2,441
184620000,6,140210,Vila Moreira,974,468,506,926,448,478,411,0,300,568,568,0,0,482
184674000,6,140801,Constância,993,468,525,947,439,508,383,1,298,583,583,0,3,465
184753000,6,140802,Montalvo,1275,625,650,1226,595,631,473,2,398,614,612,2,2,470
184784000,6,140803,Santa Margarida da Coutada,1788,853,935,1836,910,926,709,0,575,978,975,3,1,916
184858000,6,141001,São João Baptista,7576,3552,4024,7309,3363,3946,3270,2,2487,4440,4436,4,5,1581
184992000,6,141002,Nossa Senhora de Fátima,12630,6077,6553,11950,5661,6289,4797,5,3890,6263,6261,2,7,2569
185196000,6,141101,Águas Belas,1072,520,552,1023,490,533,429,0,336,886,885,1,0,858
185340000,6,141102,Areias,1484,693,791,1434,664,770,615,2,440,1476,1475,1,2,1469
185481000,6,141103,Beco,906,416,490,878,406,472,365,0,292,759,759,0,1,759
185599000,6,141104,Chãos,597,278,319,593,275,318,252,0,196,618,618,0,0,612
185672000,6,141105,Dornes,594,288,306,588,287,301,251,1,191,587,585,2,5,585
185741000,6,141106,Ferreira do Zêzere,2353,1136,1217,2284,1097,1187,878,3,705,1800,1800,0,7,1288
185875000,6,141107,Igreja Nova do Sobral,662,312,350,615,285,330,272,1,192,625,624,1,1,615
185981000,6,141108,Paio Mendes,495,239,256,473,226,247,191,0,151,425,425,0,1,419
186054000,6,141109,Pias,456,216,240,446,211,235,185,0,145,332,332,0,0,328
186091000,6,141701,Alcaravela,904,439,465,851,403,448,344,2,278,695,695,0,2,682
186200000,6,141702,Santiago de Montalegre,229,111,118,221,108,113,99,0,73,312,312,0,0,312
186260000,6,141703,Sardoal,2404,1172,1232,2277,1095,1182,906,9,709,1579,1578,1,11,1435
186420000,6,141704,Valhascos,402,194,208,382,184,198,165,2,124,384,384,0,2,381
186453000,6,141801,Alviobeira,623,297,326,596,284,312,247,0,186,476,476,0,1,468
186513000,6,141802,Asseiceira,2945,1417,1528,2801,1332,1469,1167,2,936,1665,1663,2,4,1615
186659000,6,141803,Beselga,751,365,386,729,348,381,321,0,240,645,645,0,0,642
186733000,6,141804,Carregueiros,1179,558,621,1111,518,593,467,0,377,716,716,0,0,698
186798000,6,141805,Casais,2342,1128,1214,2250,1070,1180,927,2,744,1592,1592,0,2,1551
186932000,6,141806,Junceira,889,422,467,879,418,461,319,1,248,670,670,0,3,656
187015000,6,141807,Madalena,3239,1626,1613,3044,1520,1524,1227,6,1005,1784,1784,0,7,1732
187153000,6,141808,Olalhas,1415,690,725,1345,641,704,559,1,407,1302,1302,0,2,1289
187286000,6,141809,Paialvo,2599,1227,1372,2511,1156,1355,1003,9,783,1521,1518,3,11,1491
187469000,6,141810,Pedreira,549,253,296,550,258,292,223,0,185,335,335,0,0,323
187491000,6,141811,Santa Maria dos Olivais,12616,5847,6769,12466,5766,6700,5188,9,3890,7189,7184,5,17,3169
187710000,6,141812,Tomar (São João Baptista),5593,2614,2979,5390,2487,2903,2328,2,1721,3351,3299,52,14,2178
187856000,6,141813,São Pedro de Tomar,3027,1470,1557,2947,1427,1520,1163,4,949,1878,1875,3,4,1813
188035000,6,141814,Sabacheira,955,443,512,918,430,488,406,1,303,867,867,0,1,859
188138000,6,141815,Serra,1191,552,639,1176,537,639,488,1,331,1719,1716,3,2,1691
188291000,6,141816,Além da Ribeira,764,362,402,736,346,390,320,0,247,590,590,0,0,581
188361000,6,141901,Alcorochel,810,391,419,754,358,396,341,1,253,505,504,1,1,503
188399000,6,141902,Assentiz,2921,1390,1531,2838,1348,1490,1177,2,905,1942,1942,0,2,1929
188568000,6,141903,Brogueira,1112,530,582,1083,513,570,431,0,358,661,660,1,0,659
188637000,6,141904,Chancelaria,1659,797,862,1594,763,831,664,2,501,1110,1107,3,2,1099
188753000,6,141905,Lapas,2590,1253,1337,2450,1170,1280,1031,1,802,1240,1240,0,1,762
188801000,6,141906,Olaia,1725,860,865,1658,814,844,695,3,537,1050,1050,0,3,1024
188896000,6,141907,Paço,684,353,331,648,333,315,286,0,223,479,479,0,1,478
188944000,6,141908,Parceiros de Igreja,907,434,473,888,423,465,382,0,294,724,722,2,1,704
189011000,6,141909,Pedrógão,2037,970,1067,1934,917,1017,780,1,625,1246,1245,1,1,1219
189143000,6,141910,Riachos,5247,2496,2751,5080,2396,2684,2053,6,1678,2558,2557,1,7,2193
189244000,6,141911,Ribeira Branca,618,292,326,602,283,319,249,0,204,414,414,0,0,408
189293000,6,141912,Torres Novas (Salvador),2227,1040,1187,2122,977,1145,832,7,618,1154,1153,1,8,693
189363000,6,141913,Torres Novas (Santa Maria),5026,2388,2638,4843,2301,2542,1972,4,1571,2683,2683,0,7,1585
189484000,6,141914,Torres Novas (Santiago),993,466,527,913,425,488,429,0,317,687,686,1,0,580
189549000,6,141915,Torres Novas (São Pedro),5466,2527,2939,5159,2358,2801,2257,6,1711,2998,2995,3,6,1461
189662000,6,141916,Zibreira,1028,508,520,954,467,487,391,2,324,578,577,1,2,557
189724000,6,141917,Meia Via,1667,816,851,1591,770,821,658,1,527,833,833,0,1,749
189764000,6,142001,Atalaia,1697,833,864,1628,792,836,651,1,549,856,856,0,2,789
189832000,6,142002,Praia do Ribatejo,1702,819,883,1716,844,872,684,2,521,1080,1075,5,5,997
189952000,6,142003,Tancos,243,136,107,232,125,107,87,1,68,149,149,0,1,143
189984000,6,142004,Vila Nova da Barquinha,1588,751,837,1503,702,801,656,1,509,953,953,0,2,599
190086000,6,142005,Moita do Norte,2092,1016,1076,2014,954,1060,832,0,674,1064,1063,1,2,886
190183000,6,142101,Alburitel,1179,570,609,1124,533,591,434,3,366,609,609,0,4,605
190223000,6,142102,Atouguia,2454,1187,1267,2374,1130,1244,888,1,722,1354,1354,0,1,1329
190331000,6,142103,Casal dos Bernardos,921,430,491,887,413,474,374,0,290,818,818,0,0,816
190407000,6,142104,Caxarias,2166,1029,1137,2115,992,1123,850,1,676,1477,1474,3,3,1307
190525000,6,142105,Espite,1104,501,603,1070,487,583,457,3,352,1059,1059,0,3,1060
190625000,6,142106,Fátima,11596,5238,6358,11434,5073,6361,3900,97,2997,6575,6566,9,197,3704
190920000,6,142107,Formigais,375,177,198,360,170,190,164,0,120,325,323,2,2,326
190947000,6,142108,Freixianda,2474,1168,1306,2429,1135,1294,939,3,719,1806,1805,1,4,1760
191116000,6,142109,Gondemaria,1175,570,605,1118,536,582,450,0,355,754,752,2,0,744
191177000,6,142110,Olival,1995,953,1042,1931,920,1011,811,2,611,1462,1461,1,3,1450
191314000,6,142111,Nossa Senhora das Misericórdias,5077,2481,2596,4788,2303,2485,1799,3,1474,2729,2728,1,4,2584
191527000,6,142112,Rio de Couros,1877,895,982,1788,845,943,717,0,588,1404,1404,0,0,1395
191638000,6,142113,Seiça,2076,968,1108,2001,920,1081,855,1,633,1531,1530,1,2,1519
191763000,6,142114,Urqueira,1682,807,875,1583,756,827,694,0,514,1356,1355,1,0,1349
191851000,6,142115,Nossa Senhora da Piedade,7217,3464,3753,6745,3175,3570,2712,8,2111,4167,4162,5,14,2151
192037000,6,142116,Matas,944,446,498,897,428,469,355,2,287,634,634,0,2,628
192108000,6,142117,Cercal,784,390,394,742,365,377,284,0,233,410,409,1,0,409
192146000,6,142118,Ribeira do Fárrio,836,383,453,800,362,438,307,2,233,576,575,1,2,573
192196000,6,110501,Alcabideche,42162,20428,21734,40755,19636,21119,15460,30,12493,19758,19696,62,31,10662
192837000,6,110502,Carcavelos,23347,10780,12567,22179,10145,12034,9982,10,7130,12339,12323,16,16,2947
193128000,6,110503,Cascais,35409,16224,19185,34023,15544,18479,14564,11,10567,22734,22718,16,36,8777
193735000,6,110504,Estoril,26399,12062,14337,25435,11586,13849,11147,27,7650,16027,16018,9,45,5597
194151000,6,110505,Parede,21660,9829,11831,20742,9295,11447,9154,25,6290,12101,12086,15,26,3807
194427000,6,110506,São Domingos de Rana,57502,27543,29959,55206,26106,29100,21786,20,17757,26039,25999,40,19,11834
195271000,6,110601,Ajuda,15584,7120,8464,14916,6787,8129,6982,5,4610,8872,8866,6,7,2837
195474000,6,110602,Alcântara,13943,6254,7689,14352,6460,7892,6591,10,3968,8900,8886,14,20,1659
195610000,6,110603,Alto do Pina,10333,4687,5646,9975,4488,5487,4647,9,2914,6106,6104,2,11,588
195678000,6,110604,Alvalade,8869,3764,5105,9129,3850,5279,4189,9,2440,5381,5381,0,14,633
195730000,6,110605,Ameixoeira,11863,5568,6295,11299,5270,6029,4772,5,3462,6235,6227,8,5,998
195838000,6,110606,Anjos,9361,4392,4969,9442,4431,5011,4604,11,2462,6032,6027,5,34,968
195906000,6,110607,Beato,12429,5763,6666,12047,5567,6480,5757,1,3652,7636,7631,5,4,1832
196023000,6,110608,Benfica,36821,16487,20334,35713,15958,19755,16735,11,11067,21204,21197,7,17,2811
196272000,6,110609,Campo Grande,10514,4679,5835,11918,5267,6651,4669,13,2928,6199,6199,0,21,639
196343000,6,110610,Campolide,15460,7468,7992,15669,7580,8089,6729,20,4114,9235,9224,11,20,2472
196494000,6,110611,Carnide,23316,10893,12423,23072,10861,12211,9064,17,6598,11148,11145,3,18,1804
196665000,6,110612,Castelo,355,158,197,353,157,196,191,0,97,348,347,1,1,102
196676000,6,110613,Charneca,9935,4753,5182,9469,4481,4988,3677,2,2862,4446,4430,16,2,702
196752000,6,110614,Coração de Jesus,3689,1698,1991,5355,2617,2738,1928,2,946,2849,2848,1,42,493
196810000,6,110615,Encarnação,2252,1060,1192,2300,1068,1232,1175,2,578,2261,2258,3,22,497
196871000,6,110616,Graça,5787,2613,3174,5606,2514,3092,2769,3,1621,4118,4117,1,7,874
196915000,6,110617,Lapa,8000,3553,4447,7780,3445,4335,3618,7,2130,5284,5281,3,13,936
196984000,6,110618,Lumiar,41163,19140,22023,39642,18182,21460,17185,21,11690,21451,21446,5,21,1775
197247000,6,110619,Madalena,393,187,206,457,234,223,181,0,106,370,370,0,5,79
197266000,6,110620,Mártires,372,182,190,349,172,177,184,1,92,321,321,0,5,64
197278000,6,110621,Marvila,38102,17945,20157,36630,17144,19486,14194,11,11494,16669,16649,20,12,1553
197506000,6,110622,Mercês,4345,1968,2377,4121,1857,2264,2176,3,1118,3248,3241,7,4,732
197553000,6,110623,Nossa Senhora de Fátima,15283,6692,8591,16114,7069,9045,7061,20,4043,10387,10386,1,55,1264
197681000,6,110624,Pena,4486,2166,2320,4600,2299,2301,2207,4,1139,3505,3503,2,13,735
197733000,6,110625,Penha de França,12780,5680,7100,12406,5431,6975,6184,6,3642,8308,8305,3,8,1291
197804000,6,110626,Prazeres,8096,3679,4417,7660,3497,4163,3777,6,2200,4937,4924,13,12,1290
197883000,6,110627,Sacramento,742,357,385,802,383,419,376,0,173,676,674,2,10,134
197899000,6,110628,Santa Catarina,3716,1692,2024,3591,1631,1960,1917,2,913,2951,2949,2,15,608
197956000,6,110629,Santa Engrácia,5249,2376,2873,5097,2305,2792,2680,0,1507,3530,3529,1,4,662
198002000,6,110630,Santa Isabel,6875,3034,3841,6643,2919,3724,3173,9,1841,4305,4305,0,15,940
198055000,6,110631,Santa Justa,891,497,394,1865,1069,796,412,1,180,628,628,0,32,193
198076000,6,110632,Santa Maria de Belém,8541,3868,4673,8302,3755,4547,3809,13,2374,5255,5253,2,18,2000
198254000,6,110633,Santa Maria dos Olivais,51036,24026,27010,49643,23224,26419,21132,15,15230,26059,26045,14,29,3435
198614000,6,110634,Santiago,619,261,358,582,242,340,326,1,155,556,556,0,3,113
198630000,6,110635,Santo Condestável,15257,6628,8629,14566,6269,8297,7358,10,4306,9481,9476,5,14,1711
198741000,6,110636,Santo Estêvão,1511,691,820,1398,643,755,849,0,399,1565,1564,1,6,409
198784000,6,110637,Santos-o-Velho,4020,1865,2155,3966,1819,2147,1930,0,1057,2888,2888,0,10,653
198830000,6,110638,São Cristóvão e São Lourenço,1341,675,666,1275,647,628,676,4,309,1092,1092,0,4,217
198860000,6,110639,São Domingos de Benfica,33745,15194,18551,33365,14938,18427,15298,16,9821,20233,20229,4,27,1753
199063000,6,110640,São Francisco Xavier,8020,3656,4364,8496,4135,4361,3341,5,2315,4216,4203,13,6,1039
199181000,6,110641,São João,15187,6790,8397,14852,6618,8234,7233,8,4329,9484,9480,4,20,1281
199270000,6,110642,São João de Brito,11727,5152,6575,11516,5025,6491,5233,34,3181,6782,6780,2,43,1225
199375000,6,110643,São João de Deus,9798,4224,5574,9797,4230,5567,4603,6,2703,6427,6425,2,14,831
199472000,6,110644,São Jorge de Arroios,18415,8405,10010,19367,9011,10356,9218,22,4702,11887,11882,5,75,1617
199590000,6,110645,São José,2746,1295,1451,3159,1581,1578,1429,3,695,2327,2324,3,27,522
199632000,6,110646,São Mamede,5420,2358,3062,5824,2572,3252,2427,12,1386,3321,3321,0,27,594
199687000,6,110647,São Miguel,1531,694,837,1534,697,837,872,0,405,1138,1138,0,1,264
199717000,6,110648,São Nicolau,1231,715,516,1946,1082,864,456,5,229,1159,1159,0,29,234
199774000,6,110649,São Paulo,2728,1354,1374,2760,1380,1380,1315,2,702,2036,2034,2,11,396
199843000,6,110650,São Sebastião da Pedreira,6342,2877,3465,9224,4415,4809,2838,7,1651,4043,4041,2,47,589
199912000,6,110651,São Vicente de Fora,3539,1579,1960,3430,1529,1901,1842,1,998,2644,2639,5,6,831
199954000,6,110652,Sé,910,437,473,912,432,480,433,2,235,862,862,0,9,144
199975000,6,110653,Socorro,3065,1625,1440,3062,1620,1442,1470,2,750,2081,2076,5,10,473
200002000,6,110701,Apelação,5647,2785,2862,5467,2680,2787,1959,4,1591,2197,2193,4,5,662
200077000,6,110702,Bucelas,4663,2243,2420,4522,2151,2371,1893,1,1517,2612,2608,4,2,2063
200233000,6,110703,Camarate,19789,9513,10276,18971,9084,9887,7563,7,5965,9268,9201,67,8,3285
200528000,6,110705,Fanhões,2801,1403,1398,2735,1378,1357,1098,6,857,1429,1422,7,7,1284
200633000,6,110706,Frielas,2171,1088,1083,2100,1051,1049,817,0,668,1011,996,15,0,394
200683000,6,110707,Loures,27362,13071,14291,26242,12374,13868,10598,21,8481,13715,13700,15,21,5028
201172000,6,110708,Lousa,3169,1511,1658,3062,1459,1603,1268,3,981,1767,1766,1,5,1544
201302000,6,110709,Moscavide,14266,6560,7706,13745,6229,7516,6561,3,4379,7990,7990,0,3,1004
201409000,6,110712,Sacavém,18469,8708,9761,17612,8244,9368,7528,1,5658,9533,9531,2,2,1010
201551000,6,110713,Santa Iria de Azoia,18240,8836,9404,17537,8396,9141,7075,5,5883,8567,8559,8,7,3498
201984000,6,110714,Santo Antão do Tojal,4216,2097,2119,4037,1988,2049,1583,5,1310,2245,2241,4,6,1566
202101000,6,110715,São João da Talha,17252,8360,8892,16507,7920,8587,6465,5,5451,7630,7620,10,5,3336
202461000,6,110716,São Julião do Tojal,3837,1850,1987,3720,1771,1949,1430,2,1153,1793,1788,5,2,1452
202619000,6,110717,Unhos,9507,4668,4839,9159,4461,4698,3564,0,2914,4360,4346,14,0,2239
202800000,6,110719,Portela,11809,5517,6292,11290,5184,6106,4768,1,3826,5469,5464,5,1,367
202885000,6,110722,Bobadela,8839,4228,4611,8564,4060,4504,3679,1,2827,4364,4360,4,4,1123
203001000,6,110723,Prior Velho,7136,3570,3566,6951,3454,3497,2757,1,2005,3385,3362,23,3,515
203076000,6,110724,Santo António dos Cavaleiros,25881,12258,13623,24461,11451,13010,9858,1,7819,11927,11913,14,1,725
203252000,6,110901,Azueira,3164,1536,1628,3092,1493,1599,1165,2,988,1581,1580,1,2,1394
203366000,6,110902,Carvoeira,2155,1062,1093,2004,978,1026,849,0,684,1659,1658,1,1,1392
203500000,6,110903,Cheleiros,1347,675,672,1310,654,656,542,1,407,789,789,0,1,704
203577000,6,110904,Encarnação,4798,2372,2426,4621,2257,2364,1703,3,1404,2427,2425,2,4,2102
203756000,6,110905,Enxara do Bispo,1740,847,893,1705,830,875,675,0,538,829,829,0,0,754
203839000,6,110906,Ericeira,10260,4968,5292,9831,4723,5108,4076,6,3078,9047,9041,6,24,4242
204230000,6,110907,Gradil,1226,571,655,1201,560,641,442,2,357,650,649,1,4,587
204291000,6,110908,Igreja Nova,3037,1522,1515,2950,1468,1482,1155,0,970,1541,1540,1,1,1384
204452000,6,110909,Mafra,17986,8673,9313,17318,8280,9038,6780,8,5543,9103,9102,1,15,5126
204971000,6,110910,Malveira,6493,3097,3396,6208,2931,3277,2564,2,1999,3286,3283,3,2,1246
205109000,6,110911,Milharado,7023,3470,3553,6836,3336,3500,2479,1,2111,3084,3081,3,1,2296
205338000,6,110912,Santo Estêvão das Galés,1709,828,881,1675,809,866,654,2,530,880,879,1,2,819
205464000,6,110913,Santo Isidoro,3814,1902,1912,3648,1806,1842,1436,0,1186,2366,2364,2,1,2221
205660000,6,110914,Sobral da Abelheira,1152,563,589,1111,542,569,453,0,353,630,627,3,0,598
205733000,6,110915,Vila Franca do Rosário,871,418,453,837,401,436,315,0,257,438,438,0,0,375
205774000,6,110916,Venda do Pinheiro,8146,3936,4210,7763,3691,4072,2931,4,2461,3718,3715,3,4,2153
206003000,6,110917,São Miguel de Alcainça,1764,877,887,1700,842,858,668,0,552,867,867,0,0,609
206055000,6,111002,Barcarena,13861,6749,7112,13330,6411,6919,5415,10,4266,6403,6392,11,10,2358
206317000,6,111003,Carnaxide,25911,12079,13832,24987,11540,13447,10098,5,7828,11719,11717,2,10,1596
206578000,6,111004,Oeiras e São Julião da Barra,33827,15241,18586,32403,14421,17982,14825,17,10124,18274,18260,14,24,2887
207016000,6,111005,Paço de Arcos,15315,6977,8338,14829,6774,8055,6998,6,4421,8964,8962,2,11,1466
207248000,6,111006,Algés,22273,10317,11956,21169,9720,11449,9562,3,6621,11675,11674,1,5,1318
207406000,6,111007,Cruz Quebrada-Dafundo,6393,2896,3497,6308,2836,3472,2925,5,1865,3633,3633,0,6,607
207470000,6,111008,Linda-a-Velha,19999,9194,10805,19113,8721,10392,8632,7,6225,10146,10145,1,11,1544
207666000,6,111009,Porto Salvo,15157,7250,7907,14570,6894,7676,5675,4,4650,6614,6611,3,8,2762
207941000,6,111010,Queijas,10377,4972,5405,9938,4726,5212,4081,11,3253,4680,4677,3,14,1925
208101000,6,111011,Caxias,9007,4462,4545,8850,4449,4401,3373,7,2623,3948,3944,4,7,1780
208255000,6,111102,Algueirão-Mem Martins,66250,31600,34650,63034,29739,33295,25014,43,20052,30804,30787,17,47,7770
208899000,6,111103,Almargem do Bispo,8983,4401,4582,8645,4182,4463,3444,5,2801,4521,4517,4,8,3903
209201000,6,111104,Belas,26087,12691,13396,25057,12089,12968,9121,17,7602,11177,11165,12,10,2927
209521000,6,111105,Colares,7628,3623,4005,7434,3522,3912,3011,5,2318,6017,6007,10,24,5083
209798000,6,111106,Montelavar,3559,1740,1819,3429,1660,1769,1407,0,1108,1777,1775,2,2,1407
209898000,6,111107,Queluz,26248,12178,14070,25604,11954,13650,11139,4,7875,13682,13672,10,10,2040
210092000,6,111108,Rio de Mouro,47311,22567,24744,44882,21112,23770,17561,7,14277,21993,21966,27,10,5193
210588000,6,111109,Sintra (Santa Maria e São Miguel),9364,4410,4954,9028,4202,4826,3794,4,2897,4917,4913,4,14,2817
210732000,6,111110,São João das Lampas,11392,5600,5792,10989,5353,5636,4438,4,3504,6708,6694,14,5,6389
211153000,6,111111,Sintra (São Martinho),6226,2972,3254,6078,2889,3189,2385,3,1887,3535,3533,2,10,3189
211324000,6,111112,Sintra (São Pedro de Penaferrim),14001,7024,6977,13591,6797,6794,4812,13,4003,6290,6280,10,16,3730
211582000,6,111113,Terrugem,5113,2502,2611,4934,2405,2529,1976,2,1596,2505,2499,6,2,2175
211757000,6,111114,Pêro Pinheiro,4246,2083,2163,4190,2102,2088,1700,3,1293,2394,2392,2,6,1911
211889000,6,111115,Casal de Cambra,12701,6168,6533,12435,5999,6436,4529,1,3936,5737,5722,15,1,2041
212103000,6,111116,Massamá,28112,13374,14738,26623,12525,14098,10691,1,8527,12689,12679,10,3,1013
212309000,6,111117,Monte Abraão,20809,9798,11011,19787,9196,10591,8304,1,6216,10041,10037,4,1,618
212466000,6,111118,Agualva,35824,17015,18809,34047,16037,18010,13951,4,10954,17350,17328,22,5,2409
212800000,6,111119,Cacém,21289,10112,11177,20239,9473,10766,8229,1,6494,10012,10009,3,1,1217
212985000,6,111120,Mira-Sintra,5280,2522,2758,5087,2415,2672,2055,1,1664,2380,2378,2,5,393
213050000,6,111121,São Marcos,17412,8325,9087,16441,7801,8640,6599,0,5110,8144,8136,8,1,678
213150000,6,111401,Alhandra,6047,2802,3245,5935,2735,3200,2591,3,1856,3191,3190,1,2,1041
213251000,6,111402,Alverca do Ribatejo,31070,14918,16152,29926,14205,15721,12494,8,9866,14827,14808,19,18,3394
213701000,6,111403,Cachoeiras,766,383,383,758,372,386,300,1,242,368,366,2,1,363
213755000,6,111404,Calhandriz,801,374,427,809,377,432,313,1,260,476,476,0,1,446
213806000,6,111405,Castanheira do Ribatejo,7500,3623,3877,7260,3466,3794,2893,5,2313,3569,3557,12,6,989
213924000,6,111406,Póvoa de Santa Iria,29348,14249,15099,28235,13519,14716,10893,1,9176,12860,12854,6,1,1582
214163000,6,111407,São João dos Montes,6018,2962,3056,5806,2808,2998,2267,1,1936,2869,2862,7,1,1972
214402000,6,111408,Vialonga,21033,10192,10841,20172,9680,10492,7813,2,6639,9319,9271,48,2,2701
214743000,6,111409,Vila Franca de Xira,18197,8579,9618,17842,8334,9508,7565,7,5651,10091,10045,46,12,2909
215045000,6,111410,Sobralinho,5050,2457,2593,4840,2317,2523,1986,0,1608,2418,2405,13,2,863
215134000,6,111411,Forte da Casa,11056,5269,5787,10686,5048,5638,4281,4,3433,5087,5085,2,4,724
215256000,6,111501,Alfragide,9904,4708,5196,9531,4487,5044,3859,3,2912,4502,4501,1,5,514
215339000,6,111502,Brandoa,17805,8535,9270,17146,8129,9017,6905,1,5365,8356,8348,8,1,1459
215458000,6,111503,Buraca,16081,7599,8482,15523,7283,8240,6275,5,4666,7347,7342,5,6,1511
215589000,6,111504,Damaia,20894,9734,11160,19989,9219,10770,9384,0,6406,11420,11393,27,0,1503
215737000,6,111505,Falagueira,14531,6820,7711,14110,6568,7542,6114,2,4475,7022,7020,2,3,1069
215834000,6,111506,Mina,17977,8445,9532,17133,7992,9141,7570,1,5546,9233,9226,7,2,1981
215965000,6,111507,Reboleira,14344,6558,7786,13659,6177,7482,6816,1,4281,8616,8615,1,2,635
216070000,6,111508,Venteira,18539,8534,10005,18721,8722,9999,8458,3,5789,10494,10491,3,10,1326
216210000,6,111509,Alfornelos,10439,4880,5559,10000,4614,5386,4393,1,3129,4945,4942,3,1,348
216270000,6,111510,São Brás,26263,12625,13638,25189,12000,13189,9829,2,8041,11419,11417,2,3,2192
216575000,6,111511,Venda Nova,8359,3904,4455,8020,3713,4307,3830,1,2452,4648,4644,4,1,1158
216669000,6,111601,Caneças,12324,5952,6372,11934,5711,6223,4548,16,3764,5527,5517,10,16,2944
216865000,6,111602,Famões,11095,5431,5664,10620,5143,5477,3865,8,3403,4931,4921,10,8,2841
217173000,6,111603,Odivelas,59559,28131,31428,56796,26521,30275,24581,5,18468,29422,29361,61,6,3521
217620000,6,111604,Olival Basto,5812,2767,3045,5553,2621,2932,2541,0,1778,3029,3017,12,0,663
217673000,6,111605,Pontinha,23041,11027,12014,22142,10521,11621,9348,2,7067,11531,11495,36,3,3207
217925000,6,111606,Póvoa de Santo Adrião,13061,6117,6944,12371,5722,6649,5302,0,4108,6261,6247,14,0,949
218007000,6,111607,Ramada,19657,9392,10265,18822,8902,9920,7559,7,6158,8497,8484,13,7,2219
218241000,6,150201,Alcochete,12239,5902,6337,11736,5609,6127,4703,3,3759,6215,6213,2,10,2952
218472000,6,150202,Samouco,3143,1535,1608,3013,1444,1569,1257,0,970,1559,1558,1,0,853
218537000,6,150203,São Francisco,2187,1057,1130,2106,999,1107,834,1,678,1044,1042,2,1,770
218584000,6,150301,Almada,16584,7480,9104,15891,7112,8779,7927,8,5090,10369,10358,11,8,1672
218715000,6,150302,Caparica,20454,9846,10608,20202,9649,10553,7916,4,6094,10947,10931,16,7,3430
218980000,6,150303,Costa da Caparica,13418,6384,7034,13136,6228,6908,6135,2,3985,13964,13935,29,26,3362
219206000,6,150304,Cova da Piedade,19904,9082,10822,18935,8525,10410,8925,1,6341,10897,10892,5,2,1905
219376000,6,150305,Trafaria,5696,2774,2922,5476,2630,2846,2319,0,1678,3288,3104,184,2,2022
219488000,6,150306,Cacilhas,6017,2684,3333,5729,2534,3195,2818,0,1886,3721,3721,0,1,457
219536000,6,150307,Pragal,7156,3394,3762,7603,3590,4013,2840,1,2161,3377,3374,3,5,465
219592000,6,150308,Sobreda,15166,7287,7879,14626,6922,7704,5630,13,4711,6908,6891,17,13,4024
219840000,6,150309,Charneca de Caparica,29763,14647,15116,28604,13899,14705,11131,21,9197,18186,18178,8,24,12865
220687000,6,150310,Laranjeiro,20988,9941,11047,20256,9611,10645,8523,2,6430,10540,10524,16,4,1480
220838000,6,150311,Feijó,18884,8977,9907,18032,8483,9549,7737,1,5912,9246,9238,8,1,2481
221029000,6,150401,Barreiro,7449,3476,3973,7221,3319,3902,3394,4,2262,4967,4958,9,6,1729
221155000,6,150402,Lavradio,14428,6854,7574,13849,6505,7344,5944,5,4622,7296,7294,2,5,1442
221316000,6,150403,Palhais,1869,910,959,1802,861,941,754,0,595,915,905,10,1,588
221376000,6,150404,Santo André,11480,5538,5942,11012,5238,5774,4769,3,3703,5685,5677,8,4,1571
221511000,6,150405,Verderena,10285,4834,5451,9787,4560,5227,4654,0,3259,5721,5718,3,2,824
221593000,6,150406,Alto do Seixalinho,19995,9334,10661,19624,9072,10552,8656,4,6398,10924,10916,8,8,1717
221757000,6,150407,Santo António da Charneca,11536,5575,5961,10996,5253,5743,4313,6,3621,5332,5317,15,7,2588
221980000,6,150408,Coina,1722,826,896,1670,799,871,690,0,540,899,897,2,0,549
222027000,6,150601,Alhos Vedros,15050,7380,7670,14266,6845,7421,5970,6,4669,8210,8199,11,6,3723
222274000,6,150602,Baixa da Banheira,21085,9985,11100,20080,9352,10728,8879,1,6638,11767,11758,9,1,3060
222467000,6,150603,Moita,17653,8488,9165,16832,7978,8854,6878,5,5535,9017,9008,9,5,3796
222727000,6,150604,Gaio-Rosário,1227,620,607,1160,579,581,464,0,367,591,591,0,0,536
222747000,6,150605,Sarilhos Pequenos,1150,540,610,1129,524,605,437,1,352,620,619,1,1,488
222771000,6,150606,Vale da Amoreira,9864,4695,5169,9366,4400,4966,3509,1,2821,4454,4448,6,1,795
222862000,6,150701,Canha,1689,819,870,1645,790,855,683,4,520,1200,1200,0,5,1175
222969000,6,150702,Montijo,29908,14259,15649,28720,13569,15151,12158,11,9296,15565,15535,30,16,5299
223501000,6,150703,Santo Isidro de Pegões,1538,753,785,1508,733,775,603,0,489,806,798,8,0,720
223571000,6,150704,Sarilhos Grandes,3424,1666,1758,3324,1600,1724,1376,2,1077,1751,1746,5,2,1577
223720000,6,150705,Alto-Estanqueiro-Jardia,2846,1379,1467,2793,1342,1451,1100,2,894,1301,1298,3,3,1281
223847000,6,150706,Pegões,2375,1176,1199,2293,1120,1173,920,4,733,1142,1132,10,4,991
223939000,6,150707,Atalaia,2239,1087,1152,2168,1050,1118,863,1,703,1146,1145,1,1,688
224033000,6,150708,Afonsoeiro,7203,3584,3619,6876,3378,3498,2873,1,2278,3822,3817,5,2,1265
224182000,6,150801,Marateca,3724,1853,1871,3650,1811,1839,1437,2,1175,1843,1840,3,4,1674
224305000,6,150802,Palmela,17481,8462,9019,16769,8029,8740,6513,18,5458,9022,9007,15,22,6488
224803000,6,150803,Pinhal Novo,25003,12035,12968,23965,11354,12611,9515,15,7827,12489,12479,10,18,5541
225227000,6,150804,Quinta do Anjo,11865,5825,6040,11392,5534,5858,4455,8,3739,7380,7363,17,8,5722
225787000,6,150805,Poceirão,4758,2311,2447,4641,2243,2398,1757,3,1480,2407,2384,23,3,2206
225944000,6,151001,Aldeia de Paio Pires,13258,6433,6825,12549,5976,6573,5235,1,4134,6415,6404,11,2,1634
226075000,6,151002,Amora,48629,23185,25444,46092,21685,24407,19554,16,15141,23933,23840,93,17,6464
226650000,6,151003,Arrentela,28886,13782,15104,27267,12810,14457,11337,6,9082,14364,14338,26,8,3849
227041000,6,151004,Seixal,2776,1304,1472,2637,1225,1412,1242,0,856,1884,1882,2,1,662
227099000,6,151005,Corroios,47661,22843,24818,45495,21515,23980,18651,14,15022,22820,22807,13,14,8256
227789000,6,151006,Fernão Ferro,17059,8369,8690,16624,8088,8536,6242,14,5449,10070,10034,36,24,9259
228605000,6,151101,Sesimbra (Castelo),19053,9429,9624,18172,8881,9291,7271,8,5963,13567,13554,13,14,10567
229365000,6,151102,Sesimbra (Santiago),4841,2352,2489,4785,2299,2486,2120,4,1534,6038,6032,6,12,1467
229517000,6,151103,Quinta do Conde,25606,12536,13070,24549,11857,12692,9883,18,7902,12187,12175,12,19,8399
230000000,6,151201,Setúbal (Nossa Senhora da Anunciada),13738,6441,7297,13254,6108,7146,5759,9,4159,7761,7750,11,23,3483
230213000,6,151202,Setúbal (Santa Maria da Graça),7620,3528,4092,7270,3345,3925,3505,1,2317,4779,4772,7,5,1104
230336000,6,151203,Setúbal (São Julião),16740,7669,9071,15703,7106,8597,7091,7,5120,9403,9396,7,12,1496
230506000,6,151204,São Lourenço,11638,5656,5982,11270,5393,5877,4335,6,3595,6272,6259,13,9,4850
230815000,6,151205,Setúbal (São Sebastião),52542,25329,27213,50772,24083,26689,20713,11,16184,25811,25725,86,20,5886
231343000,6,151206,São Simão,7239,3494,3745,7050,3381,3669,2602,5,2227,3753,3745,8,6,3449
231619000,6,151207,Gâmbia-Pontes-Alto da Guerra,5885,2954,2931,5722,2828,2894,2132,3,1819,2509,2502,7,5,1929
231754000,6,151208,Sado,5783,2915,2868,5606,2807,2799,2191,0,1883,2461,2458,3,0,2045
6000,6,160101,Aboim das Choças,333,150,183,328,143,185,131,0,105,209,209,0,0,208
41000,6,160102,Aguiã,705,354,351,679,337,342,257,0,225,455,455,0,0,444
108000,6,160103,Alvora,261,104,157,258,106,152,122,0,76,205,205,0,0,204
138000,6,160104,Ázere,247,111,136,243,110,133,101,0,81,182,182,0,0,176
160000,6,160105,Cabana Maior,239,96,143,231,92,139,117,0,76,407,407,0,0,404
210000,6,160106,Cabreiro,428,177,251,420,171,249,195,0,140,356,356,0,0,354
255000,6,160107,Carralcova,124,50,74,122,49,73,69,0,36,141,141,0,0,135
276000,6,160108,Cendufe,360,168,192,351,160,191,128,0,108,214,214,0,0,210
310000,6,160109,Couto,615,286,329,592,279,313,249,1,189,479,479,0,1,474
368000,6,160110,Eiras,269,128,141,269,130,139,114,0,88,189,189,0,0,189
395000,6,160111,Ermelo,92,43,49,92,43,49,48,0,29,165,165,0,0,165
413000,6,160112,Extremo,160,73,87,158,72,86,60,0,49,99,99,0,0,99
434000,6,160113,Gavieira,298,128,170,290,122,168,141,0,95,554,554,0,3,555
471000,6,160114,Giela,514,231,283,508,222,286,192,0,149,341,339,2,0,209
493000,6,160115,Gondoriz,958,429,529,916,407,509,398,0,293,707,706,1,0,697
560000,6,160116,Grade,393,180,213,400,182,218,145,1,111,311,311,0,1,312
593000,6,160117,Guilhadeses,1119,520,599,1054,486,568,401,1,341,573,573,0,1,503
657000,6,160118,Loureda,195,86,109,170,75,95,85,0,63,142,142,0,0,142
676000,6,160119,Jolda (Madalena),350,172,178,338,165,173,126,0,105,223,223,0,2,223
705000,6,160120,Mei,118,53,65,106,46,60,46,0,35,78,78,0,0,78
716000,6,160121,Miranda,325,140,185,324,139,185,158,0,98,368,368,0,0,368
751000,6,160122,Monte Redondo,227,102,125,232,101,131,93,0,69,195,195,0,0,192
776000,6,160123,Oliveira,330,140,190,323,136,187,127,0,103,233,233,0,0,222
797000,6,160124,Paçô,933,449,484,877,421,456,330,1,291,641,641,0,6,509
835000,6,160125,Padroso,234,106,128,231,103,128,106,0,74,224,224,0,0,224
853000,6,160126,Parada,383,189,194,381,189,192,146,0,128,329,329,0,1,222
876000,6,160127,Portela,260,117,143,250,111,139,114,0,84,181,181,0,0,181
896000,6,160128,Prozelo,943,452,491,919,438,481,346,1,269,552,552,0,1,510
937000,6,160129,Rio Cabrão,135,64,71,137,65,72,51,0,46,78,78,0,0,78
949000,6,160130,Rio Frio,684,306,378,681,303,378,308,1,202,634,634,0,2,629
1007000,6,160131,Rio de Moinhos,438,198,240,441,200,241,176,0,131,312,312,0,0,311
1040000,6,160132,Sá,138,58,80,142,59,83,62,0,41,124,124,0,0,124
1058000,6,160133,Sabadim,468,220,248,457,214,243,189,0,147,333,333,0,0,331
1090000,6,160134,Arcos de Valdevez (Salvador),1079,499,580,1038,473,565,463,0,328,815,815,0,5,303
1126000,6,160135,Padreiro (Salvador),301,132,169,304,133,171,111,0,92,186,186,0,0,168
1155000,6,160136,Padreiro (Santa Cristina),76,35,41,80,38,42,43,0,22,99,98,1,0,98
1167000,6,160137,Távora (Santa Maria),690,337,353,656,318,338,252,0,222,417,417,0,0,407
1220000,6,160138,Santar,164,79,85,160,78,82,57,0,49,81,81,0,0,80
1235000,6,160139,São Cosme e São Damião,190,85,105,186,82,104,77,0,60,172,172,0,0,164
1248000,6,160140,São Jorge,714,325,389,705,318,387,290,1,204,566,565,1,1,551
1294000,6,160141,Arcos de Valdevez (São Paio),1147,529,618,1094,498,596,453,1,350,829,829,0,4,446
1343000,6,160142,Jolda (São Paio),360,165,195,344,151,193,115,0,108,202,200,2,0,200
1366000,6,160143,Távora (São Vicente),265,123,142,263,122,141,117,0,91,184,184,0,0,184
1386000,6,160144,Senharei,259,116,143,228,104,124,122,0,88,229,228,1,0,229
1410000,6,160145,Sistelo,273,110,163,268,108,160,116,0,86,221,221,0,0,219
1431000,6,160146,Soajo,986,409,577,967,399,568,500,0,314,1076,1076,0,1,1068
1515000,6,160147,Souto,622,286,336,598,277,321,204,0,182,377,376,1,0,364
1554000,6,160148,Tabaçô,355,173,182,354,173,181,124,0,109,164,164,0,0,159
1572000,6,160149,Vale,776,366,410,766,354,412,286,1,247,543,543,0,1,542
1622000,6,160150,Vila Fonche,1118,488,630,1128,486,642,394,3,326,692,692,0,6,313
1656000,6,160151,Vilela,196,92,104,194,90,104,83,0,65,174,174,0,0,173
1674000,6,160201,Âncora,1182,576,606,1140,544,596,401,0,368,718,717,1,1,600
1738000,6,160202,Arga de Baixo,74,28,46,70,26,44,34,0,22,64,64,0,0,64
1754000,6,160203,Arga de Cima,73,33,40,73,33,40,29,0,25,46,46,0,0,46
1764000,6,160204,Arga de São João,61,26,35,61,26,35,22,0,17,32,32,0,0,32
1772000,6,160205,Argela,393,186,207,368,173,195,143,0,114,257,257,0,1,248
1801000,6,160206,Azevedo,158,77,81,156,75,81,53,0,47,96,96,0,1,95
1822000,6,160207,Caminha (Matriz),1346,564,782,1310,544,766,535,2,359,1240,1239,1,8,612
1865000,6,160208,Cristelo,244,121,123,271,151,120,95,0,79,244,244,0,32,261
1880000,6,160209,Dem,363,164,199,363,162,201,116,0,116,188,188,0,0,185
1902000,6,160210,Gondar,222,98,124,210,89,121,57,0,66,82,82,0,0,81
1917000,6,160211,Lanhelas,991,453,538,926,423,503,362,0,306,573,572,1,1,542
1951000,6,160212,Moledo,1322,602,720,1270,579,691,535,0,421,1891,1891,0,3,1228
2026000,6,160213,Orbacém,213,92,121,200,87,113,71,0,66,134,134,0,0,134
2047000,6,160214,Riba de Âncora,723,324,399,666,291,375,260,0,226,417,417,0,0,412
2087000,6,160215,Seixas,1502,698,804,1441,657,784,548,2,456,1208,1208,0,3,1018
2146000,6,160216,Venade,817,390,427,800,373,427,293,0,250,539,537,2,0,531
2196000,6,160217,Vila Praia de Âncora,4820,2271,2549,4639,2162,2477,1929,3,1475,4692,4692,0,7,1964
2292000,6,160218,Vilar de Mouros,753,357,396,694,325,369,271,0,239,536,535,1,0,520
2328000,6,160219,Vilarelho,1125,532,593,1070,496,574,410,0,356,785,785,0,2,600
2357000,6,160220,Vile,302,145,157,297,143,154,93,0,96,150,150,0,0,145
2377000,6,160301,Alvaredo,528,229,299,518,225,293,199,0,176,322,322,0,1,321
2419000,6,160302,Castro Laboreiro,540,204,336,529,197,332,256,0,161,1006,1006,0,4,1003
2513000,6,160303,Chaviães,385,172,213,368,167,201,165,0,125,318,318,0,0,317
2542000,6,160304,Cousso,294,122,172,281,119,162,135,0,102,267,267,0,0,265
2571000,6,160305,Cristoval,528,231,297,498,219,279,231,0,170,443,443,0,0,441
2624000,6,160306,Cubalhão,156,69,87,154,68,86,72,0,57,138,138,0,0,138
2640000,6,160307,Fiães,239,103,136,236,103,133,117,0,82,215,215,0,0,215
2672000,6,160308,Gave,237,93,144,227,88,139,114,0,72,276,276,0,0,275
2703000,6,160309,Lamas de Mouro,117,48,69,108,46,62,47,0,43,108,108,0,1,109
2718000,6,160310,Paços,317,145,172,302,137,165,134,0,102,249,249,0,0,247
2749000,6,160311,Paderne,1160,511,649,1150,497,653,461,1,366,763,763,0,3,758
2838000,6,160312,Parada do Monte,370,150,220,351,139,212,173,0,115,509,509,0,0,506
2884000,6,160313,Penso,523,248,275,501,237,264,209,0,182,410,410,0,0,410
2925000,6,160314,Prado,452,220,232,493,258,235,183,1,147,270,270,0,3,267
2965000,6,160315,Remoães,98,47,51,94,46,48,42,0,32,76,76,0,0,76
2980000,6,160316,Roussas,1107,496,611,1077,482,595,402,1,327,691,691,0,1,561
3050000,6,160317,São Paio,602,277,325,590,270,320,252,0,194,439,439,0,1,440
3105000,6,160318,Vila,1560,711,849,1543,704,839,647,2,476,1083,1083,0,6,655
3164000,6,160401,Abedim,205,85,120,198,82,116,86,0,65,180,180,0,0,180
3183000,6,160402,Anhões,140,57,83,138,56,82,67,0,42,106,106,0,0,106
3201000,6,160403,Badim,178,70,108,174,72,102,80,0,55,147,147,0,0,146
3228000,6,160404,Barbeita,1016,475,541,971,454,517,362,1,316,603,603,0,2,598
3306000,6,160405,Barroças e Taias,319,157,162,317,157,160,120,0,100,214,214,0,0,209
3334000,6,160406,Bela,698,327,371,676,317,359,263,0,223,442,442,0,0,441
3385000,6,160407,Cambeses,496,216,280,476,205,271,187,0,150,336,336,0,0,335
3415000,6,160408,Ceivães,492,237,255,470,220,250,206,0,149,384,384,0,0,384
3454000,6,160409,Lapela,223,99,124,211,94,117,85,0,70,145,145,0,1,142
3471000,6,160410,Lara,266,119,147,259,115,144,96,0,76,192,192,0,0,191
3496000,6,160411,Longos Vales,989,451,538,951,426,525,377,0,300,651,651,0,0,650
3565000,6,160412,Lordelo,116,60,56,116,60,56,45,0,40,82,82,0,0,82
3578000,6,160413,Luzio,120,50,70,119,50,69,55,0,39,108,108,0,0,108
3592000,6,160414,Mazedo,1859,868,991,1764,815,949,684,1,595,1202,1202,0,2,710
3668000,6,160415,Merufe,1097,477,620,1049,449,600,409,0,336,685,685,0,0,680
3729000,6,160416,Messegães,253,119,134,249,116,133,111,0,84,206,206,0,0,199
3749000,6,160417,Monção,2469,1132,1337,2465,1122,1343,912,4,744,1583,1583,0,20,898
3817000,6,160418,Moreira,615,277,338,603,270,333,248,0,192,422,422,0,0,419
3851000,6,160419,Parada,107,48,59,100,46,54,41,0,32,72,72,0,0,72
3864000,6,160420,Pias,854,401,453,821,386,435,338,0,270,574,574,0,0,572
3920000,6,160421,Pinheiros,345,156,189,332,150,182,130,0,111,228,228,0,0,214
3947000,6,160422,Podame,278,121,157,271,118,153,119,1,80,224,224,0,1,225
3975000,6,160423,Portela,242,112,130,241,113,128,105,0,80,208,208,0,0,204
3996000,6,160424,Riba de Mouro,964,372,592,913,344,569,397,0,298,1031,1031,0,0,1010
4084000,6,160425,Sá,200,87,113,197,85,112,82,0,66,146,146,0,1,146
4104000,6,160426,Sago,225,103,122,218,103,115,88,0,70,177,177,0,0,177
4129000,6,160427,Segude,356,157,199,351,153,198,137,0,117,237,237,0,1,237
4164000,6,160428,Tangil,768,330,438,749,318,431,327,0,236,584,584,0,0,578
4227000,6,160429,Troporiz,274,120,154,270,118,152,101,0,80,198,198,0,0,197
4251000,6,160430,Troviscoso,1066,516,550,1049,507,542,390,1,332,679,679,0,1,667
4308000,6,160431,Trute,277,113,164,274,115,159,111,0,76,210,210,0,0,208
4331000,6,160432,Valadares,205,95,110,203,94,109,80,0,65,164,164,0,1,165
4351000,6,160433,Cortes,1518,721,797,1444,677,767,602,0,479,957,957,0,0,563
4398000,6,160501,Agualonga,295,129,166,297,133,164,115,0,94,210,210,0,1,208
4425000,6,160502,Bico,466,220,246,440,204,236,168,1,132,321,321,0,3,324
4472000,6,160503,Castanheira,631,309,322,609,295,314,229,0,195,356,355,1,0,352
4513000,6,160504,Cossourado,319,150,169,317,146,171,127,0,101,266,266,0,0,265
4551000,6,160505,Coura,374,173,201,373,174,199,153,0,123,305,305,0,0,302
4594000,6,160506,Cristelo,317,151,166,307,146,161,113,0,106,191,191,0,0,186
4619000,6,160507,Cunha,529,255,274,498,241,257,186,0,166,295,295,0,0,291
4652000,6,160508,Ferreira,425,195,230,408,186,222,177,0,133,347,347,0,3,350
4696000,6,160509,Formariz,573,275,298,551,262,289,220,0,186,366,366,0,0,362
4730000,6,160510,Infesta,450,212,238,449,210,239,178,0,144,329,329,0,0,328
4763000,6,160511,Insalde,364,167,197,360,164,196,146,0,110,246,246,0,0,246
4794000,6,160512,Linhares,198,97,101,197,96,101,77,0,65,151,151,0,2,152
4816000,6,160513,Mozelos,347,169,178,338,166,172,131,1,109,223,223,0,2,224
4843000,6,160514,Padornelo,437,205,232,427,198,229,171,0,133,265,264,1,0,263
4878000,6,160515,Parada,298,142,156,295,137,158,113,0,84,184,184,0,0,183
4902000,6,160516,Paredes de Coura,1581,764,817,1486,713,773,588,1,460,877,877,0,2,570
4948000,6,160517,Porreiras,95,51,44,95,51,44,42,0,29,60,60,0,0,57
4959000,6,160518,Resende,518,253,265,503,242,261,180,0,170,278,278,0,1,270
4991000,6,160519,Romarigães,246,108,138,248,107,141,97,0,76,200,200,0,0,200
5023000,6,160520,Rubiães,512,242,270,501,239,262,204,0,164,421,421,0,3,416
5072000,6,160521,Vascões,223,106,117,213,101,112,89,0,69,176,176,0,0,176
5098000,6,160601,Azias,377,173,204,367,169,198,154,0,117,333,333,0,0,332
5142000,6,160602,Boivães,289,141,148,281,135,146,100,0,86,158,158,0,0,158
5175000,6,160603,Bravães,629,283,346,603,268,335,218,0,187,332,332,0,0,308
5224000,6,160604,Britelo,485,233,252,448,212,236,216,0,154,468,466,2,5,457
5266000,6,160605,Crasto,458,209,249,448,204,244,161,0,147,269,269,0,0,268
5306000,6,160606,Cuide de Vila Verde,344,157,187,339,155,184,121,0,105,201,201,0,0,196
5334000,6,160607,Entre Ambos-os-Rios,502,227,275,465,205,260,208,0,166,419,419,0,2,417
5363000,6,160608,Ermida,61,31,30,59,30,29,26,0,21,65,65,0,0,65
5369000,6,160609,Germil,49,22,27,45,20,25,24,0,17,47,47,0,0,46
5382000,6,160610,Grovelas,203,99,104,196,92,104,67,0,60,94,94,0,0,91
5401000,6,160611,Lavradas,875,396,479,825,373,452,307,0,273,477,477,0,0,463
5466000,6,160612,Lindoso,427,198,229,404,178,226,179,0,135,359,359,0,1,356
5489000,6,160613,Nogueira,410,195,215,394,186,208,138,0,125,209,209,0,0,208
5522000,6,160614,Oleiros,466,224,242,446,208,238,172,0,141,263,263,0,0,260
5565000,6,160615,Paço Vedro de Magalhães,967,471,496,938,457,481,361,0,302,694,694,0,0,550
5604000,6,160616,Ponte da Barca,2371,1067,1304,2287,1018,1269,860,3,693,1367,1367,0,7,522
5652000,6,160617,Ruivos,221,101,120,220,100,120,76,0,61,125,125,0,0,125
5674000,6,160618,Touvedo (Salvador),167,85,82,154,79,75,61,0,54,99,99,0,0,91
5692000,6,160619,Sampriz,342,146,196,344,148,196,131,0,104,263,263,0,0,263
5724000,6,160620,Vila Chã (Santiago),139,69,70,136,66,70,62,0,41,190,190,0,0,168
5741000,6,160621,Vila Chã (São João Baptista),484,222,262,461,209,252,183,0,152,377,377,0,0,371
5777000,6,160622,Touvedo (São Lourenço),210,98,112,205,96,109,86,0,69,182,182,0,0,182
5800000,6,160623,Vade (São Pedro),264,126,138,255,123,132,87,0,77,169,169,0,0,159
5822000,6,160624,Vade (São Tomé),287,126,161,275,120,155,104,0,91,194,194,0,0,164
5845000,6,160625,Vila Nova de Muía,1034,497,537,1001,479,522,369,0,322,599,599,0,0,580
5897000,6,160701,Anais,1073,501,572,983,449,534,353,0,328,535,535,0,0,522
5951000,6,160702,Arca,885,427,458,829,396,433,312,0,258,487,487,0,2,281
5972000,6,160703,Arcos,640,282,358,630,274,356,216,0,191,326,325,1,7,330
6004000,6,160704,Arcozelo,3734,1786,1948,3582,1704,1878,1236,0,1113,1745,1744,1,13,1438
6074000,6,160705,Ardegão,233,118,115,220,107,113,78,0,65,125,125,0,1,122
6095000,6,160706,Bárrio,359,179,180,354,178,176,124,0,110,194,194,0,1,191
6114000,6,160707,Beiral do Lima,558,260,298,552,256,296,208,0,168,403,403,0,0,403
6145000,6,160708,Bertiandos,414,190,224,403,182,221,142,0,125,188,188,0,0,178
6157000,6,160709,Boalhosa,163,71,92,166,71,95,66,0,52,138,138,0,0,138
6167000,6,160710,Brandara,442,211,231,428,201,227,150,0,132,224,224,0,0,214
6190000,6,160711,Cabaços,671,302,369,648,285,363,213,0,204,340,340,0,1,338
6227000,6,160712,Cabração,118,51,67,116,51,65,57,0,37,132,132,0,2,134
6245000,6,160713,Calheiros,991,463,528,930,421,509,317,0,304,456,456,0,2,455
6296000,6,160714,Calvelo,685,324,361,643,300,343,246,0,215,388,388,0,0,378
6322000,6,160715,Cepões,562,263,299,528,240,288,185,0,173,279,279,0,0,272
6351000,6,160716,Correlhã,2936,1405,1531,2790,1314,1476,923,1,855,1210,1210,0,6,1106
6428000,6,160717,Estorãos,464,224,240,450,214,236,178,0,137,356,356,0,9,304
6459000,6,160718,Facha,1529,720,809,1495,692,803,485,0,451,670,670,0,4,664
6509000,6,160719,Feitosa,1363,676,687,1314,639,675,466,0,419,731,731,0,2,427
6548000,6,160720,Fojo Lobal,280,137,143,250,111,139,99,0,77,152,152,0,1,152
6564000,6,160721,Fontão,1101,524,577,1079,510,569,344,1,324,516,516,0,5,508
6604000,6,160722,Fornelos,1638,768,870,1566,719,847,513,1,490,732,732,0,3,677
6666000,6,160723,Freixo,1209,560,649,1154,520,634,410,1,357,662,661,1,5,643
6712000,6,160724,Friastelas,450,208,242,441,201,240,142,0,136,262,262,0,0,258
6741000,6,160725,Gaifar,266,118,148,260,115,145,105,0,89,165,165,0,0,161
6759000,6,160726,Gandra,1108,520,588,1087,508,579,374,1,340,575,575,0,2,555
6795000,6,160727,Gemieira,598,277,321,545,252,293,199,0,171,304,304,0,1,303
6827000,6,160728,Gondufe,450,212,238,440,204,236,142,0,136,270,270,0,0,266
6851000,6,160729,Labruja,439,206,233,432,203,229,152,0,134,267,267,0,1,259
6881000,6,160730,Labrujó,127,64,63,124,60,64,42,0,31,77,77,0,0,75
6892000,6,160731,Mato,312,154,158,305,149,156,108,0,97,168,168,0,0,165
6910000,6,160732,Moreira do Lima,869,415,454,834,391,443,300,0,267,485,485,0,0,478
6952000,6,160733,Navió,231,118,113,224,113,111,65,0,66,117,117,0,0,116
6967000,6,160734,Poiares,775,365,410,704,317,387,235,0,232,338,337,1,0,329
7000000,6,160735,Ponte de Lima,2871,1294,1577,2897,1283,1614,990,3,782,1552,1552,0,10,674
7071000,6,160736,Queijada,274,131,143,267,125,142,90,0,80,148,148,0,1,149
7089000,6,160737,Refóios do Lima,2169,1007,1162,2190,993,1197,745,2,633,1241,1241,0,6,1215
7166000,6,160738,Rendufe,184,86,98,173,80,93,71,0,57,123,123,0,4,125
7177000,6,160739,Ribeira,1902,889,1013,1836,853,983,618,0,577,896,895,1,4,850
7227000,6,160740,Sá,423,193,230,413,190,223,136,0,125,189,189,0,0,183
7246000,6,160741,Sandiães,435,211,224,418,199,219,152,0,132,241,241,0,0,240
7263000,6,160742,Santa Comba,658,319,339,610,288,322,211,0,200,268,268,0,4,235
7287000,6,160743,Santa Cruz do Lima,480,219,261,457,208,249,161,1,142,259,259,0,2,258
7310000,6,160744,Rebordões (Santa Maria),1056,513,543,976,452,524,326,0,312,468,468,0,3,461
7344000,6,160745,Seara,714,349,365,695,332,363,216,0,214,281,281,0,1,267
7369000,6,160746,Serdedelo,464,216,248,446,202,244,132,0,140,207,207,0,0,205
7392000,6,160747,Rebordões (Souto),1127,550,577,1090,519,571,362,0,338,524,524,0,0,511
7449000,6,160748,Vilar das Almas,374,173,201,367,171,196,141,0,119,236,236,0,0,236
7474000,6,160749,Vilar do Monte,106,50,56,103,49,54,36,0,34,79,79,0,0,77
7486000,6,160750,Vitorino das Donas,1051,494,557,994,448,546,335,0,317,459,459,0,2,458
7531000,6,160751,Vitorino dos Piães,1537,710,827,1436,645,791,499,0,460,684,684,0,0,670
7594000,6,160801,Arão,758,366,392,744,357,387,296,0,246,406,406,0,0,366
7616000,6,160802,Boivão,239,105,134,238,104,134,88,0,73,159,159,0,0,159
7631000,6,160803,Cerdal,1693,816,877,1665,802,863,611,0,536,996,996,0,0,992
7710000,6,160804,Cristelo Covo,965,457,508,945,442,503,365,0,310,588,588,0,1,538
7741000,6,160805,Fontoura,751,362,389,740,356,384,275,0,229,420,420,0,0,415
7788000,6,160806,Friestas,562,250,312,535,236,299,212,0,172,315,315,0,0,311
7820000,6,160807,Gandra,1318,595,723,1277,575,702,481,0,431,681,681,0,1,624
7893000,6,160808,Ganfei,1296,618,678,1251,593,658,474,0,415,662,662,0,1,657
7948000,6,160809,Gondomil,301,127,174,297,125,172,124,0,90,221,221,0,1,221
7979000,6,160810,Sanfins,163,85,78,161,86,75,56,0,50,104,104,0,0,104
7995000,6,160811,São Julião,363,181,182,361,181,180,135,0,109,239,239,0,0,238
8023000,6,160812,São Pedro da Torre,1267,576,691,1251,565,686,473,0,402,667,667,0,3,653
8079000,6,160813,Silva,260,130,130,255,127,128,103,0,79,187,186,1,0,184
8103000,6,160814,Taião,153,69,84,157,70,87,60,0,53,92,92,0,0,92
8117000,6,160815,Valença,3430,1590,1840,3404,1571,1833,1335,2,1010,2076,2067,9,13,947
8220000,6,160816,Verdoejo,608,292,316,581,277,304,221,0,204,317,316,1,0,316
8259000,6,160901,Afife,1632,750,882,1543,690,853,638,0,522,1264,1263,1,5,1058
8349000,6,160902,Alvarães,2623,1274,1349,2574,1228,1346,912,2,805,1345,1344,1,2,1299
8442000,6,160903,Amonde,293,122,171,274,110,164,100,0,90,138,138,0,0,136
8475000,6,160904,Anha,2415,1136,1279,2317,1072,1245,852,1,780,1190,1185,5,3,1109
8562000,6,160905,Areosa,4853,2267,2586,4622,2133,2489,1758,2,1517,2513,2511,2,3,1837
8695000,6,160906,Barroselas,3927,1874,2053,3745,1778,1967,1371,2,1212,1850,1847,3,4,1660
8811000,6,160907,Cardielos,1309,623,686,1224,569,655,395,1,408,527,527,0,3,519
8870000,6,160908,Carreço,1759,830,929,1643,767,876,619,1,573,971,970,1,2,920
8980000,6,160909,Carvoeiro,1104,527,577,1040,476,564,345,0,340,498,498,0,0,490
9042000,6,160910,Castelo do Neiva,2930,1385,1545,2811,1310,1501,1038,0,916,1779,1775,4,1,1654
9148000,6,160911,Darque,7817,3772,4045,7458,3527,3931,2940,2,2405,4762,4760,2,10,2318
9291000,6,160912,Deão,951,434,517,915,411,504,307,0,289,441,441,0,0,436
9338000,6,160913,Deocriste,776,384,392,741,361,380,232,0,227,331,331,0,0,320
9382000,6,160914,Freixieiro de Soutelo,511,245,266,488,224,264,169,0,154,311,311,0,0,305
9429000,6,160915,Lanheses,1645,762,883,1606,739,867,553,0,504,740,739,1,2,726
9522000,6,160916,Mazarefes,1343,651,692,1295,616,679,451,0,416,602,602,0,0,583
9579000,6,160917,Meadela,9782,4669,5113,9280,4381,4899,3596,0,3113,4737,4736,1,2,2265
9747000,6,160918,Meixedo,467,203,264,460,199,261,151,0,141,202,202,0,0,199
9780000,6,160919,Viana do Castelo (Monserrate),4948,2295,2653,5041,2321,2720,2073,5,1454,3161,3160,1,11,1254
9870000,6,160920,Montaria,549,232,317,528,218,310,195,0,166,310,310,0,0,309
9927000,6,160921,Moreira de Geraz do Lima,597,283,314,577,278,299,192,0,182,279,279,0,0,275
9963000,6,160922,Mujães,1550,736,814,1461,680,781,543,0,476,797,797,0,1,751
10027000,6,160923,Neiva,1225,570,655,1185,552,633,418,0,381,599,599,0,0,578
10083000,6,160924,Nogueira,916,415,501,880,391,489,266,0,268,346,346,0,0,339
10144000,6,160925,Outeiro,1234,582,652,1183,551,632,354,0,368,502,502,0,0,501
10212000,6,160926,Perre,2956,1416,1540,2784,1304,1480,928,0,911,1116,1116,0,1,1080
10338000,6,160927,Portela Susã,597,270,327,576,257,319,195,1,182,284,284,0,1,278
10369000,6,160928,Santa Marta de Portuzelo,3805,1798,2007,3586,1680,1906,1257,0,1203,1666,1666,0,0,1484
10502000,6,160929,Geraz do Lima (Santa Leocádia),916,423,493,885,403,482,287,0,283,462,462,0,0,461
10574000,6,160930,Geraz do Lima (Santa Maria),875,413,462,786,362,424,296,0,271,440,440,0,1,438
10626000,6,160931,Viana do Castelo (Santa Maria Maior),10645,4929,5716,10463,4767,5696,4268,14,3133,5929,5924,5,39,1972
10803000,6,160932,Serreleis,1003,464,539,962,439,523,316,0,316,398,398,0,0,390
10849000,6,160933,Subportela,1179,563,616,1115,524,591,360,0,362,524,524,0,0,520
10905000,6,160934,Torre,615,299,316,611,296,315,182,0,177,281,281,0,0,275
10947000,6,160935,Vila Franca,1757,864,893,1708,823,885,560,1,539,774,773,1,2,759
11034000,6,160936,Vila Fria,1327,646,681,1297,627,670,451,0,422,569,569,0,0,563
11098000,6,160937,Vila Mou,566,239,327,529,220,309,197,0,175,285,285,0,0,283
11140000,6,160938,Vila de Punhe,2273,1083,1190,2171,1008,1163,829,0,699,1191,1191,0,2,1161
11231000,6,160939,Vilar de Murteda,214,92,122,210,89,121,77,0,68,135,135,0,0,135
11261000,6,160940,Chafé,2841,1369,1472,2738,1309,1429,1062,1,880,3944,3943,1,3,1285
11366000,6,161001,Campos,1367,656,711,1323,635,688,497,0,425,704,704,0,1,668
11438000,6,161002,Candemil,232,112,120,226,108,118,95,0,74,163,163,0,1,162
11472000,6,161003,Cornes,478,220,258,459,213,246,171,0,148,289,289,0,0,285
11515000,6,161004,Covas,675,313,362,662,307,355,284,0,200,633,632,1,2,632
11575000,6,161005,Gondar,127,59,68,120,56,64,56,0,40,103,103,0,0,102
11591000,6,161006,Gondarém,1010,474,536,986,454,532,382,0,323,734,734,0,3,692
11659000,6,161007,Loivo,885,439,446,842,408,434,325,0,278,526,526,0,0,484
11706000,6,161008,Lovelhe,443,218,225,404,202,202,163,0,134,274,274,0,1,224
11739000,6,161009,Mentrestido,264,123,141,257,119,138,109,0,88,219,219,0,0,218
11779000,6,161010,Nogueira,315,153,162,300,147,153,120,0,100,182,182,0,0,177
11809000,6,161011,Reboreda,756,352,404,781,352,429,272,1,222,444,443,1,1,439
11855000,6,161012,Sapardos,366,187,179,365,189,176,147,0,114,261,261,0,0,261
11893000,6,161013,Sopo,557,271,286,524,250,274,209,0,171,447,446,1,0,444
11932000,6,161014,Vila Meã,346,184,162,347,183,164,124,0,103,179,179,0,1,162
11959000,6,161015,Vila Nova de Cerveira,1432,658,774,1378,632,746,538,1,428,995,995,0,8,630
12004000,6,30101,Amares,1550,775,775,1485,739,746,513,1,461,759,759,0,3,635
12044000,6,30102,Barreiros,760,363,397,730,349,381,238,0,222,340,340,0,0,334
12077000,6,30103,Besteiros,576,281,295,570,276,294,195,0,171,293,293,0,0,270
12110000,6,30104,Bico,777,368,409,745,348,397,250,0,229,380,380,0,0,369
12141000,6,30105,Caires,868,414,454,853,399,454,279,0,261,462,462,0,0,452
12185000,6,30106,Caldelas,872,406,466,839,389,450,300,0,263,496,496,0,4,421
12221000,6,30107,Carrazedo,732,335,397,724,325,399,247,0,221,371,371,0,0,363
12256000,6,30108,Dornelas,508,246,262,500,239,261,168,0,152,254,254,0,0,254
12278000,6,30109,Ferreiros,3212,1543,1669,3095,1476,1619,1095,1,965,1678,1678,0,4,1000
12341000,6,30110,Figueiredo,1104,534,570,1085,522,563,369,0,344,655,655,0,0,618
12378000,6,30111,Fiscal,718,337,381,703,323,380,245,0,214,388,387,1,0,384
12423000,6,30112,Goães,557,269,288,537,258,279,179,0,166,274,274,0,0,273
12456000,6,30113,Lago,1910,927,983,1836,878,958,577,0,565,795,795,0,0,716
12506000,6,30114,Paranhos,111,55,56,109,56,53,40,0,36,74,74,0,0,74
12520000,6,30115,Paredes Secas,166,78,88,166,77,89,51,0,40,97,97,0,0,96
12531000,6,30116,Portela,168,82,86,162,81,81,53,0,47,88,88,0,0,87
12546000,6,30117,Prozelo,785,400,385,777,397,380,258,0,241,381,381,0,3,329
12578000,6,30118,Rendufe,1124,555,569,1103,542,561,336,0,317,510,509,1,3,497
12622000,6,30119,Bouro (Santa Maria),760,351,409,747,348,399,260,1,221,441,441,0,2,437
12642000,6,30120,Bouro (Santa Marta),490,238,252,482,231,251,163,0,147,283,283,0,0,280
12670000,6,30121,Sequeiros,204,105,99,196,101,95,71,0,58,136,136,0,0,133
12689000,6,30122,Seramil,182,97,85,181,96,85,59,0,55,85,85,0,2,87
12706000,6,30123,Torre,458,226,232,441,214,227,144,0,136,217,217,0,0,215
12740000,6,30124,Vilela,297,146,151,283,135,148,82,0,85,129,129,0,0,128
12767000,6,30201,Abade de Neiva,2024,971,1053,1907,898,1009,627,0,614,753,751,2,1,677
12831000,6,30202,Aborim,891,426,465,850,397,453,305,0,277,367,367,0,1,322
12871000,6,30203,Adães,790,389,401,726,358,368,257,0,226,300,300,0,0,277
12900000,6,30204,Aguiar,546,269,277,506,244,262,164,0,162,213,213,0,0,207
12926000,6,30205,Airó,913,454,459,869,423,446,269,1,266,324,324,0,1,288
12951000,6,30206,Aldreu,904,436,468,847,394,453,302,0,281,358,356,2,0,356
12992000,6,30207,Alheira,1072,512,560,1054,501,553,332,1,336,489,489,0,1,470
13038000,6,30208,Alvelos,2145,1047,1098,2060,986,1074,639,0,661,751,751,0,0,684
13096000,6,30209,Arcozelo,12840,6101,6739,12212,5701,6511,4618,4,3904,5710,5696,14,5,1615
13250000,6,30210,Areias,1014,502,512,953,458,495,328,0,296,407,406,1,0,348
13284000,6,30211,Areias de Vilar,1365,774,591,1307,733,574,342,3,345,420,419,1,1,393
13319000,6,30212,Balugães,841,400,441,796,363,433,264,0,251,362,362,0,0,349
13353000,6,30213,Barcelinhos,1781,835,946,1699,777,922,632,1,562,852,852,0,4,583
13391000,6,30214,Barcelos,4660,2116,2544,4637,2092,2545,1667,5,1336,2245,2240,5,11,698
13479000,6,30215,Barqueiros,1957,919,1038,1862,858,1004,587,1,586,841,841,0,2,774
13540000,6,30216,Cambeses,1300,643,657,1251,607,644,424,0,401,521,520,1,0,467
13588000,6,30217,Campo,983,471,512,917,431,486,310,0,295,351,351,0,0,329
13618000,6,30218,Carapeços,2277,1076,1201,2192,1013,1179,668,1,675,755,754,1,1,708
13680000,6,30219,Carreira,1451,710,741,1401,673,728,441,0,432,522,522,0,0,474
13724000,6,30220,Carvalhal,1391,668,723,1365,653,712,440,0,434,546,546,0,0,487
13770000,6,30221,Carvalhos,691,341,350,653,316,337,220,0,215,267,267,0,0,266
13809000,6,30222,Chavão,746,360,386,696,327,369,214,0,220,274,274,0,0,256
13840000,6,30223,Chorente,753,363,390,669,318,351,224,0,230,277,277,0,0,256
13877000,6,30224,Cossourado,825,402,423,772,364,408,263,0,239,374,373,1,1,367
13914000,6,30225,Courel,488,240,248,464,227,237,140,0,138,192,192,0,0,182
13938000,6,30226,Couto,348,178,170,334,167,167,104,0,106,114,114,0,0,110
13951000,6,30227,Creixomil,834,409,425,809,395,414,260,0,245,310,310,0,0,310
13973000,6,30228,Cristelo,1875,913,962,1803,866,937,527,1,554,684,683,1,1,662
14044000,6,30229,Durrães,723,347,376,694,323,371,225,0,214,330,330,0,2,322
14076000,6,30230,Encourados,514,260,254,485,242,243,164,0,162,212,209,3,0,202
14101000,6,30231,Faria,550,269,281,539,266,273,167,0,158,219,219,0,1,213
14130000,6,30232,Feitos,538,268,270,493,227,266,157,0,156,184,184,0,0,173
14150000,6,30233,Fonte Coberta,582,288,294,579,283,296,184,0,173,234,234,0,0,210
14175000,6,30234,Fornelos,803,410,393,744,373,371,217,0,244,273,270,3,0,261
14209000,6,30235,Fragoso,2193,1074,1119,2066,985,1081,664,0,645,887,884,3,0,852
14293000,6,30236,Gamil,924,458,466,896,437,459,282,0,279,355,354,1,1,319
14319000,6,30237,Gilmonde,1516,756,760,1440,700,740,470,0,457,583,583,0,0,531
14360000,6,30238,Góios,548,278,270,537,270,267,166,0,160,211,211,0,0,199
14391000,6,30239,Grimancelos,791,360,431,774,352,422,245,0,230,331,331,0,1,320
14416000,6,30240,Gueral,380,184,196,375,181,194,108,0,113,145,145,0,0,143
14435000,6,30241,Igreja Nova,384,181,203,367,171,196,130,0,122,215,215,0,0,213
14453000,6,30242,Lama,1271,603,668,1228,576,652,367,0,377,462,462,0,0,444
14483000,6,30243,Lijó,2306,1087,1219,2231,1038,1193,715,0,675,818,818,0,0,692
14533000,6,30244,Macieira de Rates,2083,1029,1054,1826,867,959,582,0,573,676,676,0,1,585
14611000,6,30245,Manhente,1703,825,878,1618,756,862,533,0,525,644,644,0,0,558
14662000,6,30246,Mariz,374,190,184,347,173,174,123,0,118,153,153,0,0,147
14677000,6,30247,Martim,2375,1151,1224,2205,1031,1174,681,0,687,806,806,0,0,654
14725000,6,30248,Midões,462,209,253,446,197,249,138,0,134,181,181,0,0,176
14748000,6,30249,Milhazes,912,428,484,850,393,457,251,0,262,354,353,1,0,339
14787000,6,30250,Minhotães,775,357,418,751,347,404,240,0,238,296,296,0,0,278
14821000,6,30251,Monte de Fralães,408,200,208,391,189,202,133,0,122,161,161,0,0,128
14836000,6,30252,Moure,925,443,482,877,413,464,302,0,282,378,378,0,0,327
14869000,6,30253,Negreiros,1618,781,837,1555,744,811,467,0,493,598,598,0,0,586
14936000,6,30254,Oliveira,1004,504,500,963,475,488,314,0,298,405,404,1,0,357
14978000,6,30255,Palme,1073,523,550,1006,477,529,315,0,309,410,410,0,0,398
15023000,6,30256,Panque,680,330,350,670,322,348,206,0,203,277,277,0,0,273
15055000,6,30257,Paradela,850,415,435,804,385,419,230,0,239,281,281,0,2,281
15088000,6,30258,Pedra Furada,399,199,200,381,185,196,120,0,117,170,170,0,1,168
15108000,6,30259,Pereira,1318,648,670,1293,629,664,393,0,395,442,442,0,1,392
15142000,6,30260,Perelhal,1749,872,877,1668,820,848,606,0,529,726,722,4,0,615
15195000,6,30261,Pousa,2272,1092,1180,2128,987,1141,626,0,662,764,761,3,0,650
15250000,6,30262,Quintiães,644,317,327,587,269,318,195,0,190,228,228,0,1,223
15285000,6,30263,Remelhe,1309,627,682,1260,594,666,411,0,385,484,483,1,0,465
15323000,6,30264,Roriz,2152,1059,1093,2080,1005,1075,642,0,610,737,733,4,0,636
15376000,6,30265,Rio Covo (Santa Eugénia),1483,714,769,1422,665,757,495,0,462,619,619,0,0,512
15409000,6,30266,Rio Covo (Santa Eulália),970,451,519,920,414,506,311,0,303,363,363,0,0,304
15436000,6,30267,Tamel (Santa Leocádia),753,359,394,720,335,385,230,0,230,258,258,0,0,247
15464000,6,30268,Galegos (Santa Maria),2987,1480,1507,2808,1365,1443,924,0,876,1099,1099,0,0,860
15513000,6,30269,Bastuço (Santo Estêvão),460,224,236,453,218,235,146,0,144,178,178,0,0,167
15530000,6,30270,Bastuço (São João),661,329,332,627,307,320,199,0,195,250,250,0,0,235
15556000,6,30271,Alvito (São Martinho),451,227,224,430,211,219,125,0,135,137,137,0,0,132
15576000,6,30272,Galegos (São Martinho),1930,952,978,1829,880,949,630,0,584,742,742,0,0,585
15624000,6,30273,Vila Frescainha (São Martinho),2372,1109,1263,2304,1054,1250,820,2,738,998,997,1,2,640
15665000,6,30274,Alvito (São Pedro),639,317,322,597,287,310,181,1,182,219,219,0,1,203
15693000,6,30275,Vila Frescainha (São Pedro),1593,785,808,1515,739,776,533,0,511,654,653,1,0,560
15727000,6,30276,Tamel (São Pedro Fins),538,249,289,525,235,290,166,0,157,217,217,0,1,210
15756000,6,30277,Tamel (São Veríssimo),3025,1448,1577,2913,1371,1542,997,1,925,1179,1179,0,1,994
15834000,6,30278,Sequeade,795,388,407,765,361,404,235,1,240,310,310,0,1,293
15865000,6,30279,Silva,913,453,460,869,427,442,284,2,275,326,326,0,2,302
15892000,6,30280,Silveiros,1181,565,616,1180,555,625,391,1,366,497,497,0,2,427
15932000,6,30281,Tregosa,686,332,354,646,304,342,238,0,217,342,342,0,1,341
15959000,6,30282,Ucha,1420,681,739,1378,650,728,434,0,426,561,561,0,0,505
15994000,6,30283,Várzea,1904,940,964,1851,899,952,642,0,598,807,807,0,1,596
16045000,6,30284,Viatodos,1840,891,949,1787,864,923,637,0,574,766,766,0,1,700
16091000,6,30285,Vila Boa,2483,1335,1148,2403,1302,1101,737,3,667,901,901,0,1,406
16135000,6,30286,Vila Cova,2026,937,1089,1972,901,1071,619,1,590,827,827,0,2,815
16191000,6,30287,Vila Seca,1197,557,640,1143,533,610,352,0,356,446,446,0,0,426
16230000,6,30288,Vilar de Figos,604,278,326,594,273,321,179,0,178,236,236,0,0,235
16256000,6,30289,Vilar do Monte,667,336,331,618,304,314,210,0,205,253,253,0,0,250
16284000,6,30301,Adaúfe,3711,1801,1910,3711,1810,1901,1186,0,1135,1472,1471,1,1,1311
16391000,6,30302,Arcos,764,372,392,723,348,375,239,0,228,273,273,0,0,253
16410000,6,30303,Arentim,884,432,452,862,421,441,283,0,276,365,365,0,0,344
16447000,6,30304,Aveleda,2149,1056,1093,2113,1033,1080,716,1,663,864,864,0,1,735
16490000,6,30305,Cabreiros,1511,736,775,1452,696,756,457,1,461,534,533,1,1,501
16534000,6,30306,Celeirós,3289,1648,1641,3227,1591,1636,1092,2,1011,1405,1405,0,2,922
16590000,6,30307,Braga (Cividade),1422,609,813,1406,613,793,541,8,403,690,689,1,8,226
16609000,6,30308,Crespos,899,435,464,882,421,461,279,0,264,374,374,0,0,345
16649000,6,30309,Cunha,646,308,338,615,290,325,202,1,190,268,268,0,1,259
16681000,6,30310,Dume,3251,1579,1672,3165,1529,1636,1096,0,976,1387,1387,0,0,1109
16747000,6,30311,Escudeiros,1115,558,557,1072,528,544,355,0,331,429,429,0,0,390
16788000,6,30312,Espinho,1181,593,588,1107,545,562,338,4,340,429,429,0,7,405
16828000,6,30313,Esporões,1709,839,870,1671,806,865,528,0,503,605,605,0,0,528
16875000,6,30314,Ferreiros,7707,3726,3981,7444,3561,3883,2661,2,2393,3470,3470,0,3,1308
16954000,6,30315,Figueiredo,1198,573,625,1168,555,613,378,0,363,436,436,0,0,332
16987000,6,30316,Fraião,4605,2206,2399,4373,2061,2312,1722,5,1388,2166,2166,0,5,760
17047000,6,30317,Frossos,1806,880,926,1735,835,900,571,0,530,697,696,1,0,532
17076000,6,30318,Gondizalves,1441,706,735,1377,665,712,456,0,432,589,581,8,0,479
17107000,6,30319,Gualtar,5286,2564,2722,5220,2473,2747,1917,2,1578,3021,3020,1,3,1491
17191000,6,30320,Guisande,538,276,262,533,273,260,155,0,162,170,170,0,0,157
17212000,6,30321,Lamaçães,2525,1228,1297,2412,1165,1247,943,0,771,1135,1135,0,0,469
17253000,6,30322,Lamas,842,419,423,819,403,416,257,0,242,289,289,0,0,219
17280000,6,30323,Lomar,6041,2950,3091,5860,2841,3019,2053,1,1826,2593,2593,0,1,1249
17358000,6,30324,Braga (Maximinos),9792,4671,5121,9389,4414,4975,3683,2,2894,5053,5052,1,5,1025
17447000,6,30325,Mire de Tibães,2437,1187,1250,2397,1144,1253,793,2,749,907,907,0,2,823
17508000,6,30326,Morreira,747,382,365,736,375,361,257,0,229,293,293,0,1,235
17538000,6,30327,Navarra,460,229,231,445,218,227,136,0,133,213,213,0,0,193
17554000,6,30328,Nogueira,5924,2918,3006,5753,2831,2922,2037,2,1770,2441,2440,1,4,1297
17635000,6,30329,Nogueiró,3749,1618,2131,3697,1586,2111,1248,7,1010,1631,1631,0,6,693
17688000,6,30330,Padim da Graça,1521,720,801,1518,713,805,465,0,447,605,605,0,0,486
17730000,6,30331,Palmeira,5468,2634,2834,5260,2508,2752,1779,2,1668,2248,2248,0,3,1906
17850000,6,30332,Panoias,1663,812,851,1593,770,823,519,0,489,623,623,0,0,578
17886000,6,30333,Parada de Tibães,1249,605,644,1197,568,629,389,1,362,486,486,0,1,463
17914000,6,30334,Pedralva,1110,537,573,1045,491,554,351,0,334,499,499,0,0,486
17955000,6,30335,Pousada,448,225,223,431,212,219,142,0,126,210,210,0,1,210
17977000,6,30336,Priscos,1341,654,687,1296,624,672,441,0,409,567,567,0,0,512
18032000,6,30337,Real,7666,3697,3969,7355,3499,3856,2638,3,2330,3366,3365,1,3,1285
18108000,6,30338,Ruilhe,1142,517,625,1132,503,629,338,2,309,483,483,0,2,421
18147000,6,30339,Santa Lucrécia de Algeriz,534,252,282,517,246,271,172,0,154,221,221,0,0,205
18173000,6,30340,Penso (Santo Estêvão),435,213,222,418,200,218,140,0,123,175,175,0,0,155
18194000,6,30341,Braga (São João do Souto),725,244,481,1174,505,669,209,5,115,346,346,0,10,216
18219000,6,30342,Braga (São José de São Lázaro),13576,6237,7339,12994,5888,7106,5219,15,3959,7003,7001,2,29,1580
18349000,6,30343,Passos (São Julião),654,309,345,635,293,342,195,0,195,241,241,0,0,235
18370000,6,30344,Este (São Mamede),1789,856,933,1756,828,928,574,0,556,716,716,0,0,639
18418000,6,30345,Merelim (São Paio),2451,1188,1263,2349,1129,1220,812,0,737,1031,1029,2,0,942
18478000,6,30346,Este (São Pedro),2048,995,1053,1992,950,1042,671,0,624,825,825,0,0,680
18525000,6,30347,Merelim (São Pedro),1920,947,973,1865,909,956,619,0,570,757,757,0,0,668
18568000,6,30348,Oliveira (São Pedro),515,245,270,510,241,269,164,0,155,205,205,0,0,182
18596000,6,30349,Braga (São Vicente),13236,6252,6984,12687,5958,6729,4860,16,3820,6737,6736,1,18,1462
18718000,6,30350,Penso (São Vicente),314,158,156,313,159,154,101,0,92,113,113,0,1,96
18739000,6,30351,Braga (São Vítor),29642,13930,15712,30577,14056,16521,11671,14,8743,16591,16586,5,28,2720
18983000,6,30352,Braga (Sé),3358,1544,1814,3190,1451,1739,1307,5,984,1760,1760,0,6,510
19030000,6,30353,Semelhe,783,365,418,771,353,418,248,0,246,295,295,0,0,268
19063000,6,30354,Sequeira,1811,896,915,1776,864,912,601,0,557,767,767,0,0,646
19108000,6,30355,Sobreposta,1301,648,653,1226,593,633,377,1,378,449,448,1,1,435
19162000,6,30356,Tadim,1143,553,590,1104,535,569,373,1,354,488,488,0,1,354
19190000,6,30357,Tebosa,1129,554,575,1040,499,541,383,0,354,430,430,0,0,382
19236000,6,30358,Tenões,1380,666,714,1355,648,707,507,1,408,742,742,0,6,426
19272000,6,30359,Trandeiras,700,340,360,685,329,356,219,0,206,257,257,0,0,233
19296000,6,30360,Vilaça,794,395,399,783,388,395,270,0,250,333,332,1,0,296
19325000,6,30361,Vimieiro,1233,624,609,1206,604,602,391,0,369,466,466,0,0,360
19360000,6,30362,Fradelos,786,396,390,745,369,376,262,0,240,291,291,0,0,265
19384000,6,30601,Antas,2221,1033,1188,2164,994,1170,729,0,667,1187,1187,0,1,1136
19482000,6,30602,Apúlia,4198,1985,2213,4051,1893,2158,1378,1,1254,2989,2987,2,6,1979
19623000,6,30603,Belinho,2017,981,1036,1906,899,1007,628,0,599,982,982,0,1,969
19693000,6,30604,Curvos,811,382,429,738,338,400,249,0,223,387,386,1,1,379
19730000,6,30605,Esposende,3595,1702,1893,3507,1650,1857,1335,1,1105,2629,2628,1,6,1029
19824000,6,30606,Fão,3103,1465,1638,2942,1373,1569,1110,1,924,2737,2735,2,5,1711
19943000,6,30607,Fonte Boa,1326,639,687,1278,619,659,345,0,383,437,437,0,0,432
20007000,6,30608,Forjães,2767,1307,1460,2632,1218,1414,877,1,830,1173,1172,1,1,1041
20156000,6,30609,Gandra,1323,651,672,1277,619,658,401,0,405,708,700,8,1,622
20217000,6,30610,Gemeses,1078,518,560,1045,499,546,319,0,326,631,631,0,0,523
20299000,6,30611,Mar,1182,564,618,1115,520,595,355,0,354,558,558,0,0,542
20339000,6,30612,Marinhas,6193,2959,3234,5846,2738,3108,1997,0,1850,4669,4666,3,1,2973
20583000,6,30613,Palmeira de Faro,2403,1129,1274,2287,1056,1231,782,0,707,1058,1058,0,1,982
20692000,6,30614,Rio Tinto,618,285,333,598,274,324,185,0,189,236,236,0,0,234
20742000,6,30615,Vila Chã,1419,678,741,1325,604,721,397,0,415,548,548,0,0,537
20809000,6,31001,Balança,341,158,183,338,157,181,127,0,102,195,195,0,0,192
20849000,6,31002,Brufe,50,24,26,48,23,25,22,0,14,38,38,0,1,39
20857000,6,31003,Campo do Gerês,162,81,81,163,83,80,54,0,44,160,160,0,7,163
20879000,6,31004,Carvalheira,386,186,200,378,182,196,135,0,115,249,249,0,1,250
20909000,6,31005,Chamoim,291,128,163,293,128,165,101,0,90,204,204,0,0,200
20931000,6,31006,Chorense,454,215,239,430,198,232,156,1,129,281,281,0,2,281
20956000,6,31007,Cibões,371,176,195,360,169,191,137,1,111,289,289,0,1,288
20987000,6,31008,Covide,343,171,172,335,167,168,125,1,100,220,220,0,2,220
21019000,6,31009,Gondoriz,295,147,148,300,148,152,112,0,88,287,287,0,0,285
21039000,6,31010,Moimenta,741,353,388,744,347,397,256,1,212,439,439,0,3,332
21077000,6,31011,Monte,126,63,63,120,62,58,37,0,38,57,57,0,2,59
21094000,6,31012,Ribeira,242,113,129,234,109,125,76,0,73,149,149,0,0,149
21117000,6,31013,Rio Caldo,892,433,459,871,421,450,295,1,266,578,578,0,5,580
21170000,6,31014,Souto,494,239,255,472,225,247,159,0,145,284,284,0,1,282
21192000,6,31015,Valdosende,630,304,326,675,324,351,210,1,191,422,422,0,7,427
21223000,6,31016,Vilar,149,77,72,138,71,67,53,0,42,123,123,0,0,121
21242000,6,31017,Vilar da Veiga,1286,610,676,1351,640,711,437,1,391,844,844,0,26,786
21296000,6,31301,Aboim da Nóbrega,987,458,529,926,426,500,348,1,280,611,611,0,4,606
21336000,6,31302,Arcozelo,405,187,218,398,182,216,137,0,125,220,219,1,0,217
21352000,6,31303,Atães,659,307,352,625,281,344,218,0,196,352,352,0,0,349
21387000,6,31304,Atiães,520,239,281,498,223,275,156,1,144,212,212,0,2,209
21412000,6,31305,Azões,314,148,166,294,131,163,101,0,90,156,156,0,0,152
21435000,6,31306,Barbudo,2400,1135,1265,2292,1063,1229,744,3,685,1115,1113,2,2,640
21486000,6,31307,Barros,335,166,169,318,156,162,115,0,103,194,194,0,0,191
21507000,6,31308,Cabanelas,2102,1032,1070,2021,971,1050,644,0,625,826,794,32,1,733
21554000,6,31309,Cervães,1981,963,1018,1926,923,1003,645,0,622,964,964,0,0,942
21629000,6,31310,Codeceda,172,83,89,163,79,84,63,0,50,144,144,0,0,144
21646000,6,31311,Coucieiro,531,248,283,524,247,277,173,0,154,270,270,0,0,269
21674000,6,31312,Covas,396,182,214,384,179,205,140,0,116,235,234,1,0,230
21692000,6,31313,Dossãos,500,251,249,478,232,246,155,0,149,207,207,0,0,206
21710000,6,31314,Duas Igrejas,1291,588,703,1208,533,675,427,1,352,683,683,0,1,674
21765000,6,31315,Esqueiros,493,237,256,463,222,241,157,0,143,206,206,0,0,190
21787000,6,31316,Freiriz,1099,526,573,1063,501,562,339,1,322,469,469,0,1,468
21824000,6,31317,Geme,551,258,293,545,249,296,179,0,167,245,241,4,0,224
21850000,6,31318,Goães,546,271,275,533,263,270,178,0,157,251,251,0,0,249
21875000,6,31319,Godinhaços,380,168,212,361,156,205,146,0,118,292,292,0,0,290
21902000,6,31320,Gomide,228,116,112,223,113,110,79,0,71,128,128,0,0,125
21918000,6,31321,Gondiães,347,164,183,337,157,180,116,0,102,170,170,0,0,168
21939000,6,31322,Gondomar,71,34,37,67,30,37,23,0,20,61,61,0,0,61
21950000,6,31323,Laje,2895,1382,1513,2760,1305,1455,938,1,868,1261,1260,1,2,1199
22035000,6,31324,Lanhas,581,289,292,573,283,290,188,0,172,246,246,0,1,240
22055000,6,31325,Loureira,1152,557,595,1116,533,583,360,0,347,481,481,0,0,449
22085000,6,31326,Marrancos,504,226,278,467,199,268,166,0,152,261,261,0,0,255
22107000,6,31327,Mós,323,151,172,310,145,165,106,0,96,158,158,0,0,152
22125000,6,31328,Moure,1421,681,740,1367,645,722,451,1,412,657,657,0,1,611
22176000,6,31329,Nevogilde,324,158,166,315,152,163,103,0,100,139,139,0,1,140
22199000,6,31330,Oleiros,1169,552,617,1172,555,617,381,0,346,569,569,0,0,544
22234000,6,31331,Parada de Gatim,793,392,401,756,363,393,223,0,230,312,312,0,0,295
22261000,6,31332,Passó,208,104,104,202,98,104,76,0,64,129,129,0,0,128
22279000,6,31333,Pedregais,331,150,181,328,148,180,117,0,104,196,196,0,0,194
22303000,6,31334,Penascais,255,120,135,252,120,132,87,0,83,129,129,0,0,128
22321000,6,31335,Pico,610,291,319,605,288,317,204,0,188,320,320,0,0,292
22352000,6,31336,Pico de Regalados,845,402,443,827,393,434,278,0,253,381,381,0,3,366
22384000,6,31337,Ponte,483,229,254,469,221,248,166,1,137,223,223,0,1,222
22408000,6,31338,Portela das Cabras,278,135,143,278,135,143,91,0,83,146,146,0,0,145
22425000,6,31339,Rio Mau,667,319,348,650,311,339,216,0,202,337,337,0,0,333
22454000,6,31340,Sabariz,443,211,232,430,203,227,153,0,128,229,229,0,1,224
22473000,6,31341,Sande,591,297,294,564,283,281,180,0,164,244,244,0,0,244
22510000,6,31342,Vila de Prado,4472,2164,2308,4280,2029,2251,1444,3,1310,1934,1933,1,6,1368
22588000,6,31343,Oriz (Santa Marinha),336,173,163,324,168,156,120,0,105,151,151,0,0,150
22600000,6,31344,Carreiras (Santiago),377,170,207,369,164,205,132,0,114,191,191,0,0,190
22624000,6,31345,Escariz (São Mamede),388,181,207,377,173,204,136,0,130,196,196,0,0,190
22647000,6,31346,Escariz (São Martinho),361,183,178,352,178,174,128,0,112,219,219,0,0,219
22668000,6,31347,Valbom (São Martinho),185,81,104,180,77,103,61,0,58,90,90,0,0,90
22678000,6,31348,Carreiras (São Miguel),553,261,292,535,249,286,183,0,167,247,247,0,0,242
22692000,6,31349,Oriz (São Miguel),235,111,124,237,112,125,79,0,60,129,129,0,0,127
22706000,6,31350,Prado (São Miguel),717,355,362,692,331,361,239,0,216,352,352,0,0,329
22741000,6,31351,Valbom (São Pedro),249,123,126,251,119,132,87,0,76,147,147,0,0,146
22759000,6,31352,Soutelo,2102,990,1112,2082,966,1116,634,2,632,868,867,1,6,814
22816000,6,31353,Travassós,218,108,110,211,102,109,56,0,57,82,82,0,0,82
22829000,6,31354,Turiz,1746,863,883,1688,828,860,531,1,508,765,765,0,1,743
22879000,6,31355,Valdreu,516,238,278,510,231,279,195,0,157,418,418,0,0,417
22912000,6,31356,Valões,195,91,104,187,85,102,68,0,59,116,116,0,0,115
22930000,6,31357,Vila Verde,4647,2245,2402,4422,2101,2321,1565,3,1402,2473,2472,1,7,1238
22999000,6,31358,Vilarinho,410,201,209,392,188,204,132,0,118,191,191,0,0,179
23023000,6,30701,Aboim,355,165,190,340,154,186,120,0,104,255,255,0,1,254
23057000,6,30702,Agrela,187,79,108,184,77,107,65,0,58,115,115,0,0,108
23077000,6,30703,Antime,1476,689,787,1411,652,759,548,1,484,678,678,0,1,614
23127000,6,30704,Ardegão,301,129,172,295,123,172,119,0,95,162,162,0,0,153
23151000,6,30705,Armil,735,361,374,730,359,371,265,0,231,358,358,0,0,310
23192000,6,30706,Arnozela,265,112,153,256,107,149,101,0,74,171,171,0,0,168
23226000,6,30707,Cepães,1410,681,729,1373,664,709,487,1,416,674,674,0,3,590
23284000,6,30708,Estorãos,1508,715,793,1496,708,788,523,0,495,768,768,0,0,716
23355000,6,30709,Fafe,15703,7368,8335,14979,6939,8040,5705,5,4847,7884,7883,1,9,4138
23656000,6,30710,Fareja,855,420,435,832,409,423,267,0,264,329,329,0,0,276
23681000,6,30711,Felgueiras,117,52,65,115,51,64,40,0,35,64,64,0,0,64
23702000,6,30712,Fornelos,1374,643,731,1307,605,702,466,1,408,713,713,0,1,602
23755000,6,30713,Freitas,585,266,319,581,263,318,198,1,175,340,340,0,1,330
23819000,6,30714,Golães,2135,1026,1109,2096,1003,1093,697,0,653,931,931,0,0,773
23876000,6,30715,Gontim,89,42,47,87,42,45,37,0,25,67,67,0,0,67
23890000,6,30716,Medelo,1602,773,829,1546,737,809,556,0,494,755,755,0,2,565
23951000,6,30717,Monte,308,126,182,297,121,176,133,0,90,350,350,0,0,348
23986000,6,30718,Moreira do Rei,1667,805,862,1626,778,848,595,0,506,934,934,0,0,898
24082000,6,30719,Passos,1076,531,545,1054,504,550,332,1,312,463,463,0,2,429
24131000,6,30720,Pedraído,265,118,147,257,114,143,103,0,79,181,181,0,0,181
24174000,6,30721,Queimadela,490,201,289,481,195,286,191,0,133,328,328,0,1,326
24217000,6,30722,Quinchães,2278,1090,1188,2259,1077,1182,809,1,726,1110,1107,3,1,992
24315000,6,30723,Regadas,1666,805,861,1650,795,855,597,0,512,730,730,0,0,650
24426000,6,30724,Revelhe,849,403,446,830,392,438,278,1,255,428,428,0,2,413
24486000,6,30725,Ribeiros,640,314,326,605,287,318,224,0,202,333,333,0,0,320
24544000,6,30726,Arões (Santa Cristina),1538,747,791,1517,737,780,503,0,479,705,705,0,1,596
24595000,6,30727,Silvares (São Clemente),570,262,308,548,248,300,197,0,181,269,269,0,0,252
24631000,6,30728,São Gens,1703,798,905,1635,764,871,601,0,529,865,865,0,0,772
24737000,6,30729,Silvares (São Martinho),1325,634,691,1280,611,669,455,0,408,634,634,0,0,582
24801000,6,30730,Arões (São Romão),3295,1603,1692,3211,1552,1659,1072,1,1005,1375,1375,0,1,1117
24851000,6,30731,Seidões,512,237,275,505,232,273,165,1,155,233,233,0,1,225
24881000,6,30732,Serafão,996,468,528,967,454,513,342,0,314,534,534,0,1,519
24960000,6,30733,Travassós,1539,706,833,1469,664,805,492,1,451,729,729,0,1,699
25023000,6,30734,Várzea Cova,358,172,186,348,164,184,138,0,106,295,295,0,0,295
25061000,6,30735,Vila Cova,219,96,123,215,91,124,79,0,61,122,122,0,0,121
25093000,6,30736,Vinhós,642,309,333,606,294,312,222,0,194,350,350,0,0,328
25142000,6,30801,Aldão,1293,629,664,1270,614,656,422,0,401,523,523,0,0,345
25171000,6,30802,Arosa,499,227,272,488,221,267,182,0,159,281,281,0,0,267
25194000,6,30803,Atães,1918,980,938,1889,964,925,611,0,584,763,763,0,1,633
25232000,6,30804,Azurém,8348,3931,4417,8784,4236,4548,3163,6,2590,4276,4275,1,7,1466
25347000,6,30805,Balazar,440,211,229,425,197,228,147,0,133,220,220,0,0,203
25369000,6,30806,Barco,1510,735,775,1476,716,760,458,0,457,592,592,0,0,447
25400000,6,30807,Brito,4939,2468,2471,4750,2356,2394,1608,1,1496,1839,1839,0,1,1384
25473000,6,30808,Caldelas,5723,2802,2921,5548,2697,2851,1975,0,1742,2722,2722,0,3,1135
25540000,6,30809,Calvos,1082,513,569,1065,506,559,329,1,327,402,402,0,2,305
25561000,6,30810,Castelões,310,149,161,304,147,157,114,0,94,183,183,0,0,180
25579000,6,30811,Conde,1378,664,714,1361,655,706,456,0,436,532,532,0,0,455
25610000,6,30812,Costa,5155,2475,2680,4943,2355,2588,1886,0,1599,2297,2297,0,2,794
25653000,6,30813,Creixomil,9641,4584,5057,9391,4458,4933,3571,2,2992,4325,4324,1,4,1987
25772000,6,30814,Donim,833,386,447,807,363,444,261,1,247,392,392,0,1,342
25799000,6,30815,Fermentões,5707,2768,2939,5505,2645,2860,1932,0,1732,2245,2245,0,0,1245
25886000,6,30816,Figueiredo,436,201,235,428,196,232,140,0,124,168,167,1,0,154
25904000,6,30817,Gandarela,1074,544,530,1042,523,519,348,0,339,390,390,0,0,326
25934000,6,30818,Gémeos,442,214,228,437,209,228,140,0,135,167,167,0,0,117
25949000,6,30819,Gominhães,511,260,251,507,257,250,156,0,154,196,196,0,0,168
25964000,6,30820,Gonça,1051,526,525,1004,496,508,333,0,315,422,422,0,0,382
25989000,6,30821,Gondar,2868,1408,1460,2762,1340,1422,987,0,894,1141,1140,1,0,615
26037000,6,30822,Gondomar,495,238,257,499,241,258,171,0,151,269,269,0,0,247
26060000,6,30823,Guardizela,2474,1206,1268,2416,1175,1241,809,1,761,938,938,0,1,783
26115000,6,30824,Infantas,1764,869,895,1699,837,862,552,0,549,698,697,1,1,532
26152000,6,30826,Leitões,568,268,300,549,258,291,175,0,169,185,185,0,0,170
26167000,6,30827,Longos,1372,644,728,1349,633,716,442,1,416,636,636,0,2,553
26201000,6,30828,Lordelo,4287,2080,2207,4158,2005,2153,1462,1,1353,1645,1644,1,3,1450
26283000,6,30829,Mascotelos,1631,799,832,1585,770,815,583,0,512,699,699,0,0,415
26306000,6,30830,Mesão Frio,4173,2010,2163,3988,1915,2073,1397,0,1304,1658,1658,0,1,1017
26369000,6,30831,Moreira de Cónegos,4853,2377,2476,4771,2322,2449,1667,0,1550,1885,1885,0,0,1625
26445000,6,30832,Nespereira,2578,1282,1296,2531,1255,1276,834,0,801,982,982,0,1,777
26490000,6,30833,Oleiros,462,221,241,455,217,238,145,0,134,179,179,0,0,153
26507000,6,30834,Guimarães (Oliveira do Castelo),3265,1515,1750,3238,1514,1724,1250,7,964,1676,1676,0,9,805
26572000,6,30835,Pencelo,1258,624,634,1269,615,654,415,1,381,515,515,0,1,372
26605000,6,30836,Pinheiro,1234,603,631,1210,592,618,405,0,377,445,445,0,0,345
26640000,6,30837,Polvoreira,3495,1708,1787,3455,1685,1770,1187,0,1077,1405,1404,1,1,1124
26727000,6,30838,Ponte,6610,3223,3387,6437,3102,3335,2217,1,2048,2754,2754,0,4,1797
26827000,6,30839,Rendufe,712,356,356,692,342,350,241,0,220,324,324,0,0,297
26852000,6,30840,Ronfe,4462,2207,2255,4326,2127,2199,1483,0,1378,1748,1748,0,0,1409
26928000,6,30841,Briteiros (Salvador),980,471,509,951,453,498,319,0,299,460,460,0,0,383
26955000,6,30842,Prazins (Santa Eufémia),1221,594,627,1186,577,609,373,0,355,489,489,0,0,434
26985000,6,30843,Briteiros (Santa Leocádia),819,390,429,798,377,421,263,0,242,346,345,1,0,296
27010000,6,30844,Airão (Santa Maria),1686,841,845,1625,810,815,556,0,508,644,644,0,0,525
27050000,6,30845,Souto (Santa Maria),771,400,371,761,394,367,259,0,240,369,369,0,0,328
27078000,6,30846,Candoso (Santiago),2163,1075,1088,2094,1026,1068,661,0,647,761,760,1,1,553
27112000,6,30847,Briteiros (Santo Estêvão),1292,649,643,1282,647,635,400,1,388,565,565,0,1,485
27146000,6,30848,Prazins (Santo Tirso),993,503,490,961,481,480,296,0,292,419,419,0,0,327
27172000,6,30849,Sande (São Clemente),1695,824,871,1641,795,846,532,2,501,684,683,1,2,504
27221000,6,30850,Selho (São Cristóvão),2380,1170,1210,2313,1125,1188,788,1,746,939,939,0,1,725
27261000,6,30851,São Faustino,998,501,497,968,482,486,313,0,303,375,375,0,0,290
27288000,6,30853,Airão (São João Baptista),827,400,427,805,388,417,248,1,234,293,293,0,1,247
27312000,6,30854,Selho (São Jorge),5625,2723,2902,5386,2580,2806,1949,2,1768,2323,2323,0,5,1441
27389000,6,30855,Sande (São Lourenço),1097,516,581,1064,496,568,364,0,330,563,563,0,0,464
27422000,6,30856,Selho (São Lourenço),1782,905,877,1753,881,872,606,0,571,708,708,0,0,489
27468000,6,30857,Candoso (São Martinho),1340,657,683,1299,633,666,455,0,420,550,550,0,0,498
27491000,6,30858,Sande (São Martinho),2533,1210,1323,2484,1186,1298,868,0,769,1144,1144,0,0,821
27548000,6,30860,Guimarães (São Paio),2896,1325,1571,2868,1303,1565,1151,2,871,1449,1449,0,7,446
27579000,6,30862,Souto (São Salvador),830,394,436,815,381,434,271,0,253,358,358,0,0,323
27614000,6,30863,Guimarães (São Sebastião),1976,905,1071,1899,859,1040,768,5,519,1028,1028,0,5,433
27640000,6,30864,Abação (São Tomé),2252,1143,1109,2223,1129,1094,674,0,662,779,779,0,0,565
27689000,6,30865,São Torcato,3373,1643,1730,3284,1586,1698,1147,0,1049,1443,1443,0,0,1109
27745000,6,30866,Serzedelo,3680,1804,1876,3655,1778,1877,1251,0,1166,1500,1500,0,0,1239
27810000,6,30867,Serzedo,1202,596,606,1171,573,598,400,0,374,468,468,0,0,371
27844000,6,30868,Silvares,2282,1124,1158,2237,1096,1141,767,0,701,923,923,0,0,780
27900000,6,30869,Tabuadelo,1555,762,793,1523,738,785,500,0,489,592,592,0,1,478
27938000,6,30871,Urgezes,5259,2496,2763,5138,2435,2703,1845,2,1612,2302,2302,0,5,1270
27998000,6,30872,Vermil,1144,559,585,1122,543,579,376,0,348,444,444,0,0,374
28026000,6,30873,Sande (Vila Nova),1739,834,905,1688,806,882,576,0,533,739,739,0,0,642
28068000,6,30874,Corvite,883,448,435,865,436,429,272,0,265,342,342,0,0,267
28085000,6,30901,Águas Santas,420,199,221,412,193,219,135,0,129,201,201,0,0,197
28107000,6,30902,Ajude,139,74,65,137,74,63,47,0,43,68,68,0,0,68
28119000,6,30903,Brunhais,313,151,162,302,140,162,103,1,94,173,173,0,1,169
28140000,6,30904,Calvos,483,250,233,474,237,237,149,0,142,204,204,0,2,206
28169000,6,30905,Campos,1046,525,521,1036,517,519,342,0,317,510,510,0,0,473
28217000,6,30906,Covelas,416,209,207,427,213,214,132,0,124,173,173,0,0,172
28245000,6,30907,Esperança,339,149,190,339,147,192,129,0,110,232,232,0,0,227
28259000,6,30908,Ferreiros,416,203,213,422,205,217,124,0,119,176,176,0,0,171
28288000,6,30909,Fonte Arcada,1273,583,690,1203,535,668,413,1,373,648,648,0,1,596
28331000,6,30910,Frades,270,134,136,264,128,136,97,0,80,149,149,0,1,150
28358000,6,30911,Friande,241,113,128,236,111,125,86,0,74,157,157,0,0,156
28383000,6,30912,Galegos,543,269,274,529,255,274,191,0,167,295,295,0,0,278
28410000,6,30913,Garfe,1000,458,542,990,455,535,347,0,302,536,536,0,0,509
28452000,6,30914,Geraz do Minho,521,258,263,521,259,262,171,0,157,241,241,0,1,231
28486000,6,30915,Lanhoso,742,334,408,742,334,408,264,1,218,426,426,0,2,399
28526000,6,30916,Louredo,439,205,234,421,190,231,136,0,126,174,174,0,0,164
28551000,6,30917,Monsul,773,363,410,764,359,405,237,0,234,358,358,0,0,350
28588000,6,30918,Moure,242,121,121,227,109,118,76,0,68,124,124,0,5,118
28601000,6,30919,Póvoa de Lanhoso (Nossa Senhora do Amparo),5052,2378,2674,5000,2313,2687,1748,2,1521,2982,2982,0,9,1382
28696000,6,30920,Oliveira,397,179,218,378,169,209,129,0,120,197,197,0,1,191
28714000,6,30921,Rendufinho,736,363,373,735,357,378,238,0,207,371,371,0,0,356
28737000,6,30922,Santo Emilião,890,423,467,848,390,458,275,1,267,398,398,0,1,332
28770000,6,30923,São João de Rei,401,201,200,390,193,197,134,0,117,227,227,0,0,221
28795000,6,30924,Serzedelo,723,335,388,721,332,389,249,0,216,413,413,0,0,410
28829000,6,30925,Sobradelo da Goma,794,387,407,768,376,392,308,0,242,502,502,0,2,500
28874000,6,30926,Taíde,1613,776,837,1552,735,817,522,1,482,910,910,0,1,849
28920000,6,30927,Travassos,696,320,376,692,308,384,234,2,206,366,366,0,3,355
28953000,6,30928,Verim,353,169,184,358,169,189,120,1,104,206,206,0,1,207
28982000,6,30929,Vilela,615,284,331,592,270,322,205,0,188,322,322,0,0,313
29019000,6,31101,Anissó,215,99,116,205,90,115,81,0,66,142,142,0,0,142
29041000,6,31102,Anjos,333,142,191,318,138,180,126,0,104,220,220,0,0,217
29073000,6,31103,Campos,185,89,96,168,84,84,74,0,53,185,185,0,6,189
29095000,6,31104,Caniçada,455,211,244,446,206,240,153,0,140,329,329,0,5,329
29128000,6,31105,Cantelães,828,396,432,801,380,421,283,1,239,410,410,0,1,400
29163000,6,31106,Cova,301,150,151,279,141,138,95,1,80,201,201,0,1,202
29186000,6,31107,Eira Vedra,702,356,346,689,342,347,226,0,216,389,389,0,0,384
29224000,6,31108,Guilhofrei,961,452,509,899,410,489,340,0,292,600,600,0,2,591
29283000,6,31109,Louredo,436,224,212,433,222,211,172,1,137,301,301,0,1,298
29310000,6,31110,Mosteiro,774,388,386,740,364,376,246,0,235,389,388,1,0,385
29363000,6,31111,Parada do Bouro,469,246,223,449,228,221,171,0,142,304,304,0,6,305
29394000,6,31112,Pinheiro,447,229,218,407,196,211,154,0,139,234,234,0,0,234
29424000,6,31113,Rossas,1673,786,887,1620,751,869,584,1,491,1111,1108,3,3,1105
29534000,6,31114,Ruivães,738,349,389,686,317,369,293,1,227,574,574,0,1,559
29593000,6,31115,Salamonde,387,183,204,353,168,185,144,0,122,309,309,0,1,305
29621000,6,31116,Soengas,148,72,76,152,67,85,47,0,45,112,112,0,1,113
29640000,6,31117,Soutelo,173,83,90,165,80,85,67,0,54,122,122,0,0,122
29655000,6,31118,Tabuaças,919,446,473,905,439,466,287,0,283,484,484,0,2,478
29701000,6,31119,Ventosa,358,170,188,342,156,186,119,1,107,268,268,0,3,270
29728000,6,31120,Vieira do Minho,2239,1068,1171,2164,1025,1139,739,3,645,1222,1222,0,3,704
29785000,6,31121,Vilar do Chão,256,113,143,234,99,135,81,0,71,123,123,0,0,122
29805000,6,31201,Abade de Vermoim,437,207,230,431,203,228,139,0,142,157,157,0,0,151
29827000,6,31202,Antas,6925,3287,3638,6707,3154,3553,2556,3,2142,3279,3278,1,8,1357
29942000,6,31203,Avidos,1742,855,887,1656,808,848,582,1,550,710,710,0,1,553
30002000,6,31204,Bairro,3598,1716,1882,3513,1658,1855,1239,1,1132,1567,1566,1,2,1217
30098000,6,31205,Bente,925,459,466,917,453,464,307,0,288,378,378,0,0,298
30136000,6,31206,Brufe,2231,1072,1159,2172,1039,1133,767,1,697,903,903,0,1,707
30192000,6,31207,Cabeçudos,1466,746,720,1420,714,706,495,0,465,579,576,3,0,416
30249000,6,31208,Calendário,11667,5566,6101,11237,5303,5934,4137,0,3646,5128,5128,0,0,2706
30443000,6,31209,Carreira,1662,799,863,1610,770,840,603,0,524,754,754,0,0,623
30495000,6,31210,Castelões,2021,997,1024,1959,962,997,614,1,617,731,730,1,1,643
30561000,6,31211,Cavalões,1539,743,796,1494,721,773,495,0,470,605,605,0,0,532
30621000,6,31212,Cruz,1738,832,906,1712,810,902,554,0,542,643,643,0,3,601
30676000,6,31213,Delães,3917,1885,2032,3836,1833,2003,1390,1,1257,1720,1717,3,1,1111
30772000,6,31214,Esmeriz,2218,1095,1123,2172,1062,1110,723,0,687,864,864,0,0,641
30844000,6,31215,Fradelos,3914,1906,2008,3790,1830,1960,1163,0,1155,1434,1434,0,0,1308
31003000,6,31216,Gavião,3747,1764,1983,3588,1664,1924,1249,3,1157,1458,1457,1,4,1129
31097000,6,31217,Gondifelos,2438,1160,1278,2376,1111,1265,777,0,731,1110,1110,0,0,980
31205000,6,31218,Jesufrei,606,302,304,582,292,290,210,0,184,256,254,2,0,234
31247000,6,31219,Joane,8089,3956,4133,7825,3769,4056,2689,1,2465,3228,3226,2,3,2043
31372000,6,31220,Lagoa,911,440,471,876,418,458,316,0,280,354,353,1,0,321
31409000,6,31221,Landim,2834,1403,1431,2750,1348,1402,933,0,901,1169,1168,1,0,964
31511000,6,31222,Lemenhe,1272,637,635,1256,624,632,410,0,395,484,484,0,0,454
31570000,6,31223,Louro,2250,1084,1166,2152,1035,1117,732,0,698,901,901,0,1,777
31666000,6,31224,Lousado,4057,2009,2048,4037,1978,2059,1314,1,1243,1525,1525,0,1,1249
31782000,6,31225,Mogege,1943,950,993,1876,912,964,637,0,597,752,751,1,0,614
31837000,6,31226,Mouquim,1266,627,639,1234,606,628,419,0,399,486,486,0,0,445
31896000,6,31227,Nine,2974,1453,1521,2904,1414,1490,953,0,922,1203,1203,0,0,1052
32013000,6,31228,Novais,1124,554,570,1086,537,549,358,0,357,440,440,0,0,386
32059000,6,31229,Outiz,913,412,501,889,392,497,270,1,253,339,339,0,1,309
32101000,6,31230,Pedome,2120,1052,1068,2031,997,1034,726,0,661,904,904,0,0,712
32172000,6,31231,Portela,585,297,288,562,279,283,177,0,172,212,211,1,0,194
32210000,6,31232,Pousada de Saramagos,2234,1084,1150,2172,1042,1130,745,0,694,885,885,0,0,574
32261000,6,31233,Requião,3376,1660,1716,3280,1611,1669,1104,1,1037,1296,1296,0,1,1035
32353000,6,31234,Riba de Ave,3425,1627,1798,3322,1561,1761,1225,1,1087,1531,1528,3,2,992
32430000,6,31235,Ribeirão,8828,4344,4484,8614,4181,4433,2842,1,2647,3351,3345,6,2,2525
32659000,6,31236,Ruivães,1877,927,950,1815,888,927,633,0,611,800,799,1,0,673
32739000,6,31237,Arnoso (Santa Eulália),1111,538,573,1108,532,576,360,0,340,427,427,0,0,381
32793000,6,31238,Arnoso (Santa Maria),2008,997,1011,1934,945,989,638,1,613,809,809,0,1,643
32862000,6,31239,Oliveira (Santa Maria),3420,1681,1739,3317,1611,1706,1186,0,1086,1422,1422,0,0,1084
32954000,6,31240,Vale (São Cosme),3032,1494,1538,2898,1405,1493,967,0,949,1123,1123,0,0,962
33068000,6,31241,Vale (São Martinho),2081,1022,1059,2019,982,1037,655,1,640,774,773,1,1,670
33139000,6,31242,Oliveira (São Mateus),2714,1300,1414,2632,1249,1383,958,1,856,1195,1195,0,1,913
33225000,6,31243,Seide (São Miguel),1171,565,606,1144,544,600,391,0,374,454,454,0,0,406
33264000,6,31244,Seide (São Paio),371,177,194,374,181,193,129,0,116,173,173,0,1,153
33289000,6,31245,Sezures,497,237,260,487,230,257,156,0,149,188,188,0,0,170
33313000,6,31246,Telhado,1784,869,915,1724,824,900,565,1,549,654,653,1,1,580
33381000,6,31247,Vermoim,2930,1435,1495,2820,1354,1466,996,1,913,1208,1208,0,1,851
33474000,6,31248,Vila Nova de Famalicão,8478,3947,4531,8324,3856,4468,3241,2,2576,4223,4223,0,8,1119
33559000,6,31249,Vilarinho das Cambas,1366,680,686,1313,653,660,413,0,410,499,496,3,0,410
33598000,6,31401,Santa Eulália,5619,2771,2848,5379,2631,2748,1827,1,1727,2057,2055,2,1,1417
33681000,6,31402,Caldas de Vizela (São João),3411,1635,1776,3310,1576,1734,1170,0,1054,1345,1344,1,2,896
33742000,6,31403,Caldas de Vizela (São Miguel),7222,3495,3727,6987,3355,3632,2508,3,2262,2929,2925,4,3,1454
33827000,6,31404,Infias,1840,912,928,1789,885,904,613,0,571,705,705,0,0,510
33871000,6,31405,Tagilde,1861,936,925,1829,914,915,555,0,550,632,631,1,0,489
33912000,6,31406,Vizela (Santo Adrião),2280,1142,1138,2201,1094,1107,728,0,693,837,835,2,0,631
33949000,6,31407,Vizela (São Paio),1503,762,741,1459,736,723,464,0,444,537,537,0,0,418
33984000,6,131401,Agrela,1584,754,830,1566,735,831,511,0,500,613,613,0,0,553
34040000,6,131402,Água Longa,2207,1081,1126,2151,1036,1115,746,0,691,917,917,0,0,829
34132000,6,131404,Areias,2454,1168,1286,2371,1118,1253,849,1,798,1036,1036,0,1,871
34191000,6,131405,Aves,8458,4075,4383,8226,3912,4314,3095,4,2705,3717,3714,3,8,2294
34341000,6,131406,Burgães,2097,1013,1084,2052,985,1067,710,0,656,850,850,0,0,764
34397000,6,131407,Carreira,1110,526,584,1078,512,566,372,1,348,434,434,0,1,409
34428000,6,131410,Guimarei,738,358,380,713,343,370,257,0,231,315,315,0,1,280
34458000,6,131411,Lama,1393,655,738,1349,624,725,489,0,443,572,572,0,0,479
34490000,6,131412,Lamelas,922,435,487,893,415,478,317,1,284,385,385,0,1,365
34532000,6,131413,Monte Córdova,3958,1957,2001,3832,1877,1955,1389,1,1246,1676,1672,4,1,1504
34639000,6,131415,Palmeira,1321,617,704,1301,602,699,458,0,421,536,536,0,0,445
34676000,6,131416,Rebordões,3416,1641,1775,3341,1598,1743,1201,0,1133,1456,1456,0,0,1252
34745000,6,131417,Refojos de Riba de Ave,962,456,506,916,430,486,326,0,300,394,394,0,0,366
34798000,6,131418,Reguenga,1596,760,836,1562,740,822,530,0,519,648,648,0,0,556
34860000,6,131419,Roriz,3665,1791,1874,3566,1722,1844,1238,3,1167,1359,1356,3,3,1108
34942000,6,131420,Couto (Santa Cristina),4064,1944,2120,3990,1889,2101,1437,3,1308,1638,1637,1,3,1331
35013000,6,131422,Santo Tirso,14107,6599,7508,13757,6378,7379,5051,12,4339,6244,6243,1,18,3161
35198000,6,131424,Negrelos (São Mamede),2145,1058,1087,2101,1023,1078,692,0,671,795,795,0,0,714
35232000,6,131426,Campo (São Martinho),3470,1683,1787,3388,1631,1757,1206,1,1130,1383,1383,0,2,899
35275000,6,131427,Couto (São Miguel),1222,582,640,1199,572,627,433,0,388,512,512,0,0,408
35299000,6,131429,São Salvador do Campo,1194,587,607,1169,570,599,379,0,380,444,444,0,0,345
35326000,6,131430,Negrelos (São Tomé),4032,1923,2109,3889,1831,2058,1458,0,1335,1748,1747,1,1,1318
35399000,6,131431,Sequeiró,1627,797,830,1564,761,803,557,1,511,654,654,0,1,574
35433000,6,131432,Vilarinho,3788,1874,1914,3656,1792,1864,1257,0,1207,1374,1365,9,0,1105
35492000,6,131801,Alvarelhos,3151,1553,1598,3049,1491,1558,985,0,988,1137,1135,2,0,1032
35590000,6,131802,Bougado (Santiago),6422,3133,3289,6261,3034,3227,2064,0,2012,2425,2422,3,1,1993
35737000,6,131803,Bougado (São Martinho),15190,7205,7985,14627,6867,7760,5326,3,4718,6455,6446,9,7,3021
35992000,6,131804,Coronado (São Mamede),4292,2106,2186,4149,2010,2139,1408,1,1338,1666,1663,3,2,1297
36090000,6,131805,Coronado (São Romão),4827,2341,2486,4660,2226,2434,1634,1,1505,2039,2027,12,1,1046
36160000,6,131806,Covelas,1536,753,783,1508,729,779,495,0,485,558,553,5,0,484
36219000,6,131807,Guidões,1659,804,855,1586,757,829,546,0,506,618,618,0,0,524
36280000,6,131808,Muro,1922,918,1004,1857,887,970,627,0,603,719,719,0,0,625
36344000,6,10701,Anta,10363,4934,5429,10142,4786,5356,3758,2,3283,4643,4643,0,2,2657
36542000,6,10702,Espinho,9832,4535,5297,9707,4459,5248,4220,1,3058,6292,6291,1,16,2491
36781000,6,10703,Guetim,1403,665,738,1363,642,721,484,0,458,568,568,0,0,445
36816000,6,10704,Paramos,3515,1731,1784,3434,1689,1745,1218,1,1112,1482,1481,1,2,1288
36908000,6,10705,Silvalde,6673,3247,3426,6562,3161,3401,2337,1,2096,2771,2770,1,2,2008
37056000,6,130401,Covelo,1647,819,828,1607,797,810,546,1,514,616,616,0,1,504
37096000,6,130402,Fânzeres,23108,11232,11876,22353,10750,11603,8365,6,7290,10003,10002,1,7,4241
37251000,6,130403,Foz do Sousa,6054,2969,3085,5848,2824,3024,1996,0,1908,2335,2335,0,0,1905
37317000,6,130404,Jovim,7146,3546,3600,6961,3411,3550,2433,2,2250,2775,2775,0,3,1965
37441000,6,130405,Lomba,1505,730,775,1457,710,747,496,1,459,773,773,0,2,699
37486000,6,130406,Medas,2129,1053,1076,2040,985,1055,709,0,660,832,832,0,1,722
37543000,6,130407,Melres,3691,1872,1819,3579,1778,1801,1133,0,1128,1317,1317,0,0,1202
37619000,6,130408,Rio Tinto,50713,23921,26792,48848,22775,26073,19608,7,16169,23846,23844,2,9,9171
37981000,6,130409,Gondomar (São Cosme),27047,13068,13979,26096,12479,13617,9813,5,8601,11470,11467,3,7,5651
38216000,6,130410,São Pedro da Cova,16478,8155,8323,15973,7823,8150,5753,0,5233,6597,6583,14,0,4117
38388000,6,130411,Valbom,14407,6880,7527,14042,6645,7397,5469,4,4583,6596,6596,0,5,3215
38524000,6,130412,Baguim do Monte (Rio Tinto),14102,6762,7340,13460,6396,7064,5130,2,4555,6276,6276,0,2,3167
38653000,6,130601,Águas Santas,27470,13110,14360,26503,12514,13989,10349,9,8705,12164,12143,21,12,4495
38946000,6,130602,Barca,2633,1247,1386,2572,1201,1371,940,0,836,1040,1040,0,0,834
39000000,6,130603,Folgosa,3704,1833,1871,3650,1805,1845,1273,2,1151,1538,1538,0,2,1313
39100000,6,130604,Gemunde,5215,2529,2686,5090,2440,2650,1846,1,1651,2111,2110,1,1,1131
39168000,6,130605,Gondim,2208,1062,1146,2170,1036,1134,732,0,688,819,818,1,0,623
39212000,6,130606,Gueifães,11964,5712,6252,11516,5439,6077,4480,3,3812,5075,5073,2,3,2500
39344000,6,130607,Maia,12406,5834,6572,11885,5544,6341,4798,2,3869,5692,5689,3,4,1396
39465000,6,130608,Milheirós,4861,2350,2511,4707,2247,2460,1747,1,1548,1991,1991,0,1,1263
39534000,6,130609,Moreira,12890,6248,6642,12437,5966,6471,4811,2,4100,5823,5821,2,7,2459
39706000,6,130610,Nogueira,5473,2621,2852,5288,2498,2790,2001,3,1744,2387,2384,3,4,1244
39794000,6,130611,Avioso (Santa Maria),4513,2196,2317,4364,2108,2256,1652,1,1383,1989,1986,3,2,787
39871000,6,130612,Avioso (São Pedro),3826,1862,1964,3937,1922,2015,1442,0,1218,1792,1791,1,1,823
39929000,6,130613,São Pedro Fins,1837,901,936,1828,891,937,595,1,565,727,726,1,1,555
39980000,6,130614,Silva Escura,2507,1207,1300,2464,1176,1288,843,0,764,992,991,1,0,720
40036000,6,130615,Vermoim,15764,7607,8157,15146,7228,7918,5840,2,4919,6698,6698,0,2,2319
40202000,6,130616,Vila Nova da Telha,5886,2839,3047,5625,2688,2937,2094,6,1843,2575,2573,2,6,1762
40286000,6,130617,Pedrouços,12149,5697,6452,12009,5611,6398,4825,6,3759,6201,6199,2,7,2588
40433000,6,130801,Custóias,18650,9287,9363,18182,8992,9190,6639,8,5747,7596,7594,2,3,3885
40616000,6,130802,Guifões,9495,4552,4943,9225,4370,4855,3621,3,3047,4139,4137,2,3,2590
40718000,6,130803,Lavra,10033,4861,5172,9554,4575,4979,3672,2,3209,4941,4932,9,3,3104
40877000,6,130804,Leça do Balio,17571,8422,9149,17106,8066,9040,6634,7,5486,7713,7708,5,9,3691
41055000,6,130805,Leça da Palmeira,18502,8716,9786,18006,8532,9474,7324,3,5828,9400,9393,7,16,3656
41310000,6,130806,Matosinhos,30984,14429,16555,29694,13666,16028,12485,8,9446,15032,15014,18,21,4010
41572000,6,130807,Perafita,13607,6571,7036,13153,6244,6909,5036,0,4372,5856,5848,8,3,3244
41731000,6,130808,Santa Cruz do Bispo,5767,2846,2921,5538,2718,2820,1964,8,1671,2215,2207,8,3,1320
41804000,6,130809,São Mamede de Infesta,23122,10745,12377,23376,10786,12590,9508,7,7138,12284,12279,5,11,4263
42030000,6,130810,Senhora da Hora,27747,13015,14732,27257,12610,14647,10938,4,8743,12979,12973,6,8,3626
42282000,6,131201,Aldoar,12843,6044,6799,12799,5891,6908,4850,10,3833,5843,5838,5,13,2212
42402000,6,131202,Bonfim,24265,10674,13591,24146,10541,13605,10994,39,6955,14993,14988,5,91,5428
42604000,6,131203,Campanhã,32659,15130,17529,31846,14582,17264,12955,18,10011,16431,16361,70,27,7133
42971000,6,131204,Cedofeita,22077,9736,12341,22814,9970,12844,10375,31,6221,15711,15700,11,82,4796
43143000,6,131205,Foz do Douro,10997,5098,5899,10569,4824,5745,4517,3,3306,5701,5698,3,6,1962
43301000,6,131206,Lordelo do Ouro,22270,10337,11933,22068,10158,11910,8631,2,6682,10919,10918,1,9,2651
43498000,6,131207,Massarelos,6789,3088,3701,7698,3523,4175,3064,2,1951,4380,4376,4,16,1114
43597000,6,131208,Miragaia,2067,953,1114,3012,1655,1357,993,0,564,1522,1522,0,7,572
43638000,6,131209,Nevogilde,5018,2296,2722,4748,2145,2603,1985,3,1455,2460,2459,1,3,896
43691000,6,131210,Paranhos,44298,20045,24253,47800,21748,26052,19185,33,13089,27192,27179,13,64,7789
44108000,6,131211,Ramalde,38012,17311,20701,36838,16636,20202,15352,19,11355,18835,18831,4,24,4783
44426000,6,131212,Santo Ildefonso,9029,4104,4925,9888,4559,5329,4636,13,2368,7132,7126,6,89,2713
44544000,6,131213,São Nicolau,1906,842,1064,2017,922,1095,804,6,546,1586,1585,1,17,443
44581000,6,131214,Sé,3460,1609,1851,3705,1725,1980,1583,7,904,2745,2738,7,43,1178
44644000,6,131215,Vitória,1901,837,1064,2268,1019,1249,902,3,500,1921,1917,4,29,654
44685000,6,131301,A Ver-o-Mar,8675,4111,4564,8362,3890,4472,3123,2,2695,6405,6399,6,5,2351
44841000,6,131302,Aguçadoura,4257,2067,2190,4212,2033,2179,1218,0,1305,1684,1684,0,0,1477
44937000,6,131303,Amorim,2784,1350,1434,2730,1313,1417,871,0,855,1022,1022,0,0,903
45019000,6,131304,Argivai,2163,1002,1161,2116,962,1154,728,0,676,869,869,0,0,608
45055000,6,131305,Balazar,2543,1194,1349,2449,1130,1319,816,1,745,1094,1093,1,1,877
45152000,6,131306,Beiriz,3683,1760,1923,3746,1842,1904,1187,0,1155,1549,1549,0,1,1323
45248000,6,131307,Estela,2316,1123,1193,2233,1063,1170,652,1,696,934,934,0,4,892
45325000,6,131308,Laundos,2055,976,1079,1997,933,1064,564,0,629,785,785,0,1,777
45386000,6,131309,Navais,1479,681,798,1417,645,772,439,0,455,557,557,0,0,526
45445000,6,131310,Póvoa de Varzim,28420,13243,15177,27122,12403,14719,10660,5,8628,18128,18126,2,19,5510
45795000,6,131311,Rates,2505,1234,1271,2442,1188,1254,682,1,749,880,880,0,2,868
45885000,6,131312,Terroso,2528,1217,1311,2450,1178,1272,729,4,730,983,983,0,4,948
45974000,6,131501,Alfena,15211,7372,7839,14582,6964,7618,5309,4,4767,6221,6216,5,5,3641
46136000,6,131502,Campo,9197,4538,4659,8942,4374,4568,3079,1,2897,3537,3531,6,2,2324
46290000,6,131503,Ermesinde,38798,18358,20440,37307,17463,19844,14761,15,12374,17395,17383,12,18,6448
46615000,6,131504,Sobrado,6727,3262,3465,6589,3157,3432,2139,1,2066,2475,2475,0,1,1893
46722000,6,131505,Valongo,23925,11486,12439,22789,10786,12003,8658,3,7528,10785,10778,7,6,4169
46996000,6,131601,Arcos,819,393,426,807,381,426,251,0,247,312,312,0,1,292
47023000,6,131602,Árvore,5196,2609,2587,4976,2448,2528,1845,1,1604,2724,2722,2,1,1751
47144000,6,131603,Aveleda,1314,633,681,1269,599,670,447,0,423,503,501,2,0,462
47174000,6,131604,Azurara,2305,1091,1214,2309,1081,1228,829,2,716,1264,1264,0,6,692
47210000,6,131605,Bagunte,1489,730,759,1396,674,722,424,1,443,494,493,1,1,483
47250000,6,131606,Canidelo,906,435,471,886,418,468,293,0,283,330,330,0,0,272
47272000,6,131607,Fajozes,1425,699,726,1376,661,715,468,1,449,564,559,5,1,430
47313000,6,131608,Ferreiró,690,339,351,667,322,345,212,0,198,247,247,0,1,226
47330000,6,131609,Fornelo,1392,671,721,1358,644,714,463,0,428,604,604,0,0,483
47365000,6,131610,Gião,1756,877,879,1671,824,847,615,0,556,672,671,1,0,519
47401000,6,131611,Guilhabreu,2357,1154,1203,2273,1091,1182,787,0,738,841,840,1,0,658
47444000,6,131612,Junqueira,2019,977,1042,1941,920,1021,647,1,621,780,780,0,1,714
47492000,6,131613,Labruge,2806,1372,1434,2667,1281,1386,953,1,870,1504,1502,2,1,866
47546000,6,131614,Macieira da Maia,2321,1138,1183,2207,1067,1140,757,1,737,952,940,12,1,635
47588000,6,131615,Malta,1385,686,699,1339,647,692,463,0,439,506,506,0,0,358
47614000,6,131616,Mindelo,3491,1646,1845,3320,1535,1785,1266,0,1098,2478,2478,0,0,1640
47728000,6,131617,Modivas,1806,873,933,1740,828,912,596,0,576,718,718,0,0,553
47772000,6,131618,Mosteiró,931,451,480,931,450,481,320,0,293,409,409,0,0,354
47807000,6,131619,Outeiro Maior,369,179,190,349,168,181,103,0,108,132,132,0,0,122
47825000,6,131620,Parada,300,156,144,292,151,141,94,0,89,120,120,0,0,113
47841000,6,131621,Retorta,1165,574,591,1122,537,585,396,0,364,479,479,0,1,376
47866000,6,131622,Rio Mau,1862,900,962,1780,845,935,593,0,568,732,732,0,0,642
47923000,6,131623,Tougues,887,426,461,833,385,448,286,0,274,340,340,0,0,244
47941000,6,131624,Touguinha,2000,970,1030,1902,891,1011,601,2,571,743,742,1,2,543
47968000,6,131625,Touguinhó,1386,663,723,1292,600,692,439,0,431,574,574,0,0,478
47997000,6,131626,Vairão,1251,590,661,1206,565,641,391,0,388,487,487,0,1,414
48037000,6,131627,Vila Chã,3094,1473,1621,3027,1420,1607,1041,0,986,1672,1672,0,2,1314
48093000,6,131628,Vila do Conde,28636,13730,14906,27167,12466,14701,10192,11,8772,14832,14829,3,21,5940
48407000,6,131629,Vilar,1638,801,837,1575,757,818,555,0,537,633,633,0,0,503
48434000,6,131630,Vilar de Pinheiro,2537,1233,1304,2465,1186,1279,883,0,818,1083,1081,2,0,818
48483000,6,131701,Arcozelo,14352,6937,7415,13826,6610,7216,5319,7,4498,6963,6955,8,9,3862
48732000,6,131702,Avintes,11497,5603,5894,11260,5479,5781,4119,1,3636,4973,4965,8,2,2897
48900000,6,131703,Canelas,13459,6525,6934,13103,6289,6814,4876,0,4270,5841,5833,8,0,2324
49034000,6,131704,Canidelo,27769,13362,14407,26591,12606,13985,10768,4,8806,13291,13274,17,9,5427
49283000,6,131705,Crestuma,2621,1273,1348,2533,1221,1312,873,1,824,1020,1020,0,2,702
49317000,6,131706,Grijó,10578,5115,5463,10317,4941,5376,3705,1,3342,4513,4487,26,11,3286
49492000,6,131707,Gulpilhares,11341,5432,5909,10870,5122,5748,4223,8,3521,5594,5590,4,10,3014
49619000,6,131708,Lever,2794,1365,1429,2706,1312,1394,940,0,869,1139,1139,0,3,972
49673000,6,131709,Madalena,10040,4789,5251,9614,4538,5076,3823,3,3197,4884,4877,7,3,3030
49803000,6,131710,Mafamude,38544,17734,20810,37271,16955,20316,15918,10,11960,19714,19691,23,13,5050
50082000,6,131711,Olival,5812,2807,3005,5683,2724,2959,1931,0,1818,2180,2180,0,0,1599
50193000,6,131712,Oliveira do Douro,22383,10651,11732,21518,10122,11396,8509,1,7135,10585,10575,10,1,3872
50383000,6,131713,Pedroso,18714,9148,9566,18078,8750,9328,6626,6,5923,8051,8044,7,13,5415
50659000,6,131714,Perozinho,6359,3151,3208,6136,3006,3130,2240,1,1988,2618,2617,1,1,1830
50762000,6,131715,Sandim,5938,2866,3072,5899,2857,3042,1908,1,1846,2275,2274,1,2,1962
50895000,6,131716,Vila Nova de Gaia (Santa Marinha),30146,14054,16092,29046,13408,15638,12523,8,9326,16346,16334,12,10,5266
51179000,6,131717,São Félix da Marinha,12706,6144,6562,12364,5990,6374,4799,2,3991,6431,6425,6,3,3216
51382000,6,131718,São Pedro da Afurada,3568,1737,1831,3522,1708,1814,1537,0,1039,2137,2137,0,4,658
51432000,6,131719,Seixezelo,1712,831,881,1651,791,860,601,0,537,758,758,0,0,517
51459000,6,131720,Sermonde,1360,655,705,1315,627,688,466,1,417,548,548,0,1,439
51480000,6,131721,Serzedo,7891,3767,4124,7639,3597,4042,2771,1,2527,3288,3255,33,1,2090
51587000,6,131722,Valadares,10678,5072,5606,10266,4830,5436,3998,4,3370,4834,4831,3,8,2438
51705000,6,131723,Vilar de Andorinho,18155,8820,9335,18864,8818,10046,6458,2,5629,7882,7876,6,3,2489
51868000,6,131724,Vilar do Paraíso,13878,6652,7226,13321,6302,7019,5332,3,4393,6387,6378,9,3,2733
52014000,6,10601,Bairros,2047,980,1067,1934,907,1027,660,0,656,801,801,0,0,708
52086000,6,10602,Fornos,1439,666,773,1331,588,743,515,0,449,678,678,0,0,617
52153000,6,10603,Paraíso,924,473,451,888,445,443,318,0,275,515,515,0,0,479
52230000,6,10604,Pedorido,1458,712,746,1403,678,725,505,1,450,685,684,1,1,645
52304000,6,10605,Raiva,2312,1154,1158,2227,1090,1137,791,2,689,1084,1084,0,2,1020
52372000,6,10606,Real,1300,635,665,1241,598,643,418,0,392,655,655,0,0,599
52456000,6,10607,Santa Maria de Sardoura,2538,1257,1281,2367,1134,1233,814,1,771,1045,1042,3,1,982
52530000,6,10608,São Martinho de Sardoura,1931,954,977,1807,864,943,612,0,596,742,742,0,0,609
52587000,6,10609,Sobrado,2784,1353,1431,2657,1249,1408,942,1,865,1218,1216,2,4,908
52669000,6,30401,Abadim,571,268,303,556,259,297,182,0,158,309,309,0,2,309
52697000,6,30402,Alvite,963,467,496,884,411,473,301,0,283,423,423,0,1,404
52740000,6,30403,Arco de Baúlhe,1669,829,840,1597,779,818,547,0,486,896,896,0,1,727
52790000,6,30404,Basto,938,463,475,880,421,459,282,0,258,441,441,0,0,426
52822000,6,30405,Bucos,554,261,293,504,225,279,191,1,162,326,326,0,5,327
52857000,6,30406,Cabeceiras de Basto,711,344,367,671,323,348,255,1,188,504,504,0,2,500
52912000,6,30407,Cavez,1268,623,645,1236,606,630,461,1,377,883,883,0,5,875
52962000,6,30408,Faia,558,283,275,537,265,272,187,0,163,258,258,0,2,236
52987000,6,30409,Gondiães,227,104,123,218,99,119,105,0,66,275,275,0,1,270
53012000,6,30410,Outeiro,1116,547,569,1081,523,558,365,0,337,503,503,0,0,492
53052000,6,30411,Painzela,959,464,495,894,418,476,330,0,272,483,483,0,0,449
53088000,6,30412,Passos,221,93,128,211,86,125,78,0,65,127,127,0,2,128
53110000,6,30413,Pedraça,760,372,388,714,344,370,257,0,220,436,436,0,1,405
53147000,6,30414,Refojos de Basto,4680,2260,2420,4361,2064,2297,1557,1,1387,2379,2377,2,4,1851
53345000,6,30415,Rio Douro,942,456,486,918,445,473,334,0,276,662,662,0,1,654
53415000,6,30416,Vila Nune,379,188,191,362,178,184,119,0,111,224,224,0,0,222
53431000,6,30417,Vilar de Cunhas,194,93,101,184,88,96,71,0,60,199,199,0,1,195
53455000,6,30501,Agilde,1227,617,610,1184,589,595,413,0,357,611,610,1,0,595
53498000,6,30502,Arnóia,1702,838,864,1612,780,832,572,1,492,1010,1010,0,2,985
53580000,6,30503,Borba de Montanha,1294,595,699,1234,552,682,403,1,353,568,567,1,2,553
53638000,6,30504,Britelo,2561,1238,1323,2502,1197,1305,888,0,753,1283,1283,0,1,1071
53742000,6,30505,Caçarilhe,466,229,237,454,223,231,163,0,140,265,265,0,0,258
53763000,6,30506,Canedo de Basto,1010,492,518,933,443,490,344,0,301,509,509,0,1,506
53800000,6,30507,Carvalho,789,385,404,823,402,421,259,0,220,419,419,0,0,402
53835000,6,30508,Codeçoso,444,206,238,428,196,232,166,0,129,261,261,0,0,256
53870000,6,30509,Corgo,311,144,167,313,144,169,113,0,88,209,209,0,0,205
53885000,6,30510,Fervença,1445,701,744,1381,653,728,495,0,440,765,765,0,0,671
53938000,6,30511,Gagos,628,308,320,599,287,312,210,0,183,316,316,0,0,299
53969000,6,30512,Gémeos,650,324,326,625,305,320,221,0,192,319,319,0,2,273
54000000,6,30513,Infesta,292,148,144,253,118,135,111,0,78,186,186,0,0,184
54012000,6,30514,Molares,621,291,330,619,299,320,200,2,173,292,292,0,3,262
54036000,6,30515,Moreira do Castelo,627,322,305,572,283,289,197,0,181,269,269,0,0,267
54069000,6,30516,Ourilhe,459,220,239,429,202,227,154,0,137,269,269,0,0,264
54103000,6,30517,Rego,1241,614,627,1150,548,602,427,0,351,737,737,0,0,719
54158000,6,30518,Ribas,1068,494,574,1002,452,550,312,2,287,480,480,0,3,461
54200000,6,30519,Basto (Santa Tecla),212,98,114,201,90,111,74,0,59,167,167,0,0,167
54220000,6,30520,Basto (São Clemente),1524,761,763,1386,692,694,532,0,459,837,837,0,0,755
54275000,6,30521,Vale de Bouro,813,374,439,790,355,435,274,0,244,445,445,0,0,440
54309000,6,30522,Veade,714,350,364,676,325,351,251,0,209,402,402,0,0,379
54353000,6,130101,Aboadela,783,353,430,727,317,410,262,1,229,475,475,0,1,461
54402000,6,130102,Aboim,596,284,312,575,272,303,205,0,181,311,311,0,0,302
54427000,6,130103,Ansiães,623,295,328,481,213,268,245,0,192,475,475,0,1,471
54466000,6,130104,Ataíde,1002,470,532,947,432,515,361,1,310,523,523,0,1,347
54492000,6,130105,Bustelo,521,246,275,468,213,255,186,0,165,416,416,0,0,411
54528000,6,130106,Canadelo,121,55,66,118,54,64,57,0,39,160,160,0,0,159
54534000,6,130107,Candemil,771,367,404,745,351,394,285,0,235,542,542,0,1,537
54571000,6,130108,Carneiro,311,152,159,286,132,154,114,0,95,211,211,0,0,209
54584000,6,130109,Carvalho de Rei,187,87,100,183,84,99,74,0,52,173,173,0,0,173
54597000,6,130110,Cepelos,1758,860,898,1704,821,883,598,0,547,871,871,0,6,708
54632000,6,130111,Chapa,301,143,158,291,133,158,103,0,90,178,178,0,0,178
54653000,6,130112,Fregim,2836,1345,1491,2679,1244,1435,891,2,827,1116,1114,2,1,970
54704000,6,130113,Freixo de Baixo,1434,695,739,1378,658,720,496,0,447,716,716,0,0,603
54746000,6,130114,Freixo de Cima,2203,1076,1127,2071,1004,1067,705,0,683,956,954,2,1,789
54797000,6,130115,Fridão,863,418,445,842,407,435,309,0,254,415,415,0,0,394
54820000,6,130116,Gatão,1586,795,791,1517,748,769,556,0,494,737,737,0,2,636
54870000,6,130117,Gondar,1686,830,856,1594,769,825,565,0,515,847,847,0,0,801
54920000,6,130118,Jazente,542,266,276,522,257,265,203,0,179,300,300,0,1,277
54946000,6,130119,Lomba,793,369,424,778,363,415,264,0,246,420,420,0,0,374
54981000,6,130120,Louredo,638,314,324,606,289,317,226,0,200,299,299,0,0,276
55006000,6,130121,Lufrei,1777,852,925,1664,786,878,609,0,542,904,904,0,0,788
55049000,6,130122,Madalena,1956,894,1062,1962,884,1078,707,2,590,1038,1038,0,5,522
55074000,6,130123,Mancelos,3114,1522,1592,2994,1437,1557,1022,0,950,1423,1423,0,0,1262
55152000,6,130124,Oliveira,862,420,442,835,401,434,302,0,266,382,382,0,0,285
55175000,6,130125,Olo,371,167,204,372,172,200,125,0,105,239,239,0,0,230
55193000,6,130126,Padronelo,884,435,449,847,409,438,313,0,278,458,458,0,0,376
55223000,6,130127,Real,3142,1528,1614,2948,1381,1567,1115,0,970,1427,1427,0,1,1202
55273000,6,130128,Rebordelo,365,174,191,327,150,177,118,0,104,187,187,0,0,182
55297000,6,130129,Salvador do Monte,1066,529,537,990,478,512,368,0,343,508,508,0,0,482
55346000,6,130130,Sanche,509,238,271,498,232,266,168,0,151,297,297,0,0,291
55376000,6,130131,Figueiró (Santa Cristina),1370,667,703,1324,633,691,472,0,428,592,592,0,0,521
55419000,6,130132,Figueiró (Santiago),2458,1173,1285,2387,1130,1257,834,0,758,1250,1250,0,0,1047
55493000,6,130133,Amarante (São Gonçalo),6540,3018,3522,6166,2801,3365,2410,4,1985,3372,3368,4,3,1331
55572000,6,130134,Gouveia (São Simão),633,315,318,609,297,312,235,0,200,423,423,0,0,411
55612000,6,130135,Telões,4232,2042,2190,4057,1926,2131,1467,0,1292,2109,2109,0,1,1685
55710000,6,130136,Travanca,2278,1108,1170,2193,1045,1148,746,0,696,1019,1019,0,0,896
55760000,6,130137,Várzea,383,189,194,383,192,191,140,0,117,256,256,0,0,247
55777000,6,130138,Vila Caiz,3026,1452,1574,2737,1218,1519,972,0,916,1269,1269,0,1,1142
55842000,6,130139,Vila Chã do Marão,940,441,499,887,412,475,309,0,276,536,536,0,3,528
55877000,6,130140,Vila Garcia,803,384,419,766,360,406,273,0,247,408,408,0,0,385
55906000,6,130201,Ancede,2527,1226,1301,2391,1129,1262,868,0,784,1280,1280,0,2,1134
56002000,6,130202,Campelo,3237,1507,1730,3027,1363,1664,1084,2,966,1594,1594,0,4,1205
56119000,6,130203,São Tomé de Covelas,576,287,289,526,247,279,186,0,172,377,377,0,1,373
56147000,6,130204,Frende,656,324,332,586,268,318,243,0,209,399,399,0,0,358
56186000,6,130205,Gestaçô,1263,600,663,1160,533,627,459,0,386,788,788,0,3,768
56253000,6,130206,Gove,1992,985,1007,1855,874,981,681,0,611,1027,1027,0,0,921
56323000,6,130207,Grilo,590,293,297,509,230,279,204,0,182,247,247,0,0,226
56356000,6,130208,Loivos do Monte,373,173,200,346,150,196,124,0,111,212,212,0,0,209
56381000,6,130209,Loivos da Ribeira,480,230,250,468,223,245,162,0,147,231,231,0,0,204
56398000,6,130210,Mesquinhata,301,142,159,282,129,153,103,0,89,194,194,0,1,192
56421000,6,130211,Ovil,701,329,372,664,301,363,270,0,221,637,637,0,0,633
56473000,6,130212,Ribadouro,309,141,168,276,119,157,132,0,94,243,243,0,1,239
56502000,6,130213,Santa Cruz do Douro,1453,680,773,1366,610,756,501,1,438,865,865,0,4,841
56572000,6,130214,Baião (Santa Leocádia),554,272,282,493,225,268,197,0,168,347,347,0,0,334
56611000,6,130215,Santa Marinha do Zêzere,2796,1313,1483,2582,1153,1429,983,1,860,1433,1433,0,4,1232
56720000,6,130216,Teixeira,595,276,319,555,249,306,237,0,191,515,515,0,0,511
56770000,6,130217,Teixeiró,351,179,172,325,160,165,112,0,103,188,188,0,0,188
56801000,6,130218,Tresouras,373,182,191,342,156,186,133,0,111,218,218,0,0,213
56831000,6,130219,Valadares,875,428,447,781,356,425,300,0,272,491,491,0,0,465
56876000,6,130220,Viariz,520,244,276,462,192,270,190,0,163,309,309,0,0,302
56900000,6,130301,Aião,856,415,441,847,407,440,262,0,258,355,355,0,0,325
56926000,6,130302,Airães,2486,1170,1316,2381,1107,1274,802,1,767,1040,1040,0,3,890
56991000,6,130303,Borba de Godim,2341,1097,1244,2215,1023,1192,817,0,717,1198,1197,1,0,806
57040000,6,130304,Caramos,1854,893,961,1754,832,922,599,0,573,812,812,0,0,643
57081000,6,130305,Friande,1838,912,926,1749,852,897,564,0,548,726,726,0,0,596
57123000,6,130306,Idães,2496,1198,1298,2543,1209,1334,790,1,750,995,995,0,1,788
57169000,6,130307,Jugueiros,1303,649,654,1256,627,629,418,0,383,559,558,1,0,480
57207000,6,130308,Lagares,2320,1133,1187,2269,1105,1164,799,1,711,937,937,0,1,750
57254000,6,130309,Lordelo,357,171,186,353,165,188,102,1,104,145,145,0,1,139
57266000,6,130310,Macieira da Lixa,1961,955,1006,1876,896,980,636,0,601,828,828,0,0,730
57327000,6,130311,Moure,1321,673,648,1277,642,635,423,0,407,529,528,1,0,431
57379000,6,130312,Pedreira,1564,762,802,1525,732,793,492,2,471,625,625,0,3,547
57417000,6,130313,Penacova,1130,564,566,1103,550,553,360,0,342,425,425,0,0,361
57441000,6,130314,Pinheiro,1042,522,520,1064,531,533,331,0,321,468,468,0,0,419
57474000,6,130315,Pombeiro de Ribavizela,2218,1079,1139,2127,1023,1104,683,0,673,815,815,0,2,644
57524000,6,130316,Rande,982,446,536,938,421,517,321,0,304,395,395,0,0,307
57547000,6,130317,Refontoura,2081,1038,1043,1972,967,1005,622,0,644,745,745,0,0,652
57600000,6,130318,Regilde,1284,612,672,1269,602,667,440,0,393,474,474,0,0,361
57630000,6,130319,Revinhade,811,405,406,773,381,392,254,0,240,307,307,0,0,238
57651000,6,130320,Margaride (Santa Eulália),9653,4633,5020,9574,4568,5006,3311,5,2912,4296,4296,0,11,1998
57805000,6,130321,Santão,776,379,397,731,345,386,255,0,235,370,370,0,0,340
57824000,6,130323,Vizela (São Jorge),574,284,290,568,279,289,187,0,177,244,244,0,1,218
57846000,6,130324,Sendim,1627,781,846,1574,751,823,509,0,500,636,636,0,0,546
57891000,6,130325,Sernande,941,461,480,919,448,471,308,0,286,382,382,0,0,307
57912000,6,130326,Sousa,1095,532,563,1070,523,547,387,0,324,448,448,0,0,334
57938000,6,130327,Torrados,2370,1185,1185,2277,1133,1144,738,0,721,881,881,0,0,638
57989000,6,130328,Unhão,800,395,405,738,364,374,254,1,246,340,340,0,1,301
58011000,6,130329,Várzea,2859,1380,1479,2769,1325,1444,939,0,878,1112,1112,0,0,798
58071000,6,130330,Varziela,1837,879,958,1772,844,928,588,0,537,722,722,0,1,654
58128000,6,130331,Vila Cova da Lixa,3850,1810,2040,3717,1736,1981,1341,1,1194,1869,1869,0,1,1170
58220000,6,130332,Vila Fria,629,310,319,637,298,339,201,0,189,232,232,0,1,207
58238000,6,130333,Vila Verde,809,380,429,761,345,416,269,0,247,372,371,1,0,311
58269000,6,130501,Alvarenga,463,218,245,441,205,236,150,0,138,190,189,1,0,160
58290000,6,130502,Aveleda,2073,1004,1069,1984,936,1048,636,1,613,780,780,0,1,618
58334000,6,130503,Boim,3102,1546,1556,2960,1451,1509,964,0,917,1134,1133,1,1,843
58369000,6,130504,Caíde de Rei,2529,1232,1297,2391,1131,1260,853,0,764,1053,1050,3,0,914
58421000,6,130505,Casais,1401,691,710,1373,670,703,422,1,426,502,502,0,1,457
58454000,6,130506,Cernadelo,980,474,506,916,430,486,321,0,295,394,394,0,0,328
58477000,6,130507,Covas,726,353,373,710,345,365,225,0,214,269,269,0,1,225
58494000,6,130508,Cristelos,3040,1484,1556,2913,1395,1518,1031,0,948,1285,1285,0,0,659
58523000,6,130509,Figueiras,1382,677,705,1335,640,695,406,0,410,514,514,0,0,438
58558000,6,130510,Lodares,2002,959,1043,1899,885,1014,632,1,610,750,750,0,1,607
58600000,6,130511,Lustosa,4792,2358,2434,4689,2288,2401,1573,0,1428,1924,1921,3,0,1465
58711000,6,130512,Macieira,1344,634,710,1276,585,691,441,0,410,543,543,0,0,491
58752000,6,130513,Meinedo,4052,1936,2116,3866,1804,2062,1314,0,1249,1614,1614,0,0,1386
58833000,6,130514,Nespereira,2085,1033,1052,2014,980,1034,677,0,649,813,813,0,0,622
58872000,6,130515,Nevogilde,2617,1310,1307,2518,1236,1282,774,0,794,869,868,1,0,708
58929000,6,130516,Nogueira,1253,603,650,1211,581,630,422,0,388,509,509,0,0,416
58960000,6,130517,Ordem,1201,580,621,1172,562,610,379,0,361,458,458,0,0,389
58988000,6,130518,Pias,1288,625,663,1227,579,648,424,0,403,521,520,1,0,424
59014000,6,130520,Lousada (Santa Margarida),307,144,163,299,138,161,106,0,91,149,149,0,0,135
59026000,6,130521,Barrosas (Santo Estêvão),983,504,479,969,492,477,311,0,288,380,380,0,1,273
59055000,6,130522,Lousada (São Miguel),879,420,459,760,358,402,292,0,271,337,337,0,0,288
59082000,6,130523,Silvares,3207,1534,1673,3090,1461,1629,1064,1,945,1351,1351,0,2,700
59135000,6,130524,Sousela,1797,869,928,1736,832,904,572,0,537,670,670,0,1,596
59175000,6,130525,Torno,2542,1246,1296,2449,1177,1272,820,0,754,1066,1066,0,2,731
59210000,6,130526,Vilar do Torno e Alentém,1342,643,699,1284,595,689,448,0,416,581,581,0,0,511
59258000,6,130701,Alpendurada e Matos,5580,2789,2791,5172,2475,2697,1779,1,1678,2286,2286,0,3,1680
59334000,6,130702,Ariz,1843,889,954,1678,759,919,615,0,548,840,839,1,0,667
59377000,6,130703,Avessadas,1247,593,654,1186,552,634,430,1,375,611,611,0,2,538
59413000,6,130704,Banho e Carvalhosa,1276,619,657,1133,494,639,439,0,404,650,650,0,1,567
59440000,6,130705,Constance,1626,802,824,1469,690,779,521,0,492,668,667,1,0,538
59470000,6,130706,Favões,1234,587,647,1106,500,606,411,0,357,569,569,0,0,437
59492000,6,130707,Folhada,602,280,322,574,261,313,208,0,175,373,373,0,0,353
59517000,6,130708,Fornos,3614,1753,1861,3394,1568,1826,1219,2,1078,1608,1606,2,2,777
59553000,6,130709,Freixo,845,418,427,786,384,402,277,0,255,359,359,0,0,319
59588000,6,130710,Magrelos,800,399,401,722,328,394,268,1,238,431,431,0,1,359
59610000,6,130711,Manhuncelos,486,238,248,469,222,247,152,0,137,211,210,1,0,193
59631000,6,130712,Maureles,460,232,228,441,218,223,147,0,131,214,214,0,0,184
59646000,6,130713,Paços de Gaiolo,995,488,507,910,422,488,349,0,299,584,584,0,0,561
59677000,6,130714,Paredes de Viadores,1289,654,635,1226,599,627,402,1,376,588,588,0,1,555
59707000,6,130715,Penha Longa,1929,974,955,1705,787,918,641,0,583,932,932,0,1,788
59746000,6,130716,Rio de Galinhas,2014,942,1072,1888,846,1042,687,0,612,922,922,0,1,645
59776000,6,130717,Rosem,220,111,109,210,105,105,70,0,63,126,126,0,1,122
59785000,6,130718,Sande,1882,896,986,1689,745,944,631,0,554,962,961,1,2,854
59821000,6,130719,Santo Isidoro,1495,722,773,1400,646,754,524,0,472,638,638,0,1,546
59860000,6,130720,São Lourenço do Douro,987,486,501,907,420,487,319,0,303,451,451,0,1,382
59883000,6,130721,São Nicolau,447,212,235,403,186,217,165,0,138,233,233,0,0,133
59895000,6,130722,Soalhães,3682,1789,1893,3476,1640,1836,1199,0,1090,1623,1623,0,0,1489
59968000,6,130723,Sobretâmega,1132,556,576,1064,502,562,385,0,347,504,504,0,2,425
59989000,6,130724,Tabuado,1375,674,701,1325,636,689,450,0,414,572,572,0,1,500
60015000,6,130725,Torrão,807,387,420,774,360,414,292,0,255,346,346,0,0,263
60030000,6,130726,Toutosa,588,270,318,544,237,307,213,0,182,266,266,0,0,214
60044000,6,130727,Tuias,4094,1971,2123,3791,1761,2030,1412,0,1239,1876,1874,2,2,801
60086000,6,130728,Várzea do Douro,2098,1055,1043,1930,923,1007,660,0,612,833,833,0,0,723
60130000,6,130729,Várzea da Ovelha e Aliviada,2169,1081,1088,2009,964,1045,736,0,638,1038,1038,0,0,966
60206000,6,130730,Vila Boa do Bispo,3240,1540,1700,2986,1349,1637,1044,1,946,1509,1509,0,1,1228
60264000,6,130731,Vila Boa de Quires,3394,1632,1762,3124,1445,1679,1072,0,1016,1280,1279,1,0,1108
60334000,6,130901,Arreigada,1999,1002,997,1921,939,982,638,0,587,725,724,1,1,505
60381000,6,130902,Carvalhosa,4583,2266,2317,4442,2193,2249,1471,1,1384,1744,1744,0,1,1393
60454000,6,130903,Codessos,1011,505,506,982,485,497,318,0,308,374,374,0,1,336
60489000,6,130904,Eiriz,2303,1170,1133,2255,1141,1114,702,0,681,779,779,0,0,653
60542000,6,130905,Ferreira,4341,2155,2186,4172,2051,2121,1321,0,1291,1529,1527,2,0,1294
60659000,6,130906,Figueiró,2496,1237,1259,2433,1193,1240,781,0,750,922,922,0,0,752
60726000,6,130907,Frazão,4264,2095,2169,4173,2038,2135,1391,0,1324,1598,1597,1,0,1254
60811000,6,130908,Freamunde,7789,3821,3968,7533,3665,3868,2470,1,2352,2904,2897,7,4,1700
60904000,6,130909,Lamoso,1613,804,809,1591,790,801,540,0,489,627,626,1,0,546
60949000,6,130910,Meixomil,3676,1808,1868,3605,1764,1841,1184,0,1128,1425,1425,0,0,1056
61037000,6,130911,Modelos,1594,758,836,1558,731,827,532,0,478,516,516,0,0,421
61086000,6,130912,Paços de Ferreira,7491,3615,3876,7283,3491,3792,2570,2,2272,3407,3402,5,4,1385
61199000,6,130913,Penamaior,3819,1870,1949,3747,1826,1921,1222,0,1144,1413,1413,0,1,1104
61288000,6,130914,Raimonda,2576,1253,1323,2514,1213,1301,825,0,791,977,975,2,1,806
61349000,6,130915,Sanfins de Ferreira,3139,1513,1626,3057,1456,1601,1014,0,960,1139,1139,0,1,841
61417000,6,130916,Seroa,3646,2209,1437,3532,2137,1395,929,9,866,1144,1144,0,2,866
61496000,6,131001,Aguiar de Sousa,1631,799,832,1609,783,826,511,1,503,649,649,0,1,610
61566000,6,131002,Astromil,1086,539,547,1041,512,529,345,0,343,400,400,0,0,303
61587000,6,131003,Baltar,4818,2352,2466,4679,2234,2445,1654,1,1490,2043,2040,3,1,1305
61659000,6,131004,Beire,2040,995,1045,2339,1134,1205,626,0,626,739,739,0,0,674
61712000,6,131005,Besteiros,1448,707,741,1417,686,731,469,0,434,531,531,0,0,443
61750000,6,131006,Bitarães,2868,1395,1473,2760,1328,1432,915,0,865,1062,1062,0,0,848
61818000,6,131007,Castelões de Cepeda,8755,4139,4616,8416,3950,4466,3131,2,2694,3988,3988,0,4,1499
61930000,6,131008,Cete,3113,1498,1615,2986,1406,1580,1058,0,980,1315,1315,0,1,814
61986000,6,131009,Cristelo,1891,958,933,1809,895,914,591,0,557,709,709,0,0,489
62035000,6,131010,Duas Igrejas,3879,1943,1936,3705,1805,1900,1166,1,1117,1365,1365,0,1,1028
62125000,6,131011,Gandra,6974,3448,3526,7013,3379,3634,2291,0,2116,3137,3135,2,1,2042
62267000,6,131012,Gondalães,1228,600,628,1206,586,620,387,0,368,481,481,0,0,357
62294000,6,131013,Lordelo,10025,4993,5032,9740,4802,4938,3141,3,3014,3734,3731,3,3,2713
62447000,6,131014,Louredo,1514,747,767,1506,740,766,489,0,450,602,602,0,0,476
62494000,6,131015,Madalena,1843,897,946,1774,846,928,634,0,565,774,774,0,0,383
62519000,6,131016,Mouriz,3026,1452,1574,2943,1389,1554,1004,0,927,1320,1320,0,0,861
62577000,6,131017,Parada de Todeia,1848,909,939,1770,862,908,605,0,575,768,768,0,0,542
62622000,6,131018,Rebordosa,9106,4458,4648,8901,4310,4591,2891,3,2663,3479,3478,1,3,2406
62741000,6,131019,Recarei,4631,2309,2322,4474,2202,2272,1505,0,1397,1711,1711,0,0,1447
62825000,6,131020,Sobreira,4300,2106,2194,4220,2032,2188,1402,0,1316,1628,1624,4,0,1298
62927000,6,131021,Sobrosa,2641,1243,1398,2581,1202,1379,811,1,800,958,958,0,1,796
62997000,6,131022,Vandoma,2363,1185,1178,2252,1106,1146,753,0,712,892,892,0,1,706
63065000,6,131023,Vila Cova de Carros,666,334,332,651,323,328,205,0,190,247,247,0,0,222
63088000,6,131024,Vilela,5160,2524,2636,4909,2344,2565,1530,0,1501,1742,1741,1,0,1303
63157000,6,131101,Abragão,2341,1178,1163,2246,1099,1147,753,0,716,962,962,0,0,883
63191000,6,131102,Boelhe,1646,796,850,1609,760,849,538,0,498,668,668,0,1,551
63238000,6,131103,Bustelo,1579,734,845,1528,706,822,522,0,484,675,675,0,0,643
63295000,6,131104,Cabeça Santa,2528,1244,1284,2394,1134,1260,787,0,752,924,920,4,0,771
63350000,6,131105,Canelas,1649,825,824,1573,760,813,531,2,494,693,693,0,2,630
63399000,6,131106,Capela,1047,510,537,1032,498,534,363,0,310,449,449,0,0,415
63433000,6,131107,Castelões,1397,657,740,1350,620,730,485,0,443,634,634,0,0,560
63470000,6,131108,Croca,1767,887,880,1912,942,970,561,0,542,685,685,0,2,599
63509000,6,131109,Duas Igrejas,2426,1188,1238,2311,1084,1227,799,0,729,949,949,0,0,759
63573000,6,131110,Eja,1110,531,579,1045,477,568,394,0,342,538,538,0,1,451
63602000,6,131111,Figueira,406,190,216,390,184,206,128,1,114,169,169,0,1,156
63616000,6,131112,Fonte Arcada,1606,784,822,1551,745,806,511,0,457,633,633,0,1,544
63672000,6,131113,Galegos,2673,1334,1339,2606,1285,1321,868,0,798,1053,1053,0,0,846
63734000,6,131114,Guilhufe,2844,1407,1437,3178,1559,1619,875,0,864,1088,1088,0,1,894
63794000,6,131115,Irivo,2182,1077,1105,2130,1028,1102,724,1,665,837,835,2,1,673
63851000,6,131116,Lagares,2457,1214,1243,2382,1159,1223,774,0,724,885,884,1,0,817
63899000,6,131117,Luzim,817,394,423,757,350,407,259,0,230,419,419,0,0,387
63938000,6,131118,Marecos,1068,542,526,1046,523,523,355,0,323,436,436,0,0,355
63969000,6,131119,Milhundos,1793,854,939,1714,794,920,571,2,542,726,725,1,2,479
64013000,6,131120,Novelas,1794,857,937,1729,812,917,599,0,554,828,827,1,0,507
64053000,6,131121,Oldrões,2004,957,1047,1959,920,1039,633,0,600,748,748,0,0,599
64105000,6,131122,Paço de Sousa,3869,1906,1963,3725,1810,1915,1275,1,1164,1656,1656,0,1,1288
64178000,6,131123,Paredes,1258,597,661,1204,560,644,415,0,386,522,522,0,2,378
64213000,6,131124,Penafiel,8761,4064,4697,8292,3793,4499,3204,2,2666,4075,4072,3,6,1793
64331000,6,131125,Perozelo,1346,629,717,1291,580,711,430,0,398,530,530,0,0,450
64375000,6,131126,Pinheiro,2431,1193,1238,2388,1131,1257,797,1,755,998,998,0,5,770
64444000,6,131127,Portela,1266,623,643,1200,559,641,406,0,374,560,560,0,0,499
64492000,6,131128,Rans,1907,944,963,1816,867,949,597,0,572,724,724,0,0,552
64542000,6,131129,Rio de Moinhos,2886,1434,1452,2714,1311,1403,889,0,858,1152,1152,0,0,981
64591000,6,131130,Santa Marta,1289,652,637,1243,614,629,436,0,399,546,545,1,0,381
64611000,6,131131,Santiago de Subarrifana,1006,481,525,961,450,511,338,0,312,418,418,0,0,328
64626000,6,131132,Recezinhos (São Mamede),1439,718,721,1361,665,696,456,0,428,684,684,0,0,587
64672000,6,131133,Recezinhos (São Martinho),1791,880,911,1706,809,897,599,0,534,747,747,0,3,674
64725000,6,131134,Sebolido,912,458,454,881,429,452,291,0,292,375,375,0,0,342
64748000,6,131135,Urrô,1161,566,595,1130,545,585,382,0,360,450,450,0,0,404
64776000,6,131136,Valpedre,1576,790,786,1553,769,784,480,0,456,562,559,3,1,475
64818000,6,131137,Vila Cova,819,397,422,780,371,409,283,0,264,389,389,0,0,341
64850000,6,131138,Rio Mau,1414,699,715,1372,669,703,486,0,450,661,661,0,0,584
64867000,6,170501,Atei,1352,672,680,1308,652,656,454,0,382,708,708,0,1,705
64938000,6,170502,Bilhó,546,253,293,518,242,276,210,0,165,374,374,0,0,374
64983000,6,170503,Campanhó,268,126,142,247,111,136,109,0,86,227,227,0,0,225
64999000,6,170504,Ermelo,483,232,251,480,234,246,207,0,143,496,495,1,0,492
65034000,6,170505,Mondim de Basto,3273,1552,1721,3104,1454,1650,1094,2,939,1725,1725,0,8,1289
65148000,6,170506,Paradança,358,163,195,345,159,186,121,0,104,231,231,0,0,231
65175000,6,170507,Pardelhas,77,36,41,76,35,41,31,0,21,67,67,0,0,67
65183000,6,170508,Vilar de Ferreiros,1136,564,572,1035,489,546,366,0,339,683,683,0,0,683
65242000,6,170901,Alvadia,196,97,99,190,96,94,75,0,62,153,153,0,0,153
65270000,6,170902,Canedo,390,194,196,348,167,181,164,0,114,394,394,0,0,394
65318000,6,170903,Cerva,2280,1116,1164,2247,1095,1152,819,1,639,1478,1478,0,5,1427
65434000,6,170904,Limões,335,164,171,343,171,172,125,0,97,251,251,0,0,251
65465000,6,170905,Ribeira de Pena (Salvador),2417,1181,1236,2343,1123,1220,897,2,732,1747,1747,0,5,1507
65602000,6,170906,Santa Marinha,558,269,289,543,263,280,223,0,194,477,477,0,0,472
65658000,6,170907,Santo Aleixo de Além-Tâmega,368,175,193,356,169,187,162,0,118,410,410,0,2,407
65697000,6,180401,Alhões,196,104,92,210,110,100,81,0,61,277,277,0,0,277
65721000,6,180402,Bustelo,115,56,59,110,54,56,53,0,35,108,108,0,0,108
65734000,6,180403,Cinfães,3395,1578,1817,3160,1415,1745,1244,1,1042,1951,1950,1,4,1579
65845000,6,180404,Espadanedo,1318,642,676,1235,578,657,445,0,411,536,536,0,0,507
65879000,6,180405,Ferreiros de Tendais,695,343,352,646,317,329,266,0,206,682,682,0,4,674
65929000,6,180406,Fornelos,703,328,375,662,300,362,266,0,227,469,469,0,0,465
65971000,6,180407,Gralheira,165,82,83,157,79,78,71,0,52,218,218,0,0,217
65985000,6,180408,Moimenta,408,196,212,372,171,201,153,0,130,227,227,0,0,227
66015000,6,180409,Nespereira,1977,959,1018,1846,867,979,731,0,623,1302,1302,0,1,1254
66121000,6,180410,Oliveira do Douro,1529,753,776,1452,685,767,532,0,468,852,852,0,1,838
66191000,6,180411,Ramires,119,56,63,113,53,60,49,0,36,93,93,0,0,93
66210000,6,180412,Santiago de Piães,1797,877,920,1651,766,885,616,0,561,847,847,0,0,818
66279000,6,180413,São Cristóvão de Nogueira,1930,936,994,1776,814,962,650,1,579,910,909,1,1,853
66369000,6,180414,Souselo,3202,1577,1625,2913,1353,1560,1099,0,1005,1471,1471,0,0,1323
66460000,6,180415,Tarouquela,1242,634,608,1099,519,580,413,0,391,514,514,0,0,489
66501000,6,180416,Tendais,807,398,409,779,382,397,302,1,242,758,758,0,1,747
66568000,6,180417,Travanca,829,413,416,781,367,414,283,0,263,389,389,0,0,385
66600000,6,181301,Anreade,1114,529,585,1073,507,566,384,0,327,709,709,0,3,647
66637000,6,181302,Barrô,744,365,379,741,361,380,290,0,229,562,562,0,0,560
66685000,6,181303,Cárquere,854,418,436,819,394,425,292,0,260,483,483,0,0,462
66717000,6,181304,Feirão,117,54,63,108,51,57,37,0,31,127,127,0,0,124
66732000,6,181305,Felgueiras,319,152,167,304,145,159,107,1,86,217,217,0,1,216
66751000,6,181306,Freigil,431,218,213,422,212,210,159,0,139,296,296,0,0,289
66770000,6,181307,Miomães,359,174,185,341,153,188,133,0,111,266,266,0,2,255
66785000,6,181308,Ovadas,277,129,148,263,122,141,117,0,82,265,265,0,0,264
66812000,6,181309,Panchorra,132,65,67,131,66,65,56,0,45,185,185,0,0,184
66833000,6,181310,Paus,528,257,271,499,244,255,209,0,157,475,474,1,0,468
66865000,6,181311,Resende,3166,1539,1627,3126,1479,1647,1049,6,918,1686,1685,1,13,1311
66946000,6,181312,São Cipriano,771,381,390,766,376,390,281,0,227,418,418,0,0,418
66979000,6,181313,São João de Fontoura,700,337,363,685,327,358,254,0,213,430,430,0,0,429
67016000,6,181314,São Martinho de Mouros,1495,725,770,1477,715,762,571,0,468,1023,1023,0,0,988
67085000,6,181315,São Romão de Aregos,357,180,177,367,182,185,131,1,103,272,272,0,1,271
67110000,6,10401,Albergaria da Serra,105,49,56,101,47,54,42,0,28,68,68,0,0,68
67122000,6,10402,Alvarenga,1223,621,602,1180,587,593,455,0,374,844,840,4,4,837
67192000,6,10403,Arouca,3185,1445,1740,3050,1383,1667,1049,6,930,1458,1455,3,8,1058
67265000,6,10404,Burgo,1993,981,1012,1889,905,984,638,0,626,918,918,0,1,857
67318000,6,10405,Cabreiros,126,57,69,119,52,67,54,0,40,105,105,0,0,105
67327000,6,10406,Canelas,801,407,394,746,367,379,251,0,238,332,332,0,1,328
67341000,6,10407,Chave,1253,604,649,1192,573,619,435,0,382,639,639,0,0,628
67387000,6,10408,Covelo de Paivó,103,45,58,104,46,58,42,0,30,65,65,0,0,59
67396000,6,10409,Escariz,2222,1082,1140,2103,1008,1095,715,0,680,954,952,2,0,879
67459000,6,10410,Espiunca,382,194,188,345,174,171,130,0,115,223,222,1,0,222
67481000,6,10411,Fermedo,1340,640,700,1289,614,675,456,0,410,667,666,1,0,633
67534000,6,10412,Janarde,119,59,60,119,60,59,40,0,38,99,99,0,0,99
67542000,6,10413,Mansores,1081,529,552,1058,516,542,350,0,322,446,446,0,1,415
67586000,6,10414,Moldes,1257,602,655,1199,567,632,389,0,377,600,599,1,0,589
67625000,6,10415,Rossas,1599,788,811,1532,749,783,525,0,485,751,751,0,0,743
67675000,6,10416,Santa Eulália,2253,1088,1165,2176,1040,1136,747,0,691,969,962,7,1,911
67737000,6,10417,São Miguel do Mato,598,281,317,593,279,314,204,0,169,303,303,0,2,295
67762000,6,10418,Tropeço,1150,554,596,1076,517,559,405,0,348,537,537,0,0,523
67809000,6,10419,Urrô,1029,512,517,969,475,494,354,0,318,506,506,0,3,498
67848000,6,10420,Várzea,540,261,279,535,245,290,183,0,165,231,230,1,0,220
67877000,6,10901,Argoncilhe,8420,4093,4327,8213,3950,4263,2972,0,2635,3465,3463,2,0,2743
68001000,6,10902,Arrifana,6551,3184,3367,6324,3065,3259,2369,0,2140,2861,2861,0,0,1773
68075000,6,10903,Canedo,6044,2921,3123,5865,2806,3059,2037,0,1871,2919,2917,2,0,2365
68169000,6,10904,Escapães,3309,1571,1738,3205,1509,1696,1152,1,1048,1406,1405,1,1,1026
68258000,6,10905,Espargo,1559,752,807,1521,729,792,516,0,497,660,660,0,1,592
68304000,6,10906,Feira,12511,5947,6564,12032,5680,6352,4622,4,3919,5789,5789,0,9,2615
68451000,6,10907,Fiães,7991,3860,4131,7649,3670,3979,2821,3,2514,3266,3264,2,4,2415
68555000,6,10908,Fornos,3397,1656,1741,3291,1601,1690,1206,0,1106,1461,1461,0,0,1112
68616000,6,10909,Gião,1815,861,954,1745,823,922,606,0,565,849,849,0,0,685
68676000,6,10910,Guisande,1237,615,622,1218,607,611,434,0,379,579,578,1,1,535
68727000,6,10911,Lobão,5483,2689,2794,5336,2602,2734,1947,2,1705,2653,2652,1,3,2143
68793000,6,10912,Louredo,1325,626,699,1274,591,683,452,0,393,723,723,0,0,634
68845000,6,10913,Lourosa,8636,4167,4469,8358,3986,4372,3101,0,2756,3752,3752,0,2,2495
68969000,6,10914,Milheirós de Poiares,3791,1870,1921,3670,1800,1870,1276,1,1165,1536,1532,4,1,1084
69051000,6,10915,Mosteiró,2038,987,1051,1983,955,1028,711,1,644,854,854,0,1,744
69100000,6,10916,Mozelos,7142,3476,3666,6980,3376,3604,2523,1,2272,2981,2981,0,1,1746
69185000,6,10917,Nogueira da Regedoura,5790,2798,2992,5623,2702,2921,2029,0,1854,2339,2338,1,0,1817
69263000,6,10918,São Paio de Oleiros,4069,1940,2129,3966,1872,2094,1453,2,1283,1643,1643,0,2,1125
69324000,6,10919,Paços de Brandão,4867,2365,2502,4729,2286,2443,1802,0,1536,2068,2068,0,0,1269
69390000,6,10920,Pigeiros,1181,560,621,1130,533,597,406,0,362,504,504,0,0,441
69435000,6,10921,Rio Meão,4931,2378,2553,4801,2309,2492,1725,0,1535,2082,2080,2,2,1523
69496000,6,10922,Romariz,3023,1484,1539,2939,1436,1503,1035,0,931,1409,1409,0,0,1271
69579000,6,10923,Sanfins,1882,926,956,1814,892,922,657,0,599,825,825,0,0,656
69618000,6,10924,Sanguedo,3600,1735,1865,3437,1636,1801,1144,2,1088,1436,1436,0,2,1277
69706000,6,10925,Santa Maria de Lamas,5073,2440,2633,4944,2358,2586,1795,1,1591,2061,2059,2,1,1168
69772000,6,10926,São João de Ver,10579,5190,5389,10167,4947,5220,3687,1,3397,4609,4608,1,2,3145
69903000,6,10927,Caldas de São Jorge,2716,1330,1386,2607,1260,1347,937,0,867,1192,1192,0,0,994
69941000,6,10928,Souto,4696,2282,2414,4519,2182,2337,1581,1,1498,1955,1953,2,1,1802
70018000,6,10929,Travanca,2242,1083,1159,2161,1037,1124,761,0,687,932,932,0,0,824
70075000,6,10930,Vale,1903,879,1024,1865,862,1003,687,0,576,1029,1029,0,0,966
70146000,6,10931,Vila Maior,1511,737,774,1456,707,749,519,0,466,682,682,0,0,626
70215000,6,11301,Carregosa,3419,1664,1755,3339,1608,1731,1267,0,1108,1639,1638,1,1,1367
70295000,6,11302,Cesar,3166,1565,1601,3073,1499,1574,1138,1,984,1419,1419,0,1,1003
70356000,6,11303,Fajões,3087,1493,1594,3014,1447,1567,1069,1,958,1306,1304,2,1,1130
70427000,6,11304,Loureiro,3531,1716,1815,3423,1654,1769,1183,0,1104,1444,1444,0,0,1283
70520000,6,11305,Macieira de Sarnes,1925,924,1001,1817,869,948,691,0,625,863,862,1,0,660
70567000,6,11306,Macinhata da Seixa,1390,697,693,1324,660,664,462,0,440,606,606,0,0,502
70607000,6,11307,Madail,809,406,403,785,394,391,273,0,253,336,336,0,0,249
70636000,6,11308,Nogueira do Cravo,2795,1357,1438,2720,1314,1406,990,0,901,1174,1174,0,0,987
70700000,6,11309,Oliveira de Azeméis,12204,5778,6426,11653,5447,6206,4466,4,3834,5655,5653,2,7,2469
70872000,6,11310,Ossela,2208,1088,1120,2114,1035,1079,789,0,695,983,983,0,0,905
70936000,6,11311,Palmaz,2079,1016,1063,2005,979,1026,740,0,671,964,964,0,0,920
70997000,6,11312,Pindelo,2595,1264,1331,2506,1217,1289,918,0,825,1133,1133,0,0,912
71052000,6,11313,Pinheiro da Bemposta,3324,1616,1708,3217,1557,1660,1153,1,1053,1480,1479,1,1,1344
71118000,6,11314,Santiago de Riba-Ul,3944,1897,2047,3806,1811,1995,1389,0,1282,1672,1670,2,0,1243
71206000,6,11315,São Martinho da Gândara,1985,966,1019,1957,939,1018,649,0,633,810,810,0,0,745
71267000,6,11316,Travanca,1804,878,926,1751,849,902,613,0,578,672,671,1,0,620
71308000,6,11317,Ul,2413,1175,1238,2305,1111,1194,846,0,778,1066,1066,0,0,985
71376000,6,11318,São Roque,5228,2566,2662,5069,2485,2584,1838,1,1701,2192,2192,0,1,1586
71476000,6,11319,Vila de Cucujães,10705,5216,5489,10249,4955,5294,3748,5,3468,4602,4597,5,5,3592
71702000,6,11601,São João da Madeira,21713,10222,11491,20834,9743,11091,8292,4,6875,10465,10462,3,16,3371
71997000,6,11901,Arões,1459,680,779,1380,632,748,571,0,452,756,756,0,0,751
72099000,6,11902,São Pedro de Castelões,7254,3523,3731,7084,3406,3678,2656,3,2339,3574,3574,0,4,2712
72324000,6,11903,Cepelos,1313,633,680,1231,589,642,480,1,404,797,797,0,1,783
72400000,6,11904,Codal,946,471,475,927,460,467,341,0,314,424,424,0,0,370
72450000,6,11905,Junqueira,1067,510,557,1005,472,533,368,0,315,563,563,0,0,552
72535000,6,11906,Macieira de Cambra,4752,2291,2461,4630,2202,2428,1759,1,1495,2505,2505,0,6,2110
72726000,6,11907,Roge,1752,850,902,1698,811,887,636,0,577,881,881,0,0,864
72816000,6,11908,Vila Chã,3912,1939,1973,3796,1849,1947,1521,0,1267,2113,2113,0,1,1227
72924000,6,11909,Vila Cova de Perrinho,409,182,227,407,184,223,157,0,130,225,225,0,0,210
72953000,6,40301,Amedo,302,145,157,297,143,154,122,0,94,244,224,20,0,224
72982000,6,40302,Beira Grande,144,72,72,143,71,72,73,0,48,139,139,0,0,139
72997000,6,40303,Belver,322,160,162,303,151,152,125,0,102,217,217,0,0,215
73026000,6,40304,Carrazeda de Ansiães,1701,820,881,1626,776,850,619,1,518,993,991,2,2,826
73111000,6,40305,Castanheiro,427,189,238,401,174,227,191,0,133,383,383,0,0,379
73137000,6,40306,Fonte Longa,301,152,149,294,147,147,124,1,87,236,236,0,1,236
73174000,6,40307,Lavandeira,162,80,82,159,78,81,77,0,51,185,184,1,0,185
73191000,6,40308,Linhares,421,208,213,411,202,209,214,0,138,388,387,1,0,387
73234000,6,40309,Marzagão,315,146,169,228,105,123,137,0,95,248,248,0,0,248
73269000,6,40310,Mogo de Malta,111,49,62,112,49,63,35,1,28,81,81,0,1,82
73282000,6,40311,Parambos,247,125,122,227,115,112,107,0,76,222,222,0,0,210
73308000,6,40312,Pereiros,235,118,117,236,121,115,104,0,73,232,232,0,0,232
73323000,6,40313,Pinhal do Norte,263,125,138,251,118,133,118,0,84,290,290,0,0,289
73347000,6,40314,Pombal,324,148,176,308,146,162,139,1,89,263,263,0,1,258
73371000,6,40315,Ribalonga,92,46,46,92,46,46,44,0,32,116,116,0,0,116
73380000,6,40316,Seixo de Ansiães,290,149,141,284,145,139,138,0,94,325,325,0,1,320
73412000,6,40317,Selores,141,68,73,129,60,69,60,0,42,111,111,0,0,108
73430000,6,40318,Vilarinho da Castanheira,415,188,227,397,177,220,185,1,126,514,514,0,1,515
73477000,6,40319,Zedes,160,78,82,157,76,81,74,0,54,146,146,0,0,146
73492000,6,40401,Fornos,206,104,102,206,104,102,103,0,76,361,361,0,0,354
73547000,6,40402,Freixo de Espada à Cinta,2188,1057,1131,2178,1056,1122,801,4,644,1329,1329,0,18,1267
73630000,6,40403,Lagoaça,411,193,218,402,186,216,188,1,128,543,543,0,3,534
73681000,6,40404,Ligares,397,183,214,387,178,209,174,1,114,355,355,0,1,351
73707000,6,40405,Mazouco,167,77,90,165,77,88,93,0,59,244,244,0,0,244
73733000,6,40406,Poiares,411,206,205,397,198,199,176,1,125,310,310,0,1,310
73777000,6,40901,Açoreira,524,285,239,522,284,238,202,0,174,310,310,0,1,306
73805000,6,40902,Adeganha,343,169,174,334,161,173,160,0,112,347,347,0,0,315
73867000,6,40903,Cabeça Boa,428,216,212,437,220,217,191,0,137,355,354,1,0,348
73908000,6,40904,Cardanha,231,104,127,228,102,126,103,0,83,254,254,0,0,252
73934000,6,40905,Carviçais,757,372,385,733,362,371,345,1,239,592,592,0,3,583
74005000,6,40906,Castedo,236,114,122,236,114,122,113,0,70,205,205,0,0,202
74029000,6,40907,Felgar,954,455,499,935,450,485,412,0,301,750,750,0,1,732
74117000,6,40908,Felgueiras,291,127,164,279,120,159,124,1,83,318,318,0,1,317
74150000,6,40909,Horta da Vilariça,310,154,156,311,155,156,170,0,97,315,315,0,0,313
74183000,6,40910,Larinho,365,184,181,371,187,184,156,1,117,326,326,0,2,325
74212000,6,40911,Lousa,358,161,197,341,153,188,192,0,119,596,596,0,0,596
74255000,6,40912,Maçores,169,76,93,155,70,85,78,0,57,173,173,0,0,172
74274000,6,40913,Mós,246,118,128,245,118,127,115,1,80,249,249,0,1,250
74294000,6,40914,Peredo dos Castelhanos,111,49,62,111,49,62,49,1,32,151,151,0,1,150
74311000,6,40915,Souto da Velha,93,44,49,92,44,48,50,0,30,143,143,0,0,143
74329000,6,40916,Torre de Moncorvo,2891,1354,1537,2829,1316,1513,1157,4,878,1870,1870,0,9,1356
74443000,6,40917,Urros,265,124,141,245,116,129,121,0,85,355,355,0,0,355
74482000,6,41001,Assares,141,69,72,128,58,70,55,0,47,98,98,0,0,97
74502000,6,41002,Benlhevai,234,120,114,214,108,106,95,0,66,180,180,0,0,172
74521000,6,41003,Candoso,158,72,86,146,65,81,73,0,49,158,158,0,0,158
74532000,6,41004,Carvalho de Egas,114,50,64,109,49,60,49,0,40,125,125,0,0,125
74543000,6,41005,Freixiel,640,303,337,617,294,323,270,1,192,547,546,1,1,542
74581000,6,41006,Lodões,100,57,43,96,54,42,50,0,29,113,113,0,0,113
74595000,6,41007,Mourão,104,53,51,101,51,50,55,0,35,151,151,0,0,151
74605000,6,41008,Nabo,144,75,69,140,72,68,74,0,49,206,206,0,0,206
74616000,6,41009,Roios,150,73,77,141,66,75,66,0,50,130,130,0,1,129
74630000,6,41010,Samões,338,167,171,330,166,164,139,0,102,262,262,0,2,262
74650000,6,41011,Sampaio,159,76,83,152,71,81,66,0,57,133,133,0,0,133
74668000,6,41012,Santa Comba de Vilariça,407,195,212,384,183,201,145,1,122,274,274,0,1,269
74703000,6,41013,Seixo de Manhoses,469,220,249,467,217,250,188,1,144,334,333,1,1,325
74721000,6,41014,Trindade,162,75,87,116,51,65,71,0,50,159,159,0,0,158
74744000,6,41015,Vale Frechoso,189,91,98,181,86,95,83,0,61,130,130,0,0,128
74768000,6,41016,Valtorno,260,114,146,272,121,151,123,0,76,302,302,0,1,293
74802000,6,41017,Vila Flor,2269,1086,1183,2252,1095,1157,839,4,686,1328,1328,0,11,989
74910000,6,41018,Vilarinho das Azenhas,109,51,58,104,49,55,49,0,37,79,79,0,1,79
74924000,6,41019,Vilas Boas,550,265,285,535,259,276,232,0,182,503,503,0,1,482
74953000,6,91401,Almendra,386,194,192,380,191,189,163,2,118,432,432,0,2,434
75008000,6,91402,Castelo Melhor,228,106,122,226,103,123,111,0,75,298,298,0,0,296
75043000,6,91403,Cedovim,338,162,176,322,155,167,138,1,100,350,350,0,1,350
75098000,6,91404,Chãs,278,130,148,279,132,147,110,1,78,217,217,0,1,218
75125000,6,91405,Custóias,202,93,109,191,88,103,104,0,67,225,225,0,0,225
75144000,6,91406,Freixo de Numão,502,233,269,475,224,251,202,0,161,546,546,0,1,543
75191000,6,91407,Horta,242,118,124,232,111,121,93,0,81,223,223,0,2,225
75226000,6,91408,Mós,190,94,96,180,90,90,85,0,65,221,221,0,0,221
75251000,6,91409,Murça,107,46,61,98,42,56,55,0,39,116,116,0,0,116
75270000,6,91410,Muxagata,309,143,166,306,140,166,135,0,104,242,242,0,0,242
75308000,6,91411,Numão,240,106,134,238,102,136,105,0,72,236,236,0,0,236
75331000,6,91412,Santa Comba,208,101,107,195,95,100,97,1,64,314,313,1,1,313
75375000,6,91413,Santo Amaro,50,22,28,49,22,27,29,0,18,127,127,0,0,127
75389000,6,91414,Sebadelhe,265,125,140,249,114,135,116,1,80,253,253,0,1,254
75416000,6,91415,Seixas,335,167,168,312,157,155,136,0,106,305,305,0,0,305
75435000,6,91416,Touça,235,113,122,179,71,108,95,0,76,174,174,0,0,170
75463000,6,91417,Vila Nova de Foz Côa,3197,1505,1692,3060,1443,1617,1251,1,969,2210,2209,1,5,1776
75594000,6,170101,Alijó,2635,1273,1362,2572,1212,1360,937,3,797,1477,1477,0,8,1215
75704000,6,170102,Amieiro,81,38,43,71,35,36,42,0,29,74,74,0,0,74
75712000,6,170103,Carlão,719,347,372,691,335,356,326,1,233,626,626,0,1,623
75766000,6,170104,Casal de Loivos,183,86,97,171,78,93,66,0,53,118,118,0,3,118
75777000,6,170105,Castedo,373,178,195,343,157,186,150,0,110,283,282,1,0,268
75799000,6,170106,Cotas,245,119,126,233,111,122,102,0,76,160,159,1,0,155
75816000,6,170107,Favaios,1064,508,556,1053,499,554,429,0,329,751,751,0,1,731
75886000,6,170108,Pegarinhos,465,230,235,871,638,233,187,0,142,404,404,0,1,395
75927000,6,170109,Pinhão,648,313,335,599,290,309,264,0,205,384,384,0,3,229
75948000,6,170110,Pópulo,277,129,148,264,123,141,115,0,86,242,242,0,0,241
75998000,6,170111,Ribalonga,231,105,126,219,100,119,103,0,74,220,219,1,0,219
76021000,6,170112,Sanfins do Douro,1495,730,765,1411,683,728,602,1,469,1086,1085,1,1,1054
76127000,6,170113,Santa Eugénia,333,165,168,327,158,169,148,0,112,232,232,0,1,227
76150000,6,170114,São Mamede de Ribatua,728,353,375,726,351,375,309,0,236,595,595,0,0,580
76183000,6,170115,Vale de Mendiz,249,119,130,237,115,122,97,0,79,149,149,0,2,146
76203000,6,170116,Vila Chã,533,267,266,531,266,265,224,0,166,403,403,0,0,397
76268000,6,170117,Vila Verde,622,306,316,606,303,303,268,0,185,566,566,0,1,563
76321000,6,170118,Vilar de Maçada,915,431,484,864,405,459,351,1,279,724,724,0,1,716
76369000,6,170119,Vilarinho de Cotas,146,75,71,131,63,68,50,0,48,77,77,0,0,76
76387000,6,170401,Barqueiros,701,330,371,667,308,359,241,0,217,430,430,0,1,408
76412000,6,170402,Cidadelhe,171,85,86,164,81,83,67,0,54,106,106,0,0,100
76424000,6,170403,Oliveira,391,196,195,367,182,185,136,0,119,214,214,0,4,210
76443000,6,170404,Mesão Frio (Santa Cristina),808,384,424,773,358,415,279,0,251,463,463,0,1,445
76474000,6,170405,Mesão Frio (São Nicolau),484,216,268,458,202,256,145,3,120,195,195,0,3,153
76493000,6,170406,Vila Jusã,635,319,316,610,303,307,213,0,197,288,288,0,0,219
76508000,6,170407,Vila Marim,1243,591,652,1182,552,630,455,0,380,687,687,0,0,680
76573000,6,170801,Covelinhas,222,111,111,226,112,114,94,0,69,179,179,0,0,178
76591000,6,170802,Fontelas,781,397,384,720,357,363,274,0,233,385,385,0,0,349
76622000,6,170803,Galafura,664,308,356,620,285,335,238,0,204,441,441,0,0,438
76653000,6,170804,Godim,4667,2190,2477,4525,2095,2430,1723,2,1439,2161,2158,3,9,1176
76718000,6,170805,Loureiro,1154,555,599,1067,506,561,417,0,366,658,658,0,0,650
76763000,6,170806,Moura Morta,525,267,258,494,241,253,180,0,167,288,288,0,0,286
76793000,6,170807,Peso da Régua,5292,2469,2823,5026,2268,2758,1928,3,1589,2609,2609,0,8,1204
76851000,6,170808,Poiares,802,373,429,837,414,423,309,1,243,513,513,0,1,506
76889000,6,170809,Sedielos,911,413,498,852,377,475,360,0,271,732,731,1,0,726
76936000,6,170810,Vilarinho dos Freires,950,458,492,937,447,490,343,0,287,541,541,0,0,508
76962000,6,170811,Vinhós,499,240,259,468,223,245,204,0,149,352,352,0,0,350
76977000,6,170812,Canelas,664,330,334,652,324,328,241,1,187,373,364,9,1,365
76997000,6,171001,Celeirós,222,116,106,223,114,109,85,0,66,134,134,0,1,133
77005000,6,171002,Covas do Douro,444,229,215,421,219,202,168,0,138,377,377,0,3,378
77032000,6,171003,Gouvães do Douro,142,66,76,133,61,72,56,0,48,145,145,0,2,141
77044000,6,171004,Gouvinhas,267,130,137,261,127,134,108,0,90,212,212,0,0,208
77054000,6,171005,Parada de Pinhão,309,151,158,301,146,155,123,0,100,252,252,0,1,248
77072000,6,171006,Paradela de Guiães,103,47,56,100,46,54,53,0,33,134,134,0,0,134
77084000,6,171007,Paços,762,363,399,711,334,377,291,0,248,529,529,0,0,526
77121000,6,171008,Provesende,310,132,178,296,126,170,132,0,93,255,255,0,1,256
77134000,6,171009,Sabrosa,1202,609,593,1177,588,589,427,3,353,634,633,1,5,557
77178000,6,171010,São Cristovão do Douro,160,77,83,157,73,84,59,0,55,97,97,0,0,95
77191000,6,171011,São Lourenço de Ribapinhão,407,184,223,394,177,217,172,0,124,328,328,0,0,328
77233000,6,171012,São Martinho de Antas,910,427,483,879,412,467,343,1,280,760,760,0,3,725
77281000,6,171013,Souto Maior,487,237,250,472,227,245,191,0,149,312,312,0,0,309
77313000,6,171014,Torre do Pinhão,342,167,175,338,165,173,133,0,106,269,269,0,0,269
77339000,6,171015,Vilarinho de São Romão,294,134,160,299,138,161,111,0,93,204,204,0,1,205
77358000,6,171101,Alvações do Corgo,477,220,257,455,210,245,192,0,154,320,320,0,0,319
77383000,6,171102,Cumieira,1146,536,610,1094,504,590,420,1,359,687,687,0,3,679
77458000,6,171103,Fontes,835,388,447,816,381,435,345,0,259,702,702,0,0,687
77530000,6,171104,Fornelos,241,120,121,233,116,117,99,0,75,200,200,0,0,198
77550000,6,171105,Louredo,428,205,223,399,186,213,167,0,129,305,305,0,0,304
77588000,6,171106,Medrões,505,243,262,499,241,258,202,0,150,349,349,0,0,349
77641000,6,171107,Sanhoane,375,180,195,360,169,191,145,0,113,244,244,0,0,240
77661000,6,171108,Lobrigos (São João Baptista),1270,582,688,1190,537,653,440,1,369,618,617,1,3,590
77719000,6,171109,Lobrigos (São Miguel),1365,647,718,1312,615,697,485,1,412,690,689,1,3,475
77754000,6,171110,Sever,714,342,372,679,319,360,282,0,213,507,507,0,0,505
77814000,6,171401,Abaças,965,465,500,898,433,465,364,0,294,759,759,0,0,759
77855000,6,171402,Adoufe,2155,1044,1111,2080,1012,1068,753,0,655,1139,1139,0,1,1089
77939000,6,171403,Andrães,1389,656,733,1351,635,716,525,0,443,1064,1064,0,0,1054
78016000,6,171404,Arroios,1117,540,577,1092,530,562,396,0,336,554,553,1,1,478
78043000,6,171405,Borbela,2652,1257,1395,2578,1204,1374,939,0,837,1286,1280,6,0,1107
78112000,6,171406,Campeã,1375,641,734,1347,630,717,541,0,440,1088,1088,0,4,1082
78204000,6,171407,Constantim,1020,470,550,973,448,525,348,0,311,536,536,0,1,509
78239000,6,171408,Ermida,419,197,222,397,183,214,166,0,143,299,299,0,0,298
78263000,6,171409,Folhadela,2261,1037,1224,2184,998,1186,814,1,692,1272,1272,0,2,1066
78318000,6,171410,Guiães,478,234,244,448,214,234,184,0,153,376,376,0,0,376
78333000,6,171411,Justes,333,167,166,318,157,161,139,0,114,256,256,0,0,256
78353000,6,171412,Lamares,351,172,179,345,169,176,131,0,114,251,250,1,0,247
78381000,6,171413,Lamas de Olo,109,43,66,111,45,66,47,0,37,114,114,0,0,111
78399000,6,171414,Lordelo,3169,1562,1607,3366,1669,1697,1059,2,943,1430,1429,1,3,996
78457000,6,171415,Mateus,3400,1624,1776,3285,1553,1732,1220,3,1002,1646,1636,10,5,871
78515000,6,171416,Mondrões,1065,524,541,1041,510,531,368,1,323,598,598,0,1,589
78568000,6,171417,Mouçós,3051,1494,1557,2989,1449,1540,1122,0,924,1720,1719,1,1,1679
78708000,6,171418,Nogueira,545,258,287,538,254,284,227,0,182,437,437,0,0,434
78733000,6,171419,Vila Real (Nossa Senhora da Conceição),8885,4221,4664,9076,4219,4857,3357,1,2757,4725,4723,2,7,1637
78865000,6,171420,Parada de Cunhos,1939,943,996,1873,911,962,694,0,598,991,990,1,0,655
78910000,6,171421,Pena,483,226,257,462,216,246,182,0,155,334,334,0,0,332
78950000,6,171422,Quinta,174,80,94,169,75,94,63,0,50,175,175,0,0,175
78958000,6,171423,Vila Real (São Dinis),3937,1855,2082,4050,1848,2202,1559,4,1170,2244,2241,3,12,789
79030000,6,171424,Vila Real (São Pedro),4766,2188,2578,6162,2774,3388,1960,5,1433,3027,3027,0,15,985
79103000,6,171425,São Tomé do Castelo,950,442,508,946,430,516,345,1,282,788,787,1,1,784
79184000,6,171426,Torgueda,1382,660,722,1311,615,696,498,0,433,839,835,4,0,830
79251000,6,171427,Vale de Nogueiras,836,395,441,819,385,434,310,0,248,620,620,0,0,616
79323000,6,171428,Vila Cova,162,75,87,159,73,86,74,0,50,151,151,0,0,151
79354000,6,171429,Vila Marim,1742,843,899,1689,809,880,573,0,524,791,791,0,0,780
79418000,6,171430,Vilarinho de Samardã,740,357,383,724,346,378,238,0,217,433,433,0,0,432
79469000,6,180101,Aldeias,337,165,172,331,162,169,136,0,98,249,249,0,0,249
79493000,6,180102,Aricera,157,79,78,138,64,74,66,0,49,146,146,0,0,146
79517000,6,180103,Armamar,1268,609,659,1242,599,643,421,1,364,707,705,2,11,582
79562000,6,180104,Cimbres,308,148,160,292,141,151,116,0,92,284,284,0,0,283
79588000,6,180105,Coura,49,25,24,48,24,24,21,0,15,56,56,0,0,56
79596000,6,180106,Folgosa,428,212,216,397,199,198,156,0,141,267,266,1,1,267
79612000,6,180107,Fontelo,641,288,353,608,273,335,235,1,196,504,504,0,1,504
79648000,6,180108,Goujoim,58,29,29,58,29,29,30,0,18,116,116,0,0,114
79658000,6,180109,Queimada,285,142,143,281,139,142,98,1,77,261,261,0,2,260
79680000,6,180110,Queimadela,248,125,123,226,111,115,83,0,72,169,169,0,0,169
79697000,6,180111,Santa Cruz,206,103,103,197,99,98,77,0,63,187,187,0,0,187
79715000,6,180112,Santiago,139,68,71,132,62,70,57,0,41,188,188,0,0,188
79732000,6,180113,Santo Adrião,81,35,46,79,34,45,34,0,23,96,96,0,0,96
79741000,6,180114,São Cosmado,598,272,326,592,269,323,227,2,175,493,493,0,2,494
79771000,6,180115,São Martinho das Chãs,549,246,303,501,217,284,199,0,165,403,403,0,0,400
79812000,6,180116,São Romão,167,79,88,125,58,67,68,0,55,143,143,0,0,143
79829000,6,180117,Tões,147,64,83,133,60,73,55,0,50,97,97,0,0,95
79840000,6,180118,Vacalar,205,92,113,198,85,113,85,0,60,184,184,0,0,184
79855000,6,180119,Vila Seca,426,200,226,374,174,200,159,1,114,375,375,0,1,363
79880000,6,180501,Lamego (Almacave),8750,4133,4617,8292,3853,4439,3279,10,2678,4596,4595,1,18,1914
80026000,6,180502,Avões,619,309,310,586,285,301,201,0,189,334,334,0,0,329
80040000,6,180503,Bigorne,46,27,19,44,24,20,18,0,15,66,66,0,0,66
80052000,6,180504,Britiande,934,433,501,877,408,469,342,0,296,586,586,0,4,533
80089000,6,180505,Cambres,2066,975,1091,1919,878,1041,761,0,628,1208,1207,1,6,1164
80156000,6,180506,Cepões,860,443,417,788,390,398,305,0,261,535,534,1,0,527
80195000,6,180507,Ferreirim,904,409,495,873,388,485,318,1,269,578,578,0,1,566
80231000,6,180508,Ferreiros de Avões,509,254,255,490,249,241,193,0,159,248,248,0,0,242
80254000,6,180509,Figueira,342,167,175,324,159,165,135,0,110,244,243,1,0,238
80272000,6,180510,Lalim,729,364,365,698,345,353,281,0,220,518,518,0,1,516
80299000,6,180511,Lazarim,521,255,266,489,235,254,207,0,165,539,539,0,0,538
80321000,6,180512,Magueija,591,283,308,546,253,293,228,0,174,550,550,0,0,549
80353000,6,180513,Meijinhos,86,42,44,80,39,41,34,0,25,116,116,0,0,114
80363000,6,180514,Melcões,125,59,66,125,59,66,52,0,40,149,148,1,0,149
80371000,6,180515,Parada do Bispo,149,73,76,149,73,76,55,0,44,80,80,0,0,80
80385000,6,180516,Penajóia,1023,477,546,997,458,539,388,0,325,764,763,1,1,751
80439000,6,180517,Penude,1666,801,865,1600,767,833,576,0,494,1072,1072,0,0,1031
80486000,6,180518,Pretarouca,69,32,37,71,33,38,34,0,17,101,101,0,0,101
80498000,6,180519,Samodães,203,105,98,207,108,99,77,0,61,168,168,0,2,166
80512000,6,180520,Sande,916,431,485,854,395,459,321,0,294,461,461,0,0,421
80537000,6,180521,Lamego (Sé),3464,1628,1836,3419,1605,1814,1297,4,1034,2140,2138,2,9,1136
80622000,6,180522,Valdigem,890,428,462,854,404,450,338,0,289,584,584,0,3,581
80655000,6,180523,Várzea de Abrunhais,405,199,206,381,182,199,149,0,123,281,281,0,1,281
80676000,6,180524,Vila Nova de Souto d' El-Rei,824,386,438,790,357,433,266,1,216,413,413,0,2,405
80701000,6,180701,Aldeia de Nacomba,107,52,55,105,51,54,43,0,33,102,102,0,0,100
80716000,6,180702,Alvite,1095,539,556,1003,497,506,378,1,325,649,649,0,1,646
80812000,6,180703,Arcozelos,674,320,354,663,309,354,249,0,197,475,467,8,1,424
80854000,6,180704,Ariz,107,50,57,99,45,54,52,0,35,145,145,0,0,144
80890000,6,180705,Baldos,201,99,102,192,95,97,72,0,60,133,133,0,0,132
80906000,6,180706,Cabaços,280,129,151,266,123,143,116,0,93,294,294,0,0,294
80936000,6,180707,Caria,507,238,269,499,239,260,203,0,156,489,489,0,0,482
81003000,6,180708,Castelo,245,117,128,221,104,117,102,0,83,260,260,0,0,258
81030000,6,180709,Leomil,1115,528,587,1084,517,567,391,1,336,798,798,0,2,779
81105000,6,180710,Moimenta da Beira,2888,1398,1490,2773,1327,1446,1039,3,842,1812,1812,0,4,1070
81192000,6,180711,Nagosa,111,43,68,104,42,62,50,0,35,139,139,0,0,136
81211000,6,180712,Paradinha,125,55,70,128,56,72,48,0,38,146,145,1,0,145
81233000,6,180713,Passô,343,159,184,336,154,182,143,0,94,280,280,0,0,276
81277000,6,180714,Pêra Velha,214,99,115,208,95,113,92,0,75,189,189,0,0,189
81317000,6,180715,Peva,418,194,224,392,179,213,174,0,127,418,418,0,0,413
81387000,6,180716,Rua,601,295,306,577,280,297,242,0,189,441,441,0,1,438
81427000,6,180717,Sarzedo,162,73,89,162,73,89,68,0,52,149,149,0,0,148
81446000,6,180718,Segões,101,50,51,87,41,46,45,0,30,136,136,0,0,136
81464000,6,180719,Sever,536,268,268,508,240,268,195,1,162,452,452,0,1,448
81506000,6,180720,Vilar,382,182,200,361,169,192,147,0,124,293,293,0,0,292
81534000,6,181201,Antas,184,85,99,179,84,95,93,0,56,260,260,0,0,260
81562000,6,181202,Beselga,321,155,166,304,147,157,129,1,88,331,331,0,1,325
81593000,6,181203,Castainço,161,81,80,149,73,76,70,0,53,164,164,0,0,164
81609000,6,181204,Granja,148,75,73,131,64,67,62,0,46,139,139,0,0,139
81622000,6,181205,Ourozinho,136,60,76,129,60,69,58,0,40,146,146,0,0,144
81647000,6,181206,Penedono,1007,478,529,945,437,508,359,1,283,715,715,0,1,665
81725000,6,181207,Penela da Beira,353,174,179,340,167,173,137,1,92,331,331,0,1,332
81756000,6,181208,Póvoa de Penela,325,151,174,315,145,170,136,0,97,278,278,0,0,277
81782000,6,181209,Souto,317,156,161,305,149,156,128,0,93,264,264,0,0,262
81814000,6,181501,Castanheiro do Sul,439,234,205,432,231,201,180,0,155,289,289,0,0,287
81832000,6,181502,Ervedosa do Douro,1294,612,682,1243,583,660,479,1,392,865,865,0,1,841
81881000,6,181503,Espinhosa,156,74,82,142,67,75,70,0,52,146,146,0,0,142
81897000,6,181504,Nagozelo do Douro,414,214,200,398,200,198,170,0,134,278,278,0,0,275
81917000,6,181505,Paredes da Beira,629,313,316,594,296,298,239,0,207,475,475,0,0,472
81946000,6,181506,Pereiros,84,44,40,79,39,40,35,0,26,85,85,0,0,85
81957000,6,181507,Riodades,462,220,242,453,217,236,198,0,153,444,443,1,0,444
81985000,6,181508,São João da Pesqueira,2206,1097,1109,2100,1037,1063,776,1,659,1176,1175,1,4,939
82052000,6,181509,Soutelo do Douro,459,225,234,454,222,232,175,0,141,344,344,0,0,343
82073000,6,181510,Trevões,540,260,280,522,247,275,207,1,168,415,415,0,1,416
82105000,6,181511,Vale de Figueira,462,236,226,459,232,227,184,0,148,464,464,0,0,464
82137000,6,181512,Valongo dos Azeites,227,115,112,226,112,114,90,0,73,188,188,0,0,184
82155000,6,181513,Várzea de Trevões,174,85,89,169,82,87,68,0,50,128,128,0,0,128
82169000,6,181514,Vilarouco,328,154,174,333,158,175,141,0,107,260,260,0,1,258
82200000,6,181801,Arnas,220,106,114,199,90,109,83,0,69,219,219,0,0,219
82217000,6,181802,Carregal,393,176,217,385,171,214,176,0,123,389,389,0,0,387
82255000,6,181803,Chosendo,254,127,127,260,130,130,107,0,80,226,226,0,0,225
82273000,6,181804,Cunha,310,159,151,286,145,141,115,0,89,270,267,3,0,270
82291000,6,181805,Escurquela,138,68,70,125,64,61,56,0,41,125,125,0,0,123
82308000,6,181806,Faia,207,97,110,184,84,100,80,0,67,142,142,0,0,140
82325000,6,181807,Ferreirim,457,228,229,462,231,231,191,0,143,370,370,0,0,370
82349000,6,181808,Fonte Arcada,270,127,143,268,126,142,112,1,75,266,266,0,1,262
82375000,6,181809,Freixinho,140,74,66,135,70,65,57,0,50,142,142,0,1,142
82388000,6,181810,Granjal,272,134,138,267,132,135,112,0,90,218,218,0,0,217
82410000,6,181811,Lamosa,179,86,93,170,81,89,72,1,52,167,167,0,1,168
82444000,6,181812,Macieira,124,64,60,117,60,57,53,0,37,91,91,0,0,91
82462000,6,181813,Penso,230,112,118,234,116,118,94,0,76,208,208,0,0,207
82480000,6,181814,Quintela,294,133,161,299,137,162,98,3,82,180,180,0,3,181
82512000,6,181815,Sarzeda,530,252,278,510,240,270,203,0,170,413,412,1,0,408
82552000,6,181816,Sernancelhe,1183,561,622,1141,541,600,418,1,345,743,743,0,1,642
82609000,6,181817,Vila da Ponte,470,243,227,470,242,228,179,0,143,312,312,0,0,310
82640000,6,181901,Adorigo,397,200,197,345,172,173,149,0,127,276,276,0,1,271
82655000,6,181902,Arcos,233,109,124,228,102,126,90,0,80,219,219,0,0,219
82670000,6,181903,Barcos,592,294,298,588,291,297,214,1,170,394,394,0,1,388
82697000,6,181904,Chavães,385,191,194,303,150,153,137,0,114,343,343,0,0,334
82725000,6,181905,Desejosa,175,88,87,136,67,69,76,0,49,112,112,0,0,112
82739000,6,181906,Granja do Tedo,214,111,103,182,93,89,81,0,63,179,179,0,0,179
82750000,6,181907,Granjinha,57,27,30,57,27,30,30,0,16,58,58,0,0,58
82758000,6,181908,Longra,370,179,191,327,152,175,145,0,109,285,285,0,0,284
82775000,6,181909,Paradela,123,61,62,125,62,63,49,0,36,123,123,0,0,122
82788000,6,181910,Pereiro,138,68,70,133,63,70,53,0,41,113,113,0,0,113
82798000,6,181911,Pinheiros,178,88,90,172,83,89,75,0,58,189,189,0,0,189
82814000,6,181912,Santa Leocádia,118,57,61,111,54,57,46,0,32,101,101,0,0,101
82825000,6,181913,Sendim,705,327,378,614,280,334,282,2,216,539,539,0,2,538
82867000,6,181914,Tabuaço,1782,824,958,1641,734,907,667,1,536,921,917,4,3,752
82914000,6,181915,Távora,374,176,198,362,166,196,145,0,109,252,252,0,1,236
82929000,6,181916,Vale de Figueira,146,75,71,127,63,64,53,0,46,91,91,0,0,91
82940000,6,181917,Valença do Douro,363,174,189,310,137,173,140,0,112,227,226,1,2,224
82960000,6,182001,Dálvares,689,335,354,661,318,343,260,0,219,418,418,0,1,337
82983000,6,182002,Gouviães,414,199,215,355,163,192,167,0,124,336,336,0,1,334
83007000,6,182003,Granja Nova,396,186,210,300,136,164,155,0,123,346,346,0,0,334
83036000,6,182004,Mondim da Beira,786,383,403,632,296,336,277,0,224,468,468,0,0,463
83074000,6,182005,Salzedas,767,383,384,748,366,382,291,0,235,590,590,0,0,579
83110000,6,182006,São João de Tarouca,606,290,316,583,277,306,232,0,183,790,790,0,1,786
83164000,6,182007,Tarouca,3556,1716,1840,3269,1544,1725,1263,2,1043,2546,2546,0,3,1840
83311000,6,182008,Ucanha,403,194,209,355,167,188,151,0,120,319,319,0,0,306
83336000,6,182009,Várzea da Serra,261,129,132,251,123,128,130,1,78,899,899,0,2,898
83394000,6,182010,Vila Chã da Beira,170,85,85,138,65,73,66,0,53,219,219,0,0,219
83413000,6,40101,Agrobom,109,51,58,101,45,56,52,0,38,115,115,0,0,114
83432000,6,40102,Alfândega da Fé,2055,1004,1051,2039,1005,1034,771,1,629,1187,1185,2,5,986
83530000,6,40103,Cerejais,202,90,112,195,86,109,72,1,52,137,137,0,1,138
83549000,6,40104,Eucisia,128,68,60,94,49,45,53,0,40,126,126,0,0,126
83570000,6,40105,Ferradosa,160,68,92,156,69,87,82,0,48,180,180,0,0,180
83587000,6,40106,Gebelim,190,86,104,182,83,99,70,0,62,134,134,0,0,134
83604000,6,40107,Gouveia,122,62,60,112,58,54,52,0,42,113,113,0,0,113
83620000,6,40108,Parada,124,58,66,109,50,59,52,0,39,156,156,0,0,156
83632000,6,40109,Pombal,123,60,63,111,52,59,45,0,39,81,81,0,0,81
83645000,6,40110,Saldonha,92,50,42,90,49,41,37,0,29,78,78,0,0,78
83653000,6,40111,Sambade,475,235,240,445,221,224,197,1,155,416,414,2,1,413
83696000,6,40112,Sendim da Ribeira,92,40,52,84,36,48,39,0,26,82,82,0,0,81
83708000,6,40113,Sendim da Serra,91,41,50,93,43,50,37,0,28,78,78,0,0,77
83720000,6,40114,Soeima,142,72,70,133,68,65,57,0,46,135,135,0,0,135
83738000,6,40115,Vale Pereiro,64,32,32,62,30,32,29,0,20,86,86,0,0,85
83748000,6,40116,Vales,78,42,36,78,42,36,35,0,26,61,61,0,0,61
83760000,6,40117,Valverde,107,48,59,99,44,55,49,0,30,102,102,0,0,102
83778000,6,40118,Vilar Chão,259,127,132,251,123,128,104,1,79,188,187,1,1,186
83793000,6,40119,Vilarelhos,275,123,152,269,121,148,98,1,89,187,187,0,1,188
83810000,6,40120,Vilares de Vilariça,216,110,106,206,102,104,93,0,71,214,214,0,0,214
83831000,6,40201,Alfaião,173,86,87,164,80,84,72,0,54,141,141,0,0,139
83845000,6,40202,Aveleda,196,96,100,185,92,93,95,0,65,243,243,0,0,242
83876000,6,40203,Babe,238,107,131,214,98,116,108,0,74,199,199,0,1,200
83904000,6,40204,Baçal,484,243,241,482,243,239,188,1,147,324,324,0,3,324
83931000,6,40205,Calvelhe,97,40,57,96,40,56,49,0,25,125,125,0,0,123
83944000,6,40206,Carragosa,190,90,100,184,86,98,80,0,61,183,183,0,0,182
83971000,6,40207,Carrazedo,114,45,69,113,44,69,52,0,34,123,123,0,0,123
83986000,6,40208,Castrelos,127,63,64,126,63,63,60,0,42,155,155,0,1,156
84002000,6,40209,Castro de Avelãs,460,229,231,446,223,223,175,0,150,254,254,0,0,240
84022000,6,40210,Coelhoso,319,136,183,322,140,182,126,1,92,312,312,0,1,313
84041000,6,40211,Deilão,168,80,88,167,79,88,77,0,57,175,175,0,0,175
84074000,6,40212,Donai,446,216,230,417,200,217,168,0,138,310,301,9,0,300
84105000,6,40213,Espinhosela,244,130,114,237,126,111,105,0,81,240,240,0,3,243
84138000,6,40214,Failde,150,67,83,149,68,81,59,1,41,106,106,0,1,107
84156000,6,40215,França,238,104,134,249,109,140,116,0,82,238,238,0,11,247
84186000,6,40216,Gimonde,341,158,183,351,168,183,135,0,110,225,225,0,6,229
84207000,6,40217,Gondesende,194,94,100,190,91,99,79,0,64,127,127,0,6,133
84227000,6,40218,Gostei,425,213,212,413,206,207,159,0,135,246,246,0,0,242
84253000,6,40219,Grijó de Parada,296,150,146,284,140,144,126,0,94,231,230,1,0,230
84274000,6,40220,Izeda,1006,614,392,988,608,380,278,4,221,538,538,0,2,535
84312000,6,40221,Macedo do Mato,208,104,104,206,102,104,106,0,69,220,220,0,0,220
84340000,6,40222,Meixedo,163,75,88,166,74,92,66,0,54,141,141,0,0,141
84356000,6,40223,Milhão,161,76,85,152,71,81,65,0,49,120,120,0,0,120
84378000,6,40224,Mós,178,90,88,179,91,88,75,0,58,170,170,0,2,172
84397000,6,40225,Nogueira,495,244,251,484,233,251,171,1,148,228,228,0,1,228
84425000,6,40226,Outeiro,301,152,149,298,150,148,121,1,79,293,293,0,1,294
84456000,6,40227,Parada,507,243,264,493,234,259,231,0,171,557,556,1,0,557
84498000,6,40228,Paradinha Nova,109,53,56,103,49,54,49,0,30,143,143,0,0,142
84513000,6,40229,Parâmio,214,97,117,213,97,116,104,0,68,215,215,0,3,217
84542000,6,40230,Pinela,219,103,116,253,121,132,97,0,78,255,255,0,0,255
84569000,6,40231,Pombares,41,21,20,38,19,19,19,0,13,49,49,0,0,49
84575000,6,40232,Quintanilha,216,106,110,205,101,104,92,1,65,201,201,0,1,202
84599000,6,40233,Quintela de Lampaças,215,103,112,210,101,109,107,0,71,224,224,0,0,224
84618000,6,40234,Rabal,171,75,96,160,71,89,86,0,55,160,160,0,4,164
84638000,6,40235,Rebordainhos,146,72,74,141,69,72,61,0,46,128,128,0,0,125
84655000,6,40236,Rebordãos,546,254,292,534,248,286,208,1,172,331,331,0,1,326
84675000,6,40237,Rio Frio,203,96,107,210,100,110,105,0,65,250,250,0,0,249
84702000,6,40238,Rio de Onor,76,35,41,74,35,39,41,0,27,104,104,0,0,104
84717000,6,40239,Salsas,389,200,189,394,203,191,162,1,124,311,311,0,1,311
84751000,6,40240,Samil,1246,605,641,1203,581,622,442,1,378,687,687,0,4,544
84803000,6,40241,Santa Comba de Rossas,304,152,152,280,138,142,113,1,94,231,228,3,1,227
84829000,6,40242,Bragança (Santa Maria),3940,1905,2035,3828,1861,1967,1507,5,1157,2604,2603,1,13,1345
84921000,6,40243,São Julião de Palácios,232,111,121,217,102,115,110,0,77,230,230,0,0,230
84947000,6,40244,São Pedro de Sarracenos,366,164,202,355,158,197,120,1,109,191,191,0,2,191
84969000,6,40245,Bragança (Sé),17913,8452,9461,18607,8607,10000,6902,12,5415,11541,11529,12,23,4696
85285000,6,40246,Sendas,183,83,100,173,80,93,83,0,63,146,146,0,0,146
85305000,6,40247,Serapicos,208,100,108,198,93,105,101,0,68,234,234,0,0,234
85334000,6,40248,Sortes,296,138,158,287,130,157,107,1,87,191,191,0,1,191
85357000,6,40249,Zoio,189,96,93,185,94,91,77,0,54,132,132,0,0,130
85375000,6,40501,Ala,417,198,219,398,190,208,172,0,128,323,323,0,0,323
85425000,6,40502,Amendoeira,427,214,213,413,207,206,163,0,132,308,308,0,1,308
85465000,6,40503,Arcas,262,131,131,239,122,117,116,0,88,208,208,0,1,206
85495000,6,40504,Bagueixe,156,82,74,155,81,74,78,0,43,150,150,0,0,150
85511000,6,40505,Bornes,390,174,216,378,173,205,162,0,124,293,293,0,3,295
85537000,6,40506,Burga,53,23,30,49,22,27,27,0,17,69,69,0,0,69
85547000,6,40507,Carrapatas,197,97,100,196,95,101,79,0,63,139,139,0,0,137
85560000,6,40508,Castelãos,443,180,263,411,149,262,135,3,107,219,219,0,3,222
85581000,6,40509,Chacim,265,123,142,279,122,157,118,2,82,226,226,0,3,228
85604000,6,40510,Cortiços,296,147,149,290,145,145,133,0,102,284,284,0,0,284
85628000,6,40511,Corujas,168,86,82,161,84,77,71,0,55,131,131,0,0,129
85643000,6,40512,Edroso,95,40,55,92,38,54,39,0,32,71,71,0,0,71
85656000,6,40513,Espadanedo,188,100,88,186,100,86,77,0,53,162,162,0,0,162
85680000,6,40514,Ferreira,194,94,100,192,94,98,91,0,63,180,179,1,0,179
85703000,6,40515,Grijó,371,172,199,374,172,202,150,1,110,293,293,0,1,294
85726000,6,40516,Lagoa,312,148,164,307,144,163,144,0,108,268,268,0,0,268
85745000,6,40517,Lamalonga,402,199,203,401,200,201,172,0,126,367,367,0,1,363
85779000,6,40518,Lamas,278,139,139,273,136,137,117,0,92,183,183,0,1,181
85794000,6,40519,Lombo,346,165,181,325,155,170,121,1,106,166,166,0,1,164
85807000,6,40520,Macedo de Cavaleiros,6257,2933,3324,6018,2798,3220,2323,2,1936,4047,4046,1,9,2276
85971000,6,40521,Morais,644,319,325,508,245,263,244,0,199,429,429,0,1,428
86007000,6,40522,Murçós,134,60,74,127,56,71,65,0,44,168,168,0,0,168
86024000,6,40523,Olmos,208,103,105,201,98,103,80,0,70,155,155,0,0,155
86047000,6,40524,Peredo,258,132,126,255,128,127,106,0,86,195,195,0,1,193
86067000,6,40525,Podence,250,113,137,253,120,133,107,0,83,220,220,0,3,216
86084000,6,40526,Salselas,386,196,190,390,199,191,160,0,122,352,352,0,0,352
86126000,6,40527,Santa Combinha,56,28,28,58,29,29,27,0,15,47,47,0,0,47
86136000,6,40528,Sesulfe,263,114,149,262,114,148,103,1,79,192,192,0,1,185
86161000,6,40529,Soutelo Mourisco,31,17,14,31,17,14,18,0,9,85,85,0,0,85
86178000,6,40530,Talhas,316,151,165,306,147,159,146,0,101,269,269,0,0,269
86211000,6,40531,Talhinhas,173,79,94,171,80,91,79,0,56,171,171,0,0,171
86234000,6,40532,Vale Benfeito,181,94,87,175,92,83,85,0,55,172,172,0,0,169
86252000,6,40533,Vale da Porca,286,131,155,262,117,145,111,0,91,219,219,0,0,212
86264000,6,40534,Vale de Prados,431,200,231,422,195,227,167,1,130,298,298,0,2,295
86293000,6,40535,Vilar do Monte,104,49,55,86,35,51,44,0,33,99,99,0,0,98
86303000,6,40536,Vilarinho de Agrochão,235,109,126,236,110,126,84,0,82,157,157,0,0,154
86323000,6,40537,Vilarinho do Monte,67,34,33,67,34,33,32,0,24,64,64,0,0,64
86335000,6,40538,Vinhas,236,117,119,219,109,110,117,0,76,281,281,0,0,277
86357000,6,40601,Atenor,121,58,63,115,50,65,58,0,42,110,110,0,1,110
86374000,6,40602,Cicouro,95,47,48,97,48,49,43,0,26,96,96,0,0,96
86389000,6,40603,Constantim,109,49,60,100,47,53,56,0,39,112,112,0,0,111
86400000,6,40604,Duas Igrejas,599,291,308,562,271,291,266,0,192,452,451,1,0,450
86443000,6,40605,Genísio,186,94,92,179,92,87,89,0,66,194,194,0,0,194
86467000,6,40606,Ifanes,160,76,84,158,75,83,79,0,50,181,181,0,0,181
86487000,6,40607,Malhadas,344,170,174,343,170,173,138,0,111,246,246,0,2,248
86515000,6,40608,Miranda do Douro,2254,1084,1170,2237,1063,1174,850,2,690,1443,1443,0,15,1098
86620000,6,40609,Palaçoulo,554,284,270,515,263,252,196,1,171,309,309,0,3,309
86655000,6,40610,Paradela,151,75,76,146,72,74,59,0,50,97,97,0,0,97
86675000,6,40611,Picote,301,146,155,291,142,149,128,1,87,253,253,0,4,257
86701000,6,40612,Póvoa,208,106,102,210,108,102,90,0,72,144,144,0,0,144
86729000,6,40613,São Martinho de Angueira,307,148,159,296,142,154,144,1,96,320,320,0,1,321
86764000,6,40614,Sendim,1366,670,696,1285,630,655,527,2,430,976,976,0,5,961
86828000,6,40615,Silva,237,121,116,230,120,110,112,0,81,199,199,0,0,199
86858000,6,40616,Vila Chã de Braciosa,327,164,163,300,150,150,151,0,110,270,269,1,1,271
86895000,6,40617,Águas Vivas,163,84,79,147,75,72,69,0,47,111,111,0,0,111
86911000,6,40701,Abambres,347,179,168,343,174,169,142,0,110,258,258,0,0,256
86926000,6,40702,Abreiro,257,138,119,255,137,118,110,0,76,269,269,0,0,267
86941000,6,40703,Aguieiras,289,133,156,288,136,152,134,0,96,253,252,1,0,252
86960000,6,40704,Alvites,237,120,117,231,118,113,103,0,72,192,192,0,0,192
86977000,6,40705,Avantos,96,43,53,91,42,49,49,0,36,107,107,0,0,106
86986000,6,40706,Avidagos,245,120,125,234,115,119,100,0,78,138,138,0,0,136
86999000,6,40707,Barcel,126,59,67,119,56,63,58,0,42,82,82,0,0,78
87009000,6,40708,Bouça,261,125,136,259,124,135,129,0,85,247,246,1,1,245
87022000,6,40709,Cabanelas,386,185,201,370,174,196,151,0,125,231,231,0,0,227
87036000,6,40710,Caravelas,214,107,107,207,104,103,92,0,73,146,146,0,0,145
87045000,6,40711,Carvalhais,1299,642,657,1255,620,635,455,1,395,673,673,0,2,628
87068000,6,40712,Cedães,338,161,177,329,156,173,148,0,115,280,280,0,0,277
87083000,6,40713,Cobro,205,92,113,192,87,105,90,0,67,107,107,0,0,106
87092000,6,40714,Fradizela,234,120,114,223,111,112,107,0,86,218,218,0,0,218
87102000,6,40715,Franco,244,120,124,238,118,120,109,0,83,165,165,0,0,165
87113000,6,40716,Frechas,929,444,485,888,421,467,357,1,303,530,530,0,2,526
87137000,6,40717,Freixeda,89,43,46,87,41,46,39,0,28,80,80,0,0,78
87147000,6,40718,Lamas de Orelhão,394,190,204,373,181,192,149,0,123,231,229,2,0,229
87161000,6,40719,Marmelos,145,66,79,141,64,77,63,0,43,142,142,0,0,142
87173000,6,40720,Mascarenhas,550,243,307,529,234,295,232,0,181,471,471,0,0,471
87188000,6,40721,Mirandela,11852,5620,6232,11721,5542,6179,4399,6,3628,6440,6431,9,16,3217
87438000,6,40722,Múrias,281,137,144,242,113,129,128,0,102,213,210,3,0,210
87452000,6,40723,Navalho,96,45,51,89,40,49,33,0,29,47,47,0,0,47
87461000,6,40724,Passos,423,210,213,396,196,200,167,0,137,239,239,0,0,238
87472000,6,40725,Pereira,190,64,126,155,59,96,55,1,43,90,90,0,1,91
87480000,6,40726,Romeu,280,126,154,282,128,154,100,1,82,157,157,0,1,156
87495000,6,40727,São Pedro Velho,329,154,175,320,151,169,145,0,106,278,278,0,0,277
87508000,6,40728,São Salvador,223,109,114,221,107,114,99,0,67,171,171,0,0,169
87518000,6,40729,Suçães,574,270,304,559,261,298,242,1,181,422,422,0,1,422
87533000,6,40730,Torre de Dona Chama,1105,504,601,1046,479,567,468,1,344,817,817,0,5,779
87566000,6,40731,Vale de Asnes,271,134,137,269,133,136,110,0,85,189,189,0,0,187
87579000,6,40732,Vale de Gouvinhas,319,154,165,309,148,161,136,0,106,286,286,0,0,286
87594000,6,40733,Vale de Salgueiro,424,209,215,427,211,216,164,1,126,254,254,0,1,254
87606000,6,40734,Vale de Telhas,283,132,151,276,128,148,124,0,91,216,216,0,0,215
87616000,6,40735,Valverde,144,71,73,140,68,72,51,0,45,76,76,0,0,76
87625000,6,40736,Vila Boa,90,44,46,92,46,46,43,0,31,83,83,0,0,83
87633000,6,40737,Vila Verde,81,40,41,79,40,39,28,0,25,64,64,0,0,64
87642000,6,40801,Azinhoso,307,152,155,304,150,154,136,0,108,237,237,0,0,236
87671000,6,40802,Bemposta,602,295,307,581,288,293,245,1,182,556,556,0,3,554
87724000,6,40803,Bruçó,211,102,109,203,97,106,103,1,65,195,195,0,1,196
87739000,6,40804,Brunhoso,216,107,109,211,105,106,80,0,63,206,206,0,0,206
87768000,6,40805,Brunhozinho,86,42,44,83,41,42,42,0,29,84,84,0,0,84
87782000,6,40806,Castanheira,77,42,35,76,41,35,34,0,24,49,49,0,0,49
87793000,6,40807,Castelo Branco,449,210,239,448,208,240,220,0,153,383,383,0,1,384
87844000,6,40808,Castro Vicente,337,162,175,323,152,171,138,0,108,238,238,0,0,237
87883000,6,40809,Meirinhos,287,141,146,278,139,139,120,0,96,255,255,0,0,255
87908000,6,40810,Mogadouro,3549,1752,1797,3365,1667,1698,1309,2,1110,2115,2115,0,14,1659
88039000,6,40811,Paradela,156,77,79,153,74,79,63,0,52,100,100,0,0,100
88053000,6,40812,Penas Roias,382,181,201,371,177,194,152,0,132,263,263,0,0,263
88111000,6,40813,Peredo da Bemposta,188,100,88,185,98,87,88,0,69,172,172,0,0,171
88139000,6,40814,Remondes,212,102,110,217,108,109,90,0,68,157,157,0,0,157
88155000,6,40815,Saldanha,165,79,86,165,79,86,80,0,50,143,143,0,0,143
88177000,6,40816,Sanhoane,126,67,59,123,65,58,51,0,43,85,85,0,0,85
88193000,6,40817,São Martinho do Peso,355,180,175,351,180,171,160,0,118,293,293,0,0,293
88234000,6,40818,Soutelo,129,63,66,121,61,60,58,0,38,94,94,0,0,93
88250000,6,40819,Tó,154,74,80,143,70,73,64,0,49,155,155,0,0,152
88271000,6,40820,Travanca,172,88,84,167,86,81,83,0,58,124,124,0,1,124
88299000,6,40821,Urrós,318,151,167,306,144,162,148,1,105,278,278,0,2,277
88351000,6,40822,Vale da Madre,156,85,71,156,86,70,62,0,53,109,109,0,0,109
88374000,6,40823,Vale de Porco,133,60,73,129,58,71,52,0,43,123,123,0,0,120
88397000,6,40824,Valverde,133,66,67,131,65,66,66,0,44,170,170,0,0,169
88413000,6,40825,Ventozelo,146,75,71,141,72,69,72,0,48,149,149,0,0,149
88439000,6,40826,Vila de Ala,234,119,115,214,109,105,105,0,73,203,203,0,0,202
88477000,6,40827,Vilar de Rei,72,36,36,70,35,35,33,0,21,73,73,0,0,73
88490000,6,40828,Vilarinho dos Galegos,190,91,99,190,89,101,85,0,63,173,173,0,0,172
88516000,6,41101,Algoso,281,135,146,273,131,142,115,1,89,271,271,0,2,273
88547000,6,41102,Angueira,116,56,60,109,50,59,55,0,39,119,119,0,0,119
88568000,6,41103,Argozelo,701,351,350,680,341,339,265,1,210,894,894,0,1,816
88615000,6,41104,Avelanoso,148,72,76,164,81,83,56,1,39,203,203,0,1,204
88641000,6,41105,Caçarelhos,219,115,104,214,110,104,101,0,75,182,182,0,1,182
88667000,6,41106,Campo de Víboras,155,71,84,147,68,79,78,0,54,209,209,0,0,208
88687000,6,41107,Carção,419,198,221,406,193,213,170,1,120,487,487,0,1,488
88714000,6,41108,Matela,228,110,118,232,112,120,126,0,69,254,254,0,0,248
88748000,6,41109,Pinelo,222,105,117,205,95,110,99,1,65,226,226,0,1,224
88777000,6,41110,Santulhão,423,213,210,418,212,206,198,1,135,421,421,0,1,419
88802000,6,41111,Uva,131,62,69,128,63,65,65,0,47,145,145,0,0,144
88823000,6,41112,Vale de Frades,160,80,80,158,81,77,83,0,58,241,241,0,0,241
88858000,6,41113,Vilar Seco,181,96,85,173,92,81,76,0,60,134,134,0,1,135
88870000,6,41114,Vimioso,1285,619,666,1216,586,630,475,2,381,833,833,0,6,790
88927000,6,41201,Agrochão,280,146,134,261,137,124,120,1,88,238,238,0,1,238
88955000,6,41202,Alvaredos,62,29,33,62,29,33,32,0,21,52,52,0,0,52
88961000,6,41203,Candedo,331,166,165,321,163,158,137,0,109,218,218,0,1,219
88992000,6,41204,Celas,269,144,125,289,154,135,108,0,82,260,260,0,2,261
89023000,6,41205,Curopos,212,95,117,204,90,114,94,0,67,171,171,0,0,169
89050000,6,41206,Edral,198,94,104,198,94,104,88,0,66,185,185,0,0,185
89081000,6,41207,Edrosa,151,75,76,150,75,75,63,0,49,130,130,0,0,130
89108000,6,41208,Ervedosa,376,178,198,363,171,192,159,1,118,300,300,0,1,301
89140000,6,41209,Fresulfe,83,36,47,80,36,44,37,0,27,74,74,0,2,76
89154000,6,41210,Mofreita,54,27,27,54,27,27,23,0,17,51,51,0,0,51
89168000,6,41211,Moimenta,168,90,78,159,86,73,60,1,45,141,141,0,2,141
89188000,6,41212,Montouto,110,53,57,108,51,57,51,0,29,108,108,0,4,112
89215000,6,41213,Nunes,134,64,70,133,63,70,55,0,47,100,100,0,0,100
89229000,6,41214,Ousilhão,123,56,67,120,55,65,56,0,42,83,83,0,0,83
89247000,6,41215,Paçó,191,96,95,188,95,93,83,0,56,128,128,0,0,126
89270000,6,41216,Penhas Juntas,255,128,127,252,127,125,99,0,65,218,218,0,0,217
89300000,6,41217,Pinheiro Novo,106,52,54,106,52,54,51,0,38,119,119,0,0,112
89328000,6,41218,Quirás,180,101,79,178,100,78,85,0,56,175,175,0,0,175
89376000,6,41219,Rebordelo,618,323,295,586,299,287,239,1,195,431,431,0,2,430
89418000,6,41220,Santa Cruz,57,25,32,52,23,29,29,0,17,59,59,0,0,58
89430000,6,41221,Santalha,254,129,125,246,124,122,114,0,77,245,245,0,0,245
89468000,6,41222,São Jomil,38,22,16,38,22,16,22,0,12,52,52,0,0,52
89480000,6,41223,Sobreiro de Baixo,307,155,152,302,155,147,114,0,95,171,170,1,0,171
89522000,6,41224,Soeira,87,41,46,84,39,45,43,0,28,92,92,0,0,92
89537000,6,41225,Travanca,114,57,57,105,52,53,41,0,35,58,58,0,3,61
89551000,6,41226,Tuizelo,387,193,194,376,188,188,184,0,129,303,303,0,0,303
89628000,6,41227,Vale das Fontes,347,178,169,344,177,167,151,0,117,272,272,0,0,271
89658000,6,41228,Vale de Janeiro,101,54,47,96,52,44,45,0,32,114,114,0,0,114
89676000,6,41229,Vila Boa de Ousilhão,184,98,86,179,95,84,74,1,52,130,130,0,1,131
89689000,6,41230,Vila Verde,186,91,95,180,90,90,81,0,58,151,151,0,1,151
89709000,6,41231,Vilar de Lomba,199,103,96,243,126,117,78,0,62,120,120,0,0,119
89730000,6,41232,Vilar de Ossos,269,131,138,246,124,122,108,0,82,243,243,0,0,243
89763000,6,41233,Vilar de Peregrinos,155,79,76,152,77,75,71,0,46,120,120,0,0,120
89783000,6,41234,Vilar Seco de Lomba,235,112,123,223,107,116,107,0,79,218,218,0,0,218
89826000,6,41235,Vinhais,2245,1064,1181,2148,1029,1119,867,1,691,1456,1456,0,6,1209
89922000,6,170201,Alturas do Barroso,399,190,209,395,193,202,161,0,116,327,327,0,0,327
89965000,6,170202,Ardãos,249,136,113,245,134,111,120,0,76,270,270,0,0,270
89995000,6,170203,Beça,843,415,428,826,405,421,323,0,269,713,713,0,1,713
90051000,6,170204,Bobadela,330,151,179,333,153,180,138,0,108,282,282,0,0,282
90097000,6,170205,Boticas,1280,611,669,1249,598,651,441,4,371,749,749,0,6,683
90166000,6,170206,Cerdedo,145,69,76,141,68,73,55,0,42,98,98,0,0,97
90188000,6,170207,Codessoso,132,59,73,131,58,73,56,0,42,146,146,0,1,147
90206000,6,170208,Covas do Barroso,262,119,143,253,115,138,122,0,74,233,233,0,0,233
90230000,6,170209,Curros,67,33,34,67,33,34,23,0,21,62,62,0,0,62
90250000,6,170210,Dornelas,338,155,183,376,176,200,158,0,109,341,341,0,0,329
90301000,6,170211,Fiães do Tâmega,99,44,55,91,42,49,40,0,29,110,110,0,0,109
90315000,6,170212,Granja,230,117,113,224,113,111,94,0,79,179,179,0,1,180
90341000,6,170213,Pinho,401,192,209,392,187,205,172,0,130,361,361,0,0,358
90379000,6,170214,São Salvador de Viveiro,293,151,142,280,144,136,122,0,91,206,206,0,0,206
90407000,6,170215,Sapiãos,488,238,250,481,237,244,195,0,158,412,412,0,0,412
90460000,6,170216,Vilar,194,99,95,192,98,94,80,0,61,142,142,0,1,140
90481000,6,170301,Águas Frias,746,361,385,723,351,372,298,0,235,557,557,0,0,556
90555000,6,170302,Anelhe,476,235,241,463,230,233,172,0,143,331,331,0,0,329
90579000,6,170303,Arcossó,323,156,167,314,150,164,132,0,101,268,268,0,1,268
90595000,6,170304,Bobadela,105,52,53,96,47,49,50,0,35,101,101,0,0,101
90608000,6,170305,Bustelo,519,261,258,489,242,247,204,0,159,397,396,1,0,390
90629000,6,170306,Calvão,353,159,194,348,156,192,159,1,107,429,429,0,1,427
90662000,6,170307,Cela,150,72,78,142,67,75,60,0,48,98,98,0,1,99
90674000,6,170309,Cimo de Vila da Castanheira,479,230,249,469,222,247,206,0,148,403,403,0,0,403
90714000,6,170310,Curalha,469,229,240,444,215,229,170,0,138,256,256,0,0,256
90743000,6,170311,Eiras,540,266,274,503,244,259,205,0,173,358,358,0,0,357
90780000,6,170312,Ervededo,646,328,318,628,319,309,270,1,208,662,662,0,1,662
90828000,6,170313,Faiões,873,424,449,855,418,437,326,0,263,472,472,0,0,457
90868000,6,170314,Lama de Arcos,316,146,170,313,146,167,135,0,107,298,298,0,0,298
90896000,6,170315,Loivos,553,261,292,545,258,287,219,1,176,450,450,0,1,450
90930000,6,170316,Mairos,344,154,190,338,149,189,135,1,90,235,235,0,1,235
90957000,6,170317,Moreiras,273,136,137,273,135,138,117,0,86,242,242,0,1,243
90982000,6,170318,Nogueira da Montanha,529,276,253,533,278,255,217,0,169,391,391,0,0,390
91052000,6,170319,Oucidres,194,97,97,192,95,97,81,0,68,184,184,0,0,184
91075000,6,170320,Oura,602,294,308,593,287,306,248,0,195,455,455,0,0,453
91106000,6,170321,Outeiro Seco,938,450,488,894,429,465,352,0,299,515,514,1,0,473
91144000,6,170322,Paradela,262,130,132,253,125,128,107,0,85,168,168,0,0,168
91159000,6,170323,Póvoa de Agrações,186,97,89,187,97,90,95,0,60,201,201,0,0,201
91188000,6,170324,Redondelo,527,278,249,538,284,254,197,0,168,355,355,0,3,352
91224000,6,170325,Roriz,164,73,91,162,70,92,71,0,56,162,162,0,0,162
91247000,6,170326,Samaiões,1318,634,684,1284,608,676,491,1,430,784,784,0,3,694
91304000,6,170327,Sanfins,236,105,131,242,105,137,104,0,72,286,286,0,0,285
91340000,6,170328,Sanjurge,334,166,168,328,167,161,131,0,101,263,263,0,0,261
91364000,6,170329,Santa Leocádia,324,148,176,326,149,177,142,0,112,264,262,2,1,263
91413000,6,170330,Santo António de Monforte,454,225,229,426,211,215,175,0,141,300,300,0,0,298
91435000,6,170331,Santo Estêvão,607,291,316,599,285,314,229,1,188,380,380,0,2,379
91467000,6,170332,São Julião de Montenegro,280,133,147,278,133,145,117,0,83,224,224,0,0,224
91490000,6,170333,São Pedro de Agostém,1419,684,735,1345,637,708,517,0,442,902,902,0,3,893
91601000,6,170334,São Vicente,227,115,112,242,125,117,114,0,75,313,313,0,0,313
91638000,6,170335,Seara Velha,165,81,84,165,81,84,70,0,49,144,144,0,0,144
91656000,6,170336,Selhariz,244,115,129,229,106,123,93,0,78,197,197,0,1,196
91678000,6,170337,Soutelinho da Raia,150,75,75,135,67,68,72,0,49,153,153,0,0,153
91701000,6,170338,Soutelo,350,172,178,327,156,171,138,0,112,239,239,0,0,239
91727000,6,170339,Travancas,402,179,223,377,167,210,162,1,117,317,317,0,1,318
91771000,6,170340,Tronco,218,105,113,287,140,147,104,0,72,232,232,0,0,221
91794000,6,170341,Vale de Anta,1543,772,771,1512,743,769,518,3,461,777,777,0,6,697
91854000,6,170342,Vidago,1204,570,634,1094,512,582,434,1,346,755,755,0,6,627
91901000,6,170343,Vila Verde da Raia,993,464,529,928,433,495,378,0,306,556,556,0,0,551
91946000,6,170344,Vilar de Nantes,2084,970,1114,1983,915,1068,762,2,644,1154,1154,0,5,892
92005000,6,170345,Vilarelho da Raia,558,265,293,556,261,295,252,1,180,518,518,0,1,516
92046000,6,170346,Vilarinho das Paranheiras,220,104,116,216,103,113,82,0,67,148,148,0,0,147
92063000,6,170347,Vilas Boas,195,99,96,188,96,92,84,0,57,152,152,0,1,153
92086000,6,170348,Vilela Seca,276,143,133,260,133,127,120,0,93,288,288,0,0,288
92107000,6,170349,Vilela do Tâmega,409,202,207,390,190,200,159,0,131,306,306,0,1,304
92145000,6,170350,Santa Maria Maior,11788,5470,6318,11104,5093,6011,4724,6,3605,7710,7710,0,19,3335
92376000,6,170351,Madalena,1582,760,822,1539,742,797,615,2,510,1140,1140,0,6,809
92423000,6,170352,Santa Cruz/Trindade,3096,1526,1570,2940,1433,1507,1150,0,1004,1828,1827,1,0,1489
92509000,6,170601,Cabril,553,265,288,518,251,267,212,1,158,439,439,0,1,433
92566000,6,170602,Cambeses do Rio,130,58,72,129,58,71,59,0,42,154,154,0,0,154
92589000,6,170603,Cervos,271,137,134,268,137,131,107,0,77,280,280,0,0,280
92623000,6,170604,Chã,748,366,382,752,371,381,293,0,230,742,742,0,10,751
92751000,6,170605,Contim,87,43,44,79,40,39,40,0,29,139,139,0,0,139
92775000,6,170606,Covelães,135,69,66,121,63,58,63,0,44,170,170,0,1,169
92804000,6,170607,Covelo do Gerês,194,99,95,187,95,92,73,0,56,165,165,0,0,165
92829000,6,170608,Donões,62,30,32,60,28,32,27,0,19,90,90,0,0,90
92854000,6,170609,Ferral,397,188,209,387,182,205,163,0,121,357,357,0,0,349
92911000,6,170610,Fervidelas,87,42,45,86,41,45,31,0,24,137,137,0,0,136
92931000,6,170611,Fiães do Rio,76,36,40,75,34,41,33,0,23,120,120,0,0,120
92954000,6,170612,Gralhas,208,98,110,227,109,118,112,0,73,353,353,0,0,353
92988000,6,170613,Meixedo,209,104,105,203,102,101,97,0,64,346,346,0,0,345
93032000,6,170614,Meixide,88,47,41,80,42,38,41,0,27,97,97,0,0,97
93052000,6,170615,Montalegre,1816,856,960,1739,812,927,646,1,537,1225,1225,0,6,993
93163000,6,170616,Morgade,228,113,115,230,114,116,94,0,70,201,201,0,0,201
93199000,6,170617,Mourilhe,117,58,59,118,58,60,50,0,35,184,184,0,1,185
93227000,6,170618,Negrões,177,80,97,173,78,95,70,0,57,174,174,0,0,172
93270000,6,170619,Outeiro,156,82,74,150,78,72,61,0,50,134,134,0,1,132
93300000,6,170620,Padornelos,124,57,67,102,43,59,52,0,38,203,203,0,0,203
93350000,6,170621,Padroso,107,48,59,90,42,48,45,0,33,108,108,0,0,108
93371000,6,170622,Paradela,145,66,79,134,61,73,63,0,40,148,148,0,2,150
93414000,6,170623,Pitões das Junias,161,67,94,145,62,83,68,0,48,210,210,0,2,206
93444000,6,170624,Pondras,131,58,73,128,57,71,55,0,41,196,196,0,0,195
93476000,6,170625,Reigoso,167,75,92,171,77,94,81,0,55,232,232,0,0,230
93505000,6,170626,Salto,1429,691,738,1424,696,728,543,1,418,1117,1117,0,2,1008
93654000,6,170627,Santo André,218,113,105,212,113,99,98,0,72,245,245,0,0,244
93674000,6,170628,Vilar de Perdizes (São Miguel),460,240,220,452,237,215,206,0,142,467,467,0,0,466
93718000,6,170629,Sarraquinhos,294,140,154,293,141,152,116,0,85,334,334,0,0,334
93767000,6,170630,Sezelhe,142,63,79,133,58,75,61,0,38,161,161,0,0,160
93796000,6,170631,Solveira,154,73,81,155,73,82,69,0,52,269,269,0,0,269
93838000,6,170632,Tourém,151,74,77,131,63,68,63,0,48,238,238,0,1,237
93854000,6,170633,Venda Nova,262,121,141,248,114,134,114,0,80,327,327,0,1,325
93894000,6,170634,Viade de Baixo,675,347,328,664,339,325,252,1,183,620,620,0,4,618
93977000,6,170635,Vila da Ponte,178,92,86,176,91,85,74,0,52,139,139,0,2,140
94005000,6,170701,Candedo,1002,497,505,976,479,497,407,1,303,748,748,0,1,745
94098000,6,170702,Carva,269,129,140,257,122,135,103,0,88,241,241,0,0,239
94139000,6,170703,Fiolhoso,452,220,232,497,239,258,179,1,133,467,467,0,2,468
94212000,6,170704,Jou,654,328,326,618,311,307,266,0,208,472,472,0,0,470
94265000,6,170705,Murça,2136,1021,1115,2074,982,1092,773,2,653,1137,1137,0,8,1005
94335000,6,170706,Noura,575,287,288,548,269,279,219,0,172,365,365,0,1,361
94359000,6,170707,Palheiros,332,151,181,301,136,165,134,0,98,239,239,0,0,237
94383000,6,170708,Valongo de Milhais,329,162,167,318,157,161,139,0,110,272,272,0,0,272
94425000,6,170709,Vilares,203,105,98,199,103,96,86,0,60,188,188,0,0,188
94448000,6,171201,Água Revés e Crasto,342,165,177,341,164,177,144,0,112,274,274,0,0,274
94476000,6,171202,Alvarelhos,137,59,78,185,79,106,59,0,48,121,121,0,0,121
94496000,6,171203,Algeriz,570,274,296,556,265,291,237,1,181,406,405,1,1,404
94542000,6,171204,Barreiros,177,89,88,175,90,85,74,0,53,136,136,0,0,136
94556000,6,171205,Bouçoães,419,189,230,473,213,260,185,0,136,344,344,0,0,343
94598000,6,171206,Canaveses,237,109,128,222,104,118,113,0,73,155,155,0,1,156
94617000,6,171207,Carrazedo de Montenegro,1620,787,833,1568,759,809,651,1,529,1159,1159,0,1,1005
94707000,6,171208,Curros,160,78,82,144,70,74,69,0,50,142,142,0,0,142
94720000,6,171209,Ervões,636,312,324,610,297,313,274,0,197,498,498,0,0,498
94769000,6,171210,Fiães,111,51,60,107,48,59,50,0,41,100,100,0,0,100
94783000,6,171211,Fornos do Pinhal,320,147,173,312,143,169,131,0,99,206,205,1,0,206
94806000,6,171212,Friões,619,289,330,613,287,326,288,1,187,560,560,0,2,562
94874000,6,171213,Lebução,562,277,285,560,277,283,206,1,173,432,432,0,1,433
94909000,6,171214,Nozelos,111,52,59,113,54,59,54,0,39,137,137,0,0,137
94927000,6,171215,Padrela e Tazem,359,164,195,354,161,193,154,0,120,343,343,0,0,343
94955000,6,171216,Possacos,446,211,235,429,201,228,184,0,136,343,343,0,1,344
94976000,6,171217,Rio Torto,362,161,201,346,156,190,169,0,113,300,300,0,0,300
95010000,6,171218,Sanfins,213,99,114,267,134,133,90,0,68,168,168,0,0,166
95026000,6,171219,Santa Maria de Emeres,406,189,217,393,183,210,175,0,129,319,319,0,1,320
95051000,6,171220,Santa Valha,415,198,217,406,193,213,180,0,133,323,323,0,0,323
95087000,6,171221,Santiago da Ribeira de Alhariz,603,288,315,593,281,312,265,0,198,602,602,0,0,602
95146000,6,171222,São João da Corveira,537,247,290,505,231,274,230,0,170,491,491,0,0,490
95209000,6,171223,São Pedro de Veiga de Lila,304,149,155,303,152,151,132,0,107,217,217,0,0,217
95228000,6,171224,Serapicos,246,121,125,235,114,121,103,0,77,182,182,0,0,182
95259000,6,171225,Sonim,273,134,139,279,139,140,118,0,91,237,237,0,0,236
95281000,6,171226,Tinhela,196,94,102,198,94,104,90,0,59,258,258,0,0,255
95305000,6,171227,Vales,257,131,126,237,122,115,118,0,78,214,214,0,0,214
95332000,6,171228,Valpaços,4539,2116,2423,4367,2023,2344,1679,4,1372,3273,3269,4,7,2235
95501000,6,171229,Vassal,460,209,251,437,201,236,184,1,138,360,360,0,2,362
95525000,6,171230,Veiga de Lila,261,127,134,252,126,126,103,0,88,203,203,0,1,199
95547000,6,171231,Vilarandelo,984,459,525,936,430,506,391,3,304,748,748,0,3,730
95609000,6,171301,Afonsim,183,90,93,182,91,91,76,0,58,188,188,0,0,188
95629000,6,171302,Alfarela de Jales,401,204,197,408,209,199,166,0,122,351,351,0,0,347
95677000,6,171303,Bornes de Aguiar,2057,1004,1053,1959,957,1002,790,1,655,1496,1494,2,4,1371
95770000,6,171304,Bragado,544,251,293,520,245,275,229,0,182,480,479,1,0,477
95805000,6,171305,Capeludos,440,200,240,432,199,233,199,0,136,438,438,0,0,437
95851000,6,171306,Gouvães da Serra,133,61,72,121,57,64,52,0,45,108,108,0,0,108
95875000,6,171307,Parada de Monteiros,72,30,42,72,30,42,37,0,22,94,94,0,0,94
95886000,6,171308,Pensalvos,278,127,151,276,128,148,125,0,96,281,281,0,0,278
95914000,6,171309,Santa Marta da Montanha,135,69,66,133,69,64,58,0,46,130,130,0,0,130
95932000,6,171310,Soutelo de Aguiar,638,296,342,607,280,327,236,0,202,513,513,0,0,506
95979000,6,171311,Telões,1485,723,762,1431,691,740,550,0,461,1009,1009,0,2,1006
96060000,6,171312,Tresminas,415,196,219,409,194,215,181,0,139,370,370,0,0,370
96099000,6,171313,Valoura,376,186,190,376,186,190,163,0,125,328,328,0,0,328
96113000,6,171314,Vila Pouca de Aguiar,3303,1577,1726,3183,1505,1678,1233,1,1040,2065,2064,1,9,1482
96212000,6,171315,Vreia de Bornes,652,321,331,639,315,324,259,0,208,517,517,0,0,516
96237000,6,171316,Vreia de Jales,967,471,496,988,478,510,398,0,301,877,877,0,0,863
96291000,6,171317,Sabroso de Aguiar,684,344,340,658,328,330,273,0,212,477,477,0,0,460
96319000,6,171318,Lixa do Alvão,424,212,212,405,205,200,163,0,136,309,309,0,0,307
231886000,6,21101,Colos,1005,497,508,977,481,496,417,2,298,750,750,0,2,745
231954000,6,21102,Relíquias,931,462,469,1065,516,549,413,1,278,772,771,1,2,763
232007000,6,21103,Sabóia,1152,603,549,1153,604,549,540,1,317,918,917,1,2,878
232064000,6,21104,Santa Clara-a-Velha,602,310,292,599,311,288,271,0,174,553,552,1,2,550
232094000,6,21105,Odemira (Santa Maria),1301,609,692,1318,607,711,533,4,362,822,822,0,7,714
232145000,6,21106,São Luís,1989,995,994,1936,969,967,881,0,643,1759,1756,3,9,1701
232232000,6,21107,São Martinho das Amoreiras,1006,515,491,989,505,484,442,1,302,1024,1024,0,2,958
232277000,6,21108,Odemira (São Salvador),1818,884,934,1735,856,879,796,0,578,1204,1200,4,5,1038
232352000,6,21109,São Teotónio,5527,2911,2616,5449,2852,2597,2593,1,1620,3745,3725,20,21,3342
232551000,6,21110,Vale de Santiago,554,278,276,525,262,263,248,0,175,467,464,3,0,466
232589000,6,21111,Vila Nova de Milfontes,5031,2480,2551,4947,2429,2518,2062,0,1559,4635,4618,17,28,3556
232812000,6,21112,Pereiras-Gare,271,143,128,266,140,126,126,0,84,334,334,0,1,329
232836000,6,21113,Bicos,549,287,262,529,276,253,227,0,178,407,406,1,0,380
232868000,6,21114,Zambujeira do Mar,912,452,460,907,455,452,432,0,288,1064,1051,13,14,748
232968000,6,21115,Luzianes-Gare,429,242,187,408,231,177,206,0,127,435,435,0,1,409
232989000,6,21116,Boavista dos Pinheiros,1633,822,811,1592,799,793,617,0,518,823,821,2,3,745
233051000,6,21117,Longueira/Almograve,1356,681,675,1321,662,659,558,0,426,1212,1205,7,9,1127
233119000,6,150101,Alcácer do Sal (Santa Maria do Castelo),4048,1972,2076,3947,1925,2022,1617,2,1266,2416,2406,10,5,1894
233324000,6,150102,Santa Susana,353,180,173,339,172,167,168,0,128,420,420,0,1,420
233375000,6,150103,Alcácer do Sal (Santiago),4632,2206,2426,4477,2115,2362,1806,4,1429,2714,2711,3,13,2220
233574000,6,150104,Torrão,2295,1093,1202,2172,1032,1140,935,2,733,1805,1804,1,6,1611
233739000,6,150105,São Martinho,450,229,221,432,224,208,196,0,161,370,370,0,0,369
233773000,6,150106,Comporta,1268,652,616,1215,621,594,514,0,397,1093,1087,6,5,1021
233889000,6,150501,Azinheira Barros e São Mamede do Sádão,704,364,340,685,350,335,320,0,216,614,614,0,3,614
233929000,6,150502,Grândola,10657,5163,5494,10245,4922,5323,4395,5,3324,6701,6689,12,16,5458
234252000,6,150503,Melides,1658,825,833,1702,846,856,729,0,555,1747,1744,3,3,1623
234334000,6,150504,Santa Margarida da Serra,177,94,83,177,94,83,87,0,58,262,262,0,0,222
234356000,6,150505,Carvalhal,1630,1060,570,1666,1082,584,443,9,344,2717,2716,1,13,1420
234451000,6,150901,Abela,890,442,448,898,445,453,382,0,285,603,600,3,1,592
234501000,6,150902,Alvalade,2098,1024,1074,2021,987,1034,894,0,665,1175,1173,2,2,1123
234608000,6,150903,Cercal,3362,1650,1712,3131,1517,1614,1460,0,1074,2686,2680,6,8,2431
234729000,6,150904,Ermidas-Sado,2020,979,1041,1936,929,1007,870,2,642,1391,1386,5,4,1278
234833000,6,150905,Santa Cruz,461,237,224,449,232,217,206,0,148,363,362,1,0,348
234857000,6,150906,Santiago do Cacém,7603,3676,3927,7315,3564,3751,3126,6,2300,4369,4358,11,20,2831
235094000,6,150907,Santo André,10647,5247,5400,9995,4896,5099,4265,3,3416,5881,5869,12,9,2870
235333000,6,150908,São Bartolomeu da Serra,390,209,181,376,203,173,171,0,122,289,288,1,0,265
235360000,6,150909,São Domingos,854,408,446,830,393,437,363,0,265,597,596,1,0,588
235410000,6,150910,São Francisco da Serra,809,411,398,778,397,381,345,0,245,595,594,1,1,567
235438000,6,150911,Vale de Água,615,303,312,594,289,305,263,0,202,482,481,1,1,477
235468000,6,151301,Sines,13200,6513,6687,13203,6729,6474,5194,5,4045,7170,7144,26,40,3866
235819000,6,151302,Porto Covo,1038,516,522,1077,548,529,422,0,333,1148,1147,1,7,925
235928000,6,70701,Brotas,451,219,232,436,209,227,208,1,147,386,386,0,1,387
235967000,6,70702,Cabeção,1073,489,584,1060,482,578,432,3,317,1051,1051,0,5,1052
236039000,6,70703,Mora,2522,1231,1291,2403,1152,1251,996,2,773,1496,1496,0,7,1483
236141000,6,70704,Pavia,932,476,456,924,468,456,427,0,286,947,944,3,6,945
236210000,6,120101,Alter do Chão,2373,1120,1253,2100,982,1118,936,4,722,1739,1729,10,10,1591
236353000,6,120102,Chancelaria,448,202,246,453,203,250,198,1,137,559,559,0,2,560
236399000,6,120103,Seda,352,176,176,335,168,167,162,1,121,400,400,0,4,392
236433000,6,120104,Cunheira,389,182,207,387,180,207,168,1,122,354,354,0,2,343
236459000,6,120201,Assunção,1970,926,1044,1941,896,1045,759,4,576,1414,1413,1,7,1151
236547000,6,120202,Esperança,739,369,370,728,361,367,322,1,219,841,841,0,1,778
236598000,6,120203,Mosteiros,456,240,216,438,227,211,165,1,136,285,285,0,1,280
236622000,6,120301,Alcôrrego,401,205,196,388,194,194,163,0,131,393,392,1,0,354
236651000,6,120302,Aldeia Velha,280,134,146,272,128,144,133,0,89,327,327,0,2,324
236674000,6,120303,Avis,1840,861,979,1787,831,956,727,2,549,1168,1151,17,7,1086
236764000,6,120304,Benavila,861,396,465,832,380,452,338,2,243,645,632,13,4,628
236811000,6,120305,Ervedal,560,272,288,532,259,273,243,0,174,437,436,1,0,429
236858000,6,120306,Figueira e Barros,309,147,162,297,139,158,130,0,98,291,291,0,1,288
236892000,6,120307,Maranhão,63,30,33,56,25,31,24,0,19,139,138,1,0,138
236904000,6,120308,Valongo,257,133,124,256,132,124,109,1,73,279,279,0,1,280
236928000,6,120401,Nossa Senhora da Expectação,3974,1898,2076,3802,1798,2004,1468,2,1214,2094,2047,47,7,1761
237035000,6,120402,Nossa Senhora da Graça dos Degolados,587,296,291,593,288,305,230,1,186,426,426,0,1,415
237060000,6,120403,São João Baptista,3895,1904,1991,3763,1826,1937,1476,0,1205,2247,2246,1,3,1946
237185000,6,120501,Nossa Senhora da Graça de Póvoa e Meadas,606,294,312,583,280,303,246,2,186,654,653,1,4,654
237225000,6,120502,Santa Maria da Devesa,1578,742,836,1534,711,823,669,1,506,1340,1339,1,6,1241
237312000,6,120503,Santiago Maior,358,180,178,354,180,174,163,1,114,319,318,1,6,301
237339000,6,120504,São João Baptista,865,413,452,894,427,467,338,1,254,574,574,0,6,450
237386000,6,120601,Aldeia da Mata,374,159,215,367,155,212,155,1,101,450,449,1,1,451
237416000,6,120602,Crato e Mártires,1674,773,901,1670,761,909,655,3,504,1241,1233,8,4,1193
237519000,6,120603,Flor da Rosa,263,129,134,260,127,133,115,0,80,245,245,0,3,240
237542000,6,120604,Gáfete,856,407,449,843,397,446,376,1,279,688,688,0,1,689
237598000,6,120605,Monte da Pedra,280,137,143,282,138,144,139,0,96,293,293,0,0,293
237635000,6,120606,Vale do Peso,261,120,141,247,112,135,110,1,73,344,344,0,1,325
237656000,6,120701,"Ajuda, Salvador e Santo Ildefonso",986,398,588,945,376,569,381,3,268,794,793,1,4,459
237692000,6,120702,Alcáçova,2147,1048,1099,2081,998,1083,854,3,618,1258,1255,3,6,941
237754000,6,120703,Assunção,8702,4175,4527,8289,3973,4316,3305,5,2628,4355,4352,3,15,1671
237940000,6,120704,Barbacena,663,318,345,646,309,337,280,2,199,587,587,0,2,586
237986000,6,120705,Caia e São Pedro,4106,2002,2104,3940,1908,2032,1573,1,1239,2188,2174,14,4,1498
238106000,6,120706,Santa Eulália,1198,586,612,1143,562,581,498,1,375,840,839,1,1,833
238161000,6,120707,São Brás e São Lourenço,1684,827,857,1610,790,820,645,0,533,903,902,1,3,785
238215000,6,120708,São Vicente e Ventosa,801,398,403,796,383,413,293,3,238,497,496,1,4,494
238256000,6,120709,Terrugem,1251,602,649,1197,575,622,467,1,383,732,729,3,1,717
238296000,6,120710,Vila Boim,1224,594,630,1180,577,603,502,1,369,946,946,0,1,934
238345000,6,120711,Vila Fernando,316,144,172,311,138,173,111,2,86,275,275,0,2,274
238370000,6,120801,Cabeço de Vide,1063,492,571,993,455,538,418,4,311,1021,1021,0,11,979
238487000,6,120802,Fronteira,2069,993,1076,1984,944,1040,815,1,636,1354,1354,0,5,1326
238608000,6,120803,São Saturnino,278,142,136,268,133,135,117,0,95,218,218,0,0,214
238626000,6,120901,Atalaia,138,61,77,128,57,71,65,0,45,168,168,0,0,168
238647000,6,120902,Belver,684,302,382,657,288,369,336,1,226,867,867,0,5,861
238812000,6,120903,Comenda,890,418,472,848,393,455,369,1,282,750,749,1,1,746
238900000,6,120904,Gavião,1609,770,839,1561,743,818,618,3,457,1200,1197,3,8,1044
239009000,6,120905,Margem,811,400,411,788,384,404,355,0,269,614,614,0,0,612
239099000,6,121001,Beirã,498,245,253,500,246,254,220,0,154,507,507,0,1,494
239149000,6,121002,Santa Maria de Marvão,486,225,261,655,298,357,176,1,126,519,519,0,6,492
239213000,6,121003,Santo António das Areias,1102,546,556,1075,531,544,474,0,363,827,826,1,4,748
239322000,6,121004,São Salvador da Aramenha,1426,704,722,1328,649,679,604,1,447,1128,1128,0,14,1065
239436000,6,121101,Assumar,651,247,404,639,241,398,197,3,155,431,425,6,3,422
239476000,6,121102,Monforte,1384,677,707,1334,656,678,497,2,407,816,808,8,5,795
239549000,6,121103,Santo Aleixo,638,319,319,623,313,310,271,0,206,533,533,0,0,528
239587000,6,121104,Vaiamonte,656,310,346,638,304,334,254,1,204,576,567,9,2,577
239641000,6,121201,Alpalhão,1238,605,633,1205,588,617,531,1,392,1065,1064,1,5,1026
239698000,6,121202,Amieira do Tejo,241,113,128,231,107,124,110,1,72,468,468,0,2,467
239749000,6,121203,Arez,256,131,125,255,131,124,126,0,79,337,337,0,0,334
239786000,6,121204,Espírito Santo,1861,880,981,1792,847,945,820,1,585,1500,1500,0,3,1408
239868000,6,121205,Montalvão,442,199,243,441,198,243,231,1,134,878,878,0,1,879
239927000,6,121206,Nossa Senhora da Graça,1590,761,829,1535,734,801,592,2,465,1076,1075,1,2,1059
239996000,6,121207,Santana,404,185,219,364,160,204,193,1,124,445,445,0,1,444
240043000,6,121208,São Matias,289,129,160,288,129,159,146,0,103,534,534,0,0,534
240113000,6,121209,São Simão,118,57,61,115,56,59,67,0,39,280,280,0,0,280
240144000,6,121210,Tolosa,1011,477,534,957,451,506,402,1,317,739,739,0,1,735
240199000,6,121301,Galveias,1061,510,551,1048,508,540,417,3,306,989,989,0,4,976
240267000,6,121302,Montargil,2316,1125,1191,2215,1064,1151,953,2,726,1807,1807,0,2,1761
240384000,6,121303,Ponte de Sor,8958,4285,4673,8470,4018,4452,3476,5,2729,4674,4648,26,13,3719
240654000,6,121304,Foros de Arrão,919,438,481,869,413,456,407,1,303,627,621,6,1,616
240693000,6,121305,Longomel,1228,603,625,1181,573,608,522,0,386,845,845,0,3,830
240755000,6,121306,Vale de Açor,698,346,352,661,328,333,299,0,216,548,548,0,0,501
240792000,6,121307,Tramaga,1542,778,764,1485,737,748,597,0,487,826,823,3,0,791
240838000,6,121401,Alagoa,669,317,352,644,297,347,276,1,205,377,377,0,2,349
240862000,6,121402,Alegrete,1746,862,884,1690,826,864,723,1,567,1063,1063,0,4,997
240922000,6,121403,Carreiras,583,298,285,570,290,280,241,0,183,415,415,0,2,380
240953000,6,121404,Fortios,2018,965,1053,1951,927,1024,755,1,610,1089,1089,0,3,1021
241011000,6,121405,Reguengo,630,311,319,620,308,312,260,0,206,477,477,0,1,455
241033000,6,121406,Ribeira de Nisa,1366,681,685,1284,632,652,539,1,427,752,751,1,3,710
241071000,6,121407,São Julião,342,173,169,331,168,163,170,1,103,465,464,1,3,420
241099000,6,121408,São Lourenço,4987,2334,2653,5254,2631,2623,2092,12,1492,3238,3236,2,19,1500
241195000,6,121409,Sé,10655,5074,5581,10318,4833,5485,4339,3,3366,5700,5700,0,7,2245
241399000,6,121410,Urra,1934,956,978,1865,908,957,765,1,620,1167,1166,1,2,1127
241476000,6,70101,Alandroal (Nossa Senhora da Conceição),1873,897,976,1829,867,962,741,2,558,1259,1259,0,7,1222
241563000,6,70102,Juromenha (Nossa Senhora do Loreto),107,60,47,101,58,43,46,0,32,132,131,1,2,133
241578000,6,70103,Santiago Maior,2205,1071,1134,2083,997,1086,879,1,700,1455,1455,0,6,1411
241679000,6,70104,Capelins (Santo António),527,246,281,511,239,272,244,0,169,614,614,0,1,613
241725000,6,70105,Terena (São Pedro),767,379,388,746,367,379,326,0,246,738,738,0,1,735
241788000,6,70106,São Brás dos Matos (Mina do Bugalho),364,180,184,346,171,175,145,0,114,299,299,0,1,263
241808000,6,70201,Arraiolos,3386,1632,1754,3268,1557,1711,1329,1,1034,1910,1906,4,7,1741
241988000,6,70202,Igrejinha,932,458,474,911,450,461,372,1,287,577,575,2,2,572
242027000,6,70203,Santa Justa,225,118,107,218,114,104,94,0,70,177,177,0,1,178
242050000,6,70204,São Gregório,341,167,174,334,164,170,170,0,105,312,312,0,0,299
242081000,6,70205,Gafanhoeira (São Pedro),494,234,260,472,222,250,216,0,162,327,327,0,0,299
242114000,6,70206,Vimieiro,1589,769,820,1544,746,798,656,2,479,1155,1155,0,7,1047
242178000,6,70207,Sabugueiro,396,198,198,374,186,188,163,0,131,280,280,0,0,273
242211000,6,70301,Borba (Matriz),3779,1878,1901,3605,1782,1823,1451,4,1190,1942,1939,3,8,1446
242324000,6,70302,Orada,740,361,379,716,346,370,308,0,236,508,508,0,0,378
242367000,6,70303,Rio de Moinhos,2056,1019,1037,1971,972,999,798,0,664,1163,1163,0,2,1091
242459000,6,70304,Borba (São Bartolomeu),758,357,401,712,332,380,372,1,240,552,552,0,4,369
242482000,6,70401,Arcos,1152,557,595,1146,542,604,503,1,370,724,721,3,4,698
242535000,6,70402,Glória,532,261,271,509,249,260,205,0,171,451,451,0,1,400
242564000,6,70403,Estremoz (Santa Maria),6284,3042,3242,6014,2889,3125,2489,4,1961,3331,3295,36,9,2053
242740000,6,70404,Évora Monte (Santa Maria),569,261,308,560,257,303,241,1,162,608,608,0,4,488
242776000,6,70405,Santa Vitória do Ameixial,362,180,182,333,166,167,157,0,114,314,314,0,0,314
242791000,6,70406,Estremoz (Santo André),2378,1066,1312,2267,1008,1259,1064,2,714,1861,1860,1,11,1362
242861000,6,70407,Santo Estêvão,74,34,40,73,34,39,34,0,26,138,138,0,0,138
242872000,6,70408,São Bento do Ameixial,335,168,167,328,165,163,147,0,106,312,312,0,0,243
242895000,6,70409,São Bento de Ana Loura,32,17,15,25,14,11,13,0,11,62,62,0,0,53
242901000,6,70410,São Bento do Cortiço,699,322,377,681,314,367,269,1,224,368,368,0,2,369
242931000,6,70411,São Domingos de Ana Loura,341,164,177,330,159,171,138,0,111,258,258,0,0,253
242953000,6,70412,São Lourenço de Mamporcão,524,252,272,490,234,256,217,1,177,357,357,0,1,355
242982000,6,70413,Veiros,1036,489,547,997,466,531,424,2,319,710,709,1,2,662
243036000,6,70501,Nossa Senhora da Boa Fé,322,156,166,324,153,171,126,1,89,200,200,0,1,178
243068000,6,70502,Nossa Senhora da Graça do Divor,486,228,258,480,222,258,185,1,145,296,296,0,1,292
243102000,6,70503,Nossa Senhora de Machede,1123,556,567,1115,549,566,434,1,354,653,652,1,2,651
243194000,6,70504,Nossa Senhora da Tourega,686,342,344,680,336,344,283,1,209,409,409,0,2,339
243253000,6,70505,Évora (Santo Antão),1323,585,738,1558,694,864,717,2,366,1313,1312,1,8,1098
243323000,6,70506,São Bento do Mato,1151,564,587,1106,538,568,496,0,361,785,785,0,1,707
243397000,6,70507,Évora (São Mamede),1724,695,1029,1765,714,1051,919,4,474,1502,1501,1,6,984
243473000,6,70508,São Manços,938,462,476,904,445,459,357,1,308,527,527,0,1,515
243531000,6,70509,São Miguel de Machede,794,394,400,826,401,425,317,2,237,509,508,1,2,454
243587000,6,70511,São Vicente do Pigeiro,364,181,183,351,175,176,142,0,113,294,294,0,0,280
243627000,6,70513,Torre de Coelheiros,715,353,362,657,323,334,269,1,224,469,469,0,1,405
243678000,6,70514,São Sebastião da Giesteira,760,381,379,720,359,361,295,1,236,356,356,0,1,327
243718000,6,70515,Canaviais,3442,1692,1750,3352,1650,1702,1241,4,1062,1497,1497,0,7,1160
243796000,6,70516,Nossa Senhora de Guadalupe,465,219,246,458,213,245,181,0,148,230,230,0,0,205
243832000,6,70517,Bacelo,9309,4536,4773,8896,4272,4624,3475,4,2902,4043,4040,3,6,2702
244056000,6,70518,Horta das Figueiras,10006,4799,5207,9854,4679,5175,3837,8,2971,4453,4448,5,17,2669
244340000,6,70519,Malagueira,12373,5833,6540,11845,5537,6308,4781,8,3834,5444,5431,13,14,3535
244620000,6,70520,Sé e São Pedro,1691,710,981,2095,858,1237,852,5,447,1511,1511,0,24,1056
244731000,6,70521,Senhora da Saúde,8924,4145,4779,8825,4072,4753,3867,7,2770,4713,4705,8,13,3119
244940000,6,70601,Cabrela,649,316,333,665,313,352,274,1,205,427,427,0,2,385
244985000,6,70602,Lavre,740,360,380,708,343,365,301,1,231,521,521,0,5,478
245025000,6,70603,Nossa Senhora do Bispo,4931,2340,2591,4743,2240,2503,1994,5,1556,2740,2739,1,9,2004
245174000,6,70604,Nossa Senhora da Vila,6070,2978,3092,5874,2872,3002,2335,5,1848,3010,2995,15,13,1932
245341000,6,70605,Santiago do Escoural,1335,641,694,1261,606,655,594,1,410,940,940,0,2,747
245412000,6,70606,São Cristóvão,540,258,282,570,295,275,247,1,163,493,493,0,7,476
245472000,6,70607,Ciborro,714,354,360,702,347,355,299,1,224,481,481,0,1,427
245512000,6,70608,Cortiçadas,821,402,419,791,380,411,361,0,276,614,613,1,1,564
245561000,6,70609,Silveiras,567,287,280,539,272,267,244,0,186,421,420,1,0,315
245593000,6,70610,Foros de Vale de Figueira,1070,525,545,1042,507,535,406,2,344,676,675,1,3,652
245638000,6,70801,Granja,605,304,301,607,304,303,267,0,194,580,577,3,1,568
245701000,6,70802,Luz,290,153,137,289,152,137,109,1,85,230,230,0,3,232
245735000,6,70803,Mourão,1768,858,910,1721,832,889,627,1,513,1136,1122,14,7,1075
245829000,6,70901,Alqueva,329,161,168,694,499,195,159,0,96,388,387,1,1,384
245867000,6,70902,Amieira,362,186,176,359,186,173,160,0,123,315,315,0,0,308
245904000,6,70903,Monte do Trigo,1240,626,614,1211,602,609,454,0,384,627,627,0,0,609
245961000,6,70904,Oriola,400,183,217,384,175,209,186,0,123,295,295,0,0,294
246009000,6,70905,Portel,2661,1298,1363,2623,1255,1368,1031,4,774,1535,1531,4,15,1491
246162000,6,70906,Santana,542,259,283,510,246,264,231,0,176,380,380,0,0,369
246212000,6,70907,São Bartolomeu do Outeiro,436,209,227,431,207,224,190,0,140,378,378,0,0,377
246248000,6,70908,Vera Cruz,458,230,228,450,222,228,178,0,133,344,344,0,0,341
246293000,6,71001,Montoito,1298,636,662,1275,624,651,540,1,402,1008,1007,1,1,980
246385000,6,71002,Redondo,5733,2798,2935,5535,2693,2842,2269,2,1775,3541,3539,2,11,2902
246623000,6,71101,Campo,688,328,360,671,319,352,284,1,216,502,501,1,1,500
246684000,6,71102,Corval,1389,668,721,1352,654,698,575,2,441,1023,1023,0,3,1001
246752000,6,71103,Monsaraz,782,384,398,759,374,385,347,0,237,783,783,0,15,797
246839000,6,71104,Reguengos de Monsaraz,7261,3543,3718,6868,3326,3542,2686,6,2211,3614,3606,8,17,3225
247096000,6,71105,Campinho,708,351,357,688,338,350,280,0,232,471,470,1,0,466
247139000,6,71201,Vendas Novas,11123,5351,5772,10637,5078,5559,4425,11,3558,6063,6050,13,18,4893
247393000,6,71202,Landeira,723,354,369,700,340,360,290,0,243,353,352,1,0,345
247431000,6,71301,Alcáçovas,2111,1040,1071,2058,1003,1055,833,2,622,1520,1519,1,6,1463
247596000,6,71302,Viana do Alentejo,2742,1299,1443,2626,1226,1400,1061,3,839,1626,1625,1,8,1560
247731000,6,71303,Aguiar,890,441,449,846,414,432,320,1,274,424,424,0,1,423
247791000,6,71401,Bencatel,1679,858,821,1694,859,835,669,0,543,979,979,0,0,950
247841000,6,71402,Ciladas,1071,525,546,1041,502,539,444,1,343,685,685,0,1,647
247881000,6,71403,Vila Viçosa (Conceição),4165,2008,2157,3925,1870,2055,1624,3,1280,2127,2123,4,11,1526
248027000,6,71404,Pardais,546,281,265,539,276,263,213,0,181,381,381,0,0,355
248059000,6,71405,Vila Viçosa (São Bartolomeu),858,385,473,826,364,462,383,2,247,592,592,0,6,396
248086000,6,121501,Cano,1266,602,664,1213,576,637,546,1,384,931,931,0,2,890
248155000,6,121502,Casa Branca,1232,574,658,1185,552,633,506,1,369,1090,1089,1,2,983
248217000,6,121503,Santo Amaro,644,301,343,618,292,326,255,1,195,406,406,0,1,394
248250000,6,121504,Sousel,1932,899,1033,1801,828,973,765,1,579,1320,1318,2,5,1242
248375000,6,20101,Aljustrel,5137,2540,2597,4944,2435,2509,2044,2,1613,2975,2974,1,7,2722
248586000,6,20102,Ervidel,1005,494,511,971,474,497,416,1,307,774,774,0,1,773
248665000,6,20103,Messejana,892,431,461,876,422,454,371,1,261,676,671,5,2,657
248748000,6,20104,São João de Negrilhos,1482,736,746,1414,698,716,611,1,466,935,935,0,1,932
248879000,6,20105,Rio de Moinhos,741,378,363,687,346,341,312,0,227,447,447,0,0,442
248921000,6,20201,Almodôvar,3788,1857,1931,3647,1805,1842,1512,2,1147,2387,2387,0,9,2020
249161000,6,20202,Gomes Aires,355,196,159,359,202,157,159,0,113,352,352,0,1,353
249214000,6,20203,Rosário,608,298,310,607,296,311,237,1,185,415,415,0,1,409
249268000,6,20204,Santa Clara-a-Nova,600,305,295,588,296,292,261,0,178,444,444,0,1,441
249325000,6,20205,Santa Cruz,651,327,324,640,319,321,294,1,199,718,714,4,4,711
249454000,6,20206,São Barnabé,531,257,274,515,250,265,235,1,157,452,452,0,1,453
249498000,6,20207,Senhora da Graça de Padrões,380,180,200,381,180,201,147,1,113,238,238,0,1,237
249535000,6,20208,Aldeia dos Fernandes,536,257,279,525,250,275,229,1,179,422,422,0,1,409
249576000,6,20301,Alvito,1259,610,649,1234,593,641,541,1,350,904,897,7,9,844
249662000,6,20302,Vila Nova da Baronia,1245,589,656,1168,545,623,484,1,373,820,820,0,3,786
249732000,6,20401,Barrancos,1834,890,944,1792,868,924,721,1,537,1287,1287,0,10,1227
249832000,6,20501,Albernoa,758,366,392,725,346,379,294,1,220,509,508,1,3,508
249901000,6,20502,Baleizão,902,432,470,896,430,466,389,0,270,710,710,0,0,710
249955000,6,20503,Beringel,1301,622,679,1276,612,664,544,0,419,868,868,0,1,856
250033000,6,20504,Cabeça Gorda,1386,691,695,1330,659,671,559,0,427,810,809,1,0,808
250098000,6,20505,Mombeja,386,195,191,381,194,187,160,0,112,285,283,2,0,276
250129000,6,20506,Nossa Senhora das Neves,1747,899,848,1681,870,811,686,1,557,989,989,0,1,974
250203000,6,20507,Quintos,255,126,129,252,124,128,115,0,84,244,244,0,0,243
250222000,6,20508,Salvada,1097,540,557,1058,510,548,437,1,331,694,688,6,1,688
250263000,6,20509,Beja (Salvador),6590,3159,3431,6284,2990,3294,2555,4,1952,3293,3293,0,6,1885
250377000,6,20510,Santa Clara de Louredo,864,399,465,867,387,480,286,2,232,345,340,5,2,327
250409000,6,20511,Beja (Santa Maria da Feira),4543,2195,2348,4438,2124,2314,1579,7,1269,2153,2135,18,12,1549
250508000,6,20512,Santa Vitória,595,302,293,588,299,289,259,0,191,487,487,0,1,485
250566000,6,20513,Beja (Santiago Maior),7620,3737,3883,7546,3722,3824,3024,7,2306,4129,4123,6,11,1883
250717000,6,20514,São Brissos,108,51,57,136,74,62,47,0,31,65,65,0,1,66
250733000,6,20515,Beja (São João Baptista),6395,3037,3358,6059,2833,3226,2669,4,1937,3524,3522,2,15,1291
250835000,6,20516,São Matias,569,270,299,547,262,285,230,0,177,384,384,0,0,380
250865000,6,20517,Trindade,274,134,140,259,125,134,112,0,84,242,242,0,0,233
250884000,6,20518,Trigaches,464,232,232,446,216,230,197,0,142,370,370,0,0,368
250914000,6,20601,Casével,448,222,226,430,213,217,210,0,139,398,398,0,1,399
250966000,6,20602,Castro Verde,4898,2402,2496,4653,2247,2406,1872,3,1476,2809,2809,0,8,2664
251217000,6,20603,Entradas,649,310,339,612,290,322,280,0,200,479,478,1,0,478
251258000,6,20604,Santa Bárbara de Padrões,943,469,474,909,443,466,409,0,290,773,772,1,0,768
251365000,6,20605,São Marcos da Ataboeira,338,164,174,328,159,169,146,0,103,363,363,0,0,361
251419000,6,20701,Cuba,3306,1616,1690,3250,1587,1663,1253,3,978,1863,1854,9,10,1808
251596000,6,20702,Faro do Alentejo,591,308,283,576,299,277,212,0,189,285,282,3,0,273
251631000,6,20703,Vila Alva,514,231,283,508,230,278,182,2,143,422,418,4,3,419
251681000,6,20704,Vila Ruiva,467,229,238,458,226,232,206,0,145,462,458,4,1,456
251750000,6,20801,Alfundão,863,449,414,844,439,405,374,0,265,570,569,1,0,552
251812000,6,20802,Ferreira do Alentejo,4696,2222,2474,4555,2133,2422,1822,5,1396,2788,2765,23,10,2519
252068000,6,20803,Figueira dos Cavaleiros,1346,675,671,1289,638,651,558,0,434,786,785,1,0,765
252165000,6,20804,Odivelas,542,270,272,519,263,256,235,0,173,427,426,1,1,426
252226000,6,20805,Peroguarda,364,184,180,349,175,174,142,0,110,288,287,1,2,286
252256000,6,20806,Canhestros,444,221,223,431,215,216,203,0,145,326,325,1,0,325
252300000,6,20901,Alcaria Ruiva,849,417,432,820,400,420,363,0,257,881,881,0,1,881
252422000,6,20902,Corte do Pinto,857,430,427,843,427,416,387,0,267,1571,1571,0,5,1573
252574000,6,20903,Espírito Santo,335,169,166,354,181,173,161,0,107,1122,1122,0,0,1120
252639000,6,20904,Mértola,2824,1392,1432,2728,1332,1396,1163,2,841,2189,2188,1,13,2074
252952000,6,20905,Santana de Cambas,797,391,406,729,351,378,325,2,223,1062,1062,0,5,1065
253129000,6,20906,São João dos Caldeireiros,567,275,292,559,267,292,242,0,176,489,489,0,2,489
253273000,6,20907,São Miguel do Pinheiro,596,298,298,579,287,292,291,0,183,696,696,0,0,693
253379000,6,20908,São Pedro de Solis,229,109,120,225,109,116,103,0,80,198,198,0,0,198
253436000,6,20909,São Sebastião dos Carros,220,112,108,214,109,105,102,0,71,261,260,1,0,261
253510000,6,21001,Amareleja,2564,1261,1303,2452,1192,1260,945,2,751,1742,1729,13,3,1704
253623000,6,21002,Póvoa de São Miguel,888,456,432,858,440,418,346,0,280,874,873,1,0,861
253710000,6,21003,Safara,1078,524,554,1074,514,560,415,1,318,764,763,1,2,762
253773000,6,21004,Moura (Santo Agostinho),4344,2145,2199,4176,2075,2101,1633,0,1312,2481,2470,11,3,1988
253899000,6,21005,Santo Aleixo da Restauração,793,389,404,780,381,399,334,0,240,856,856,0,1,826
253989000,6,21006,Santo Amador,412,190,222,418,192,226,180,0,140,386,386,0,0,363
254030000,6,21007,Moura (São João Baptista),4075,1967,2108,3924,1881,2043,1583,5,1178,2558,2557,1,11,2251
254138000,6,21008,Sobral da Adiça,1013,515,498,1005,508,497,397,1,297,965,951,14,2,950
254239000,6,21201,Conceição,86,44,42,85,44,41,48,0,26,186,186,0,1,186
254267000,6,21202,Garvão,731,352,379,691,331,360,331,0,234,574,574,0,0,568
254307000,6,21203,Ourique,2874,1431,1443,2789,1388,1401,1183,1,885,1956,1954,2,8,1798
254475000,6,21204,Panóias,496,248,248,487,245,242,208,1,148,396,396,0,1,390
254520000,6,21205,Santa Luzia,352,165,187,347,162,185,147,1,105,299,299,0,1,288
254550000,6,21206,Santana da Serra,850,416,434,824,403,421,391,1,262,764,761,3,1,737
254585000,6,21301,Aldeia Nova de São Bento,3072,1499,1573,2911,1415,1496,1168,1,920,2080,2076,4,2,2025
254722000,6,21302,Brinches,1039,500,539,1012,488,524,439,1,316,870,869,1,1,840
254804000,6,21303,Pias,2852,1399,1453,2773,1349,1424,1120,2,846,2029,2012,17,4,1934
254924000,6,21304,Serpa (Salvador),4365,2117,2248,4166,2018,2148,1655,3,1318,2549,2539,10,15,2200
255084000,6,21305,Serpa (Santa Maria),1868,902,966,1790,871,919,757,0,564,1245,1241,4,5,1215
255164000,6,21306,Vale de Vargo,968,477,491,931,460,471,403,0,308,636,635,1,0,633
255233000,6,21307,Vila Verde de Ficalho,1459,738,721,1386,693,693,580,0,482,947,947,0,4,904
255303000,6,21401,Pedrógão,1151,586,565,1128,576,552,507,0,363,939,938,1,4,936
255424000,6,21402,Selmes,894,444,450,878,435,443,365,0,274,681,681,0,1,674
255516000,6,21403,Vidigueira,2959,1439,1520,2850,1380,1470,1110,2,882,1699,1682,17,9,1511
255651000,6,21404,Vila de Frades,928,448,480,910,442,468,364,0,284,561,557,4,2,558
255713000,6,110301,Alcoentre,3448,2172,1276,3347,2105,1242,1003,12,786,1740,1739,1,5,1579
255820000,6,110302,Aveiras de Baixo,1317,632,685,1287,615,672,524,1,410,750,749,1,1,646
255867000,6,110303,Aveiras de Cima,4762,2282,2480,4612,2190,2422,1794,2,1482,2453,2451,2,5,2189
255964000,6,110304,Azambuja,8190,3954,4236,7879,3756,4123,3117,4,2542,4192,4192,0,8,2427
256113000,6,110305,Manique do Intendente,1216,592,624,1157,563,594,532,0,402,888,888,0,0,869
256179000,6,110306,Vale do Paraíso,880,420,460,852,406,446,367,0,286,512,512,0,0,487
256206000,6,110307,Vila Nova da Rainha,926,456,470,911,444,467,372,0,298,474,473,1,0,397
256229000,6,110308,Vila Nova de São Pedro,687,345,342,676,336,340,304,0,220,586,586,0,0,574
256273000,6,110309,Maçussa,388,178,210,376,172,204,184,0,124,323,323,0,0,321
256310000,6,140301,Almeirim,12812,6022,6790,12091,5625,6466,5191,6,3998,6894,6888,6,10,4355
256520000,6,140302,Benfica do Ribatejo,3067,1490,1577,2954,1421,1533,1189,1,989,1637,1635,2,2,1544
256613000,6,140303,Fazendas de Almeirim,6949,3328,3621,6675,3154,3521,2738,4,2270,3326,3314,12,4,3102
256745000,6,140304,Raposa,548,260,288,533,253,280,227,0,180,359,359,0,0,357
256776000,6,140401,Alpiarça,7702,3699,4003,7389,3497,3892,3003,3,2438,4049,4048,1,7,3473
256950000,6,140501,Benavente,9174,4443,4731,8820,4218,4602,3553,4,2854,4814,4804,10,9,3092
257152000,6,140502,Samora Correia,17123,8360,8763,16369,7854,8515,6366,5,5320,8240,8231,9,10,4833
257433000,6,140503,Santo Estêvão,1997,992,1005,1934,944,990,767,0,595,1298,1297,1,1,1268
257516000,6,140504,Barrosa,725,371,354,707,359,348,277,0,224,376,375,1,0,354
257536000,6,140601,Cartaxo,11370,5422,5948,10821,5087,5734,4560,7,3520,6070,6066,4,9,3230
257769000,6,140602,Ereira,636,310,326,630,305,325,254,1,200,436,436,0,1,437
257796000,6,140603,Lapa,1200,576,624,1158,550,608,465,1,370,616,615,1,2,567
257833000,6,140604,Pontével,4614,2249,2365,4452,2158,2294,1724,5,1470,2492,2489,3,6,2331
257963000,6,140605,Valada,821,417,404,829,420,409,340,0,260,647,647,0,0,634
258002000,6,140606,Vale da Pinta,1295,660,635,1227,610,617,508,0,418,765,764,1,1,734
258049000,6,140607,Vila Chã de Ourique,2771,1353,1418,2643,1266,1377,1060,0,870,1394,1390,4,0,1293
258128000,6,140608,Vale da Pedra,1755,857,898,1687,821,866,663,2,539,911,906,5,2,781
258172000,6,140701,Chamusca,3360,1603,1757,3248,1538,1710,1372,3,1050,1926,1925,1,8,1603
258267000,6,140702,Chouto,577,288,289,556,275,281,261,0,190,544,543,1,0,542
258304000,6,140703,Pinheiro Grande,939,460,479,895,432,463,379,0,290,538,537,1,2,527
258338000,6,140704,Ulme,1277,621,656,1250,599,651,518,0,418,757,757,0,0,729
258373000,6,140705,Vale de Cavalos,1032,485,547,984,459,525,435,0,345,724,722,2,0,704
258408000,6,140706,Parreira,915,448,467,902,441,461,377,1,296,502,502,0,1,500
258438000,6,140707,Carregueira,2020,973,1047,1927,920,1007,825,1,633,1231,1231,0,2,1199
258505000,6,140901,Coruche,8913,4165,4748,8468,3893,4575,3685,4,2817,5305,5269,36,7,4555
258720000,6,140902,Couço,2765,1323,1442,2661,1268,1393,1200,4,910,2163,2160,3,8,2128
258831000,6,140903,São José da Lamarosa,1727,833,894,1663,793,870,738,0,588,996,996,0,1,992
258910000,6,140904,Fajarda,1839,888,951,1727,819,908,736,1,590,1117,1109,8,2,1097
258950000,6,140905,Branca,1474,729,745,1402,687,715,611,0,501,941,937,4,0,941
259013000,6,140906,Erra,1004,491,513,956,457,499,425,0,325,611,611,0,0,600
259061000,6,140907,Biscainho,1074,519,555,1030,490,540,433,0,360,773,772,1,0,764
259091000,6,140908,Santana do Mato,1148,575,573,1141,565,576,501,0,402,725,721,4,0,713
259137000,6,141201,Azinhaga,1620,790,830,1593,776,817,620,1,509,837,837,0,2,812
259204000,6,141202,Golegã,3845,1770,2075,3668,1668,2000,1515,5,1180,2278,2277,1,11,1961
259322000,6,141401,Alcobertas,1923,974,949,1858,940,918,703,1,555,1016,1015,1,5,1014
259447000,6,141402,Arrouquelas,591,285,306,566,272,294,245,1,176,396,396,0,1,389
259506000,6,141403,Arruda dos Pisões,405,186,219,392,180,212,163,0,129,274,274,0,0,270
259541000,6,141404,Azambujeira,458,230,228,457,232,225,194,0,141,290,289,1,0,289
259576000,6,141405,Fráguas,905,429,476,865,407,458,351,2,279,489,489,0,2,488
259630000,6,141406,Marmeleira,437,210,227,433,205,228,168,1,128,368,367,1,1,359
259659000,6,141407,Outeiro da Cortiçada,674,327,347,631,304,327,268,0,216,449,449,0,1,441
259711000,6,141408,Rio Maior,12005,5779,6226,11671,5595,6076,4683,7,3678,6839,6837,2,31,4289
260060000,6,141409,São João da Ribeira,892,439,453,849,409,440,344,1,288,530,529,1,1,526
260111000,6,141410,Asseiceira,1017,497,520,987,472,515,405,0,320,629,629,0,1,614
260159000,6,141411,São Sebastião,523,244,279,500,232,268,223,0,160,300,299,1,0,296
260194000,6,141412,Ribeira de São João,496,241,255,472,229,243,196,0,158,311,311,0,1,311
260221000,6,141413,Malaqueijo,438,209,229,427,203,224,194,1,135,297,297,0,1,297
260253000,6,141414,Assentiz,428,205,223,403,195,208,167,0,137,247,247,0,0,246
260272000,6,141501,Glória do Ribatejo,3224,1586,1638,3134,1524,1610,1266,0,1089,1546,1546,0,0,1531
260347000,6,141502,Marinhais,6336,3072,3264,6071,2890,3181,2441,6,2015,3487,3467,20,7,3253
260475000,6,141503,Muge,1270,598,672,1250,587,663,518,1,402,778,777,1,3,753
260533000,6,141504,Salvaterra de Magos,5526,2604,2922,5143,2412,2731,2115,9,1638,2977,2971,6,16,2337
260693000,6,141505,Foros de Salvaterra,4920,2350,2570,4714,2197,2517,1767,12,1507,2435,2431,4,12,2365
260803000,6,141506,Granho,883,435,448,848,410,438,340,0,292,475,475,0,0,474
260832000,6,141601,Abitureiras,972,455,517,932,435,497,385,2,301,585,585,0,2,581
260880000,6,141602,Abrã,1122,550,572,1074,516,558,447,0,355,686,686,0,0,664
260941000,6,141603,Achete,1918,938,980,1875,905,970,759,2,604,1210,1209,1,2,1202
261043000,6,141604,Alcanede,4547,2247,2300,4430,2170,2260,1775,0,1449,2456,2456,0,0,2388
261270000,6,141605,Alcanhões,1469,704,765,1421,679,742,558,2,452,794,794,0,2,781
261300000,6,141606,Almoster,1818,852,966,1738,783,955,706,2,541,1265,1261,4,2,1257
261374000,6,141607,Amiais de Baixo,1851,908,943,1789,867,922,740,1,569,1042,1041,1,1,959
261464000,6,141608,Arneiro das Milhariças,835,399,436,798,374,424,363,0,262,575,574,1,1,569
261524000,6,141609,Azoia de Baixo,297,124,173,295,120,175,97,1,70,146,146,0,1,139
261542000,6,141610,Azoia de Cima,496,239,257,486,228,258,206,0,159,331,330,1,2,322
261576000,6,141611,Casével,864,424,440,831,404,427,370,0,267,615,612,3,1,600
261638000,6,141612,Santarém (Marvila),9044,4016,5028,9046,3951,5095,3862,13,2647,5327,5306,21,17,1632
261763000,6,141613,Moçarria,1136,549,587,1105,527,578,441,0,355,661,660,1,0,653
261791000,6,141614,Pernes,1446,688,758,1392,661,731,565,2,422,769,767,2,3,632
261854000,6,141615,Pombalinho,448,213,235,439,209,230,204,0,135,304,304,0,0,303
261867000,6,141616,Póvoa da Isenta,1127,553,574,1115,539,576,424,2,336,661,659,2,2,655
261899000,6,141617,Póvoa de Santarém,708,342,366,689,330,359,246,1,212,353,352,1,1,348
261925000,6,141618,Romeira,783,388,395,741,365,376,289,1,246,432,431,1,2,423
261954000,6,141619,Santa Iria da Ribeira de Santarém,745,329,416,721,314,407,323,0,230,481,470,11,0,339
261984000,6,141620,Santarém (São Nicolau),9627,4501,5126,9546,4413,5133,3922,5,2925,5201,5197,4,9,1727
262112000,6,141621,Santarém (São Salvador),10513,4993,5520,10169,4758,5411,4161,3,3251,5304,5300,4,9,2580
262315000,6,141622,São Vicente do Paul,1835,880,955,1764,834,930,717,0,593,1168,1165,3,0,1155
262409000,6,141623,Tremês,1981,931,1050,1915,891,1024,808,1,631,1156,1155,1,1,1128
262505000,6,141624,Vale de Figueira,1082,540,542,1045,512,533,417,0,353,585,585,0,0,551
262539000,6,141625,Vale de Santarém,2920,1403,1517,2838,1348,1490,1164,1,925,1597,1587,10,3,1393
262606000,6,141626,Vaqueiros,285,137,148,270,130,140,105,0,91,174,174,0,0,166
262625000,6,141627,Várzea,1817,897,920,1758,859,899,695,0,582,942,942,0,4,905
262691000,6,141628,Gançaria,514,247,267,498,239,259,192,0,160,278,278,0,0,273
262719000,6,80101,Albufeira,22781,11113,11668,28606,14060,14546,9272,8,6768,23631,23582,49,446,8737
263425000,6,80102,Guia,4376,2148,2228,4891,2439,2452,1749,2,1340,5413,5408,5,46,3213
263581000,6,80103,Paderne,3304,1645,1659,3252,1629,1623,1342,2,1022,2284,2278,6,6,2016
263684000,6,80104,Ferreiras,6406,3178,3228,6144,3017,3127,2458,1,2011,3442,3426,16,4,2610
263810000,6,80105,Olhos de Água,3961,1944,2017,6685,3332,3353,1599,0,1254,7861,7854,7,69,3110
263999000,6,80201,Alcoutim,921,448,473,940,462,478,413,1,253,1242,1242,0,7,1215
264173000,6,80202,Giões,256,128,128,248,124,124,130,0,77,311,311,0,0,303
264255000,6,80203,Martim Longo,1030,514,516,1013,505,508,459,0,328,1044,1044,0,1,1031
264416000,6,80204,Pereiro,213,108,105,214,110,104,116,0,66,396,396,0,1,397
264494000,6,80205,Vaqueiros,497,256,241,478,244,234,244,0,155,515,515,0,0,515
264575000,6,80301,Aljezur,3365,1653,1712,3328,1635,1693,1492,1,1041,3434,3421,13,24,3136
264906000,6,80302,Bordeira,432,229,203,462,247,215,213,0,130,573,573,0,11,548
265000000,6,80303,Odeceixe,961,470,491,931,455,476,418,1,291,949,948,1,12,859
265085000,6,80304,Rogil,1126,553,573,1103,543,560,526,0,364,920,915,5,4,848
265158000,6,80401,Azinhal,522,252,270,503,242,261,255,0,157,657,657,0,0,649
265210000,6,80402,Castro Marim,3267,1629,1638,3236,1603,1633,1307,1,1005,2820,2816,4,4,2657
265364000,6,80403,Odeleite,763,398,365,766,400,366,380,0,257,1200,1200,0,1,1191
265440000,6,80404,Altura,2195,1076,1119,2564,1253,1311,882,0,697,3685,3680,5,11,2268
265577000,6,80501,Conceição,4524,2267,2257,4365,2189,2176,1726,1,1391,2305,2263,42,1,1779
265705000,6,80502,Estoi,3652,1800,1852,3701,1806,1895,1393,3,1135,2292,2283,9,7,1969
265877000,6,80503,Santa Bárbara de Nexe,4116,2034,2082,3981,1965,2016,1578,3,1283,2806,2792,14,3,2558
266035000,6,80504,Faro (São Pedro),14577,6990,7587,14198,6782,7416,6227,7,4329,8688,8597,91,35,3407
266307000,6,80505,Faro (Sé),29542,13796,15746,28961,13374,15587,12728,18,8900,17459,17434,25,38,4894
266707000,6,80506,Montenegro,8149,4043,4106,8261,4047,4214,3277,0,2501,4425,4419,6,8,2650
266906000,6,80601,Estômbar,4985,2488,2497,4976,2524,2452,1932,2,1567,3318,3306,12,67,2386
267082000,6,80602,Ferragudo,1973,1003,970,2073,1053,1020,861,0,616,1927,1926,1,32,1421
267182000,6,80603,Lagoa,7266,3513,3753,7178,3463,3715,2887,3,2200,4412,4408,4,84,2685
267389000,6,80604,Porches,2011,996,1015,2311,1174,1137,812,2,620,3300,3299,1,44,1707
267505000,6,80605,Carvoeiro,2721,1316,1405,3920,1940,1980,1120,0,856,4643,4642,1,154,3348
267658000,6,80606,Parchal,4019,1983,2036,3744,1823,1921,1459,0,1229,1988,1979,9,0,1225
267732000,6,80701,Barão de São João,895,448,447,909,457,452,398,1,264,689,676,13,5,666
267773000,6,80702,Bensafrim,1530,768,762,1493,743,750,623,1,482,1002,995,7,1,926
267849000,6,80703,Luz,3545,1731,1814,3809,1860,1949,1490,1,1120,5300,5295,5,27,3604
268160000,6,80704,Odiáxere,2984,1462,1522,2908,1428,1480,1156,2,937,1776,1769,7,8,1396
268273000,6,80705,Lagos (Santa Maria),8046,3817,4229,8024,3801,4223,3229,3,2392,6895,6895,0,37,2662
268492000,6,80706,Lagos (São Sebastião),14049,6864,7185,13791,6708,7083,5661,3,4309,11368,11343,25,27,3951
268831000,6,80801,Almancil,11136,5604,5532,12515,6402,6113,4369,2,3454,10121,10108,13,24,7536
269330000,6,80802,Alte,1997,988,1009,2008,996,1012,874,1,636,1565,1560,5,3,1522
269440000,6,80803,Ameixial,439,228,211,428,221,207,221,0,131,458,458,0,0,456
269501000,6,80804,Boliqueime,4973,2422,2551,4878,2373,2505,1963,1,1571,3189,3180,9,12,2756
269674000,6,80805,Quarteira,21798,10523,11275,22820,11087,11733,8899,2,6650,31496,31467,29,53,9383
270317000,6,80806,Querença,759,385,374,762,391,371,322,1,251,552,551,1,4,530
270358000,6,80807,Salir,2775,1381,1394,2671,1324,1347,1163,0,914,2009,2006,3,7,1935
270520000,6,80808,Loulé (São Clemente),17358,8293,9065,16546,7896,8650,6895,6,5417,10255,10246,9,14,5484
270906000,6,80809,Loulé (São Sebastião),7433,3656,3777,7155,3515,3640,2882,0,2315,4743,4719,24,2,3559
271148000,6,80810,Benafim,1069,516,553,935,443,492,470,0,359,749,749,0,1,722
271220000,6,80811,Tôr,885,453,432,875,446,429,344,0,288,525,521,4,1,511
271263000,6,80901,Alferce,441,231,210,434,226,208,199,0,142,428,428,0,0,423
271308000,6,80902,Marmelete,787,406,381,772,398,374,365,0,241,722,721,1,0,719
271358000,6,80903,Monchique,4817,2409,2408,4701,2360,2341,2019,3,1500,3438,3437,1,10,3059
271519000,6,81001,Fuseta,1918,930,988,1832,879,953,771,1,602,1393,1393,0,2,873
271592000,6,81002,Moncarapacho,7717,3832,3885,7479,3692,3787,3036,2,2445,4977,4959,18,12,4393
271816000,6,81003,Olhão,14914,7098,7816,14512,6902,7610,6148,2,4617,8947,8931,16,9,3808
272116000,6,81004,Pechão,3601,1773,1828,3460,1698,1762,1393,0,1143,1910,1871,39,1,1263
272227000,6,81005,Quelfes,17246,8541,8705,17044,8360,8684,6294,5,5250,8998,8978,20,12,4916
272494000,6,81101,Alvor,6154,3011,3143,7371,3768,3603,2462,3,1882,7327,7320,7,24,3234
272771000,6,81102,Mexilhoeira Grande,4029,2000,2029,3946,1949,1997,1541,4,1244,2724,2716,8,3,2399
272931000,6,81103,Portimão,45431,21842,23589,45213,21805,23408,18737,18,13886,36892,36851,41,111,9288
273889000,6,81201,São Brás de Alportel,10662,5232,5430,10322,5043,5279,4286,2,3336,6562,6552,10,14,4958
274159000,6,81301,Alcantarilha,2540,1247,1293,2674,1315,1359,999,2,778,1700,1700,0,7,1398
274276000,6,81302,Algoz,3831,1923,1908,3656,1825,1831,1505,1,1214,2347,2345,2,3,1866
274393000,6,81303,Armação de Pêra,4867,2397,2470,5033,2473,2560,2007,1,1467,11255,11251,4,9,1651
274546000,6,81304,Pêra,2432,1206,1226,2358,1156,1202,976,0,750,2245,2242,3,3,1714
274664000,6,81305,São Bartolomeu de Messines,8430,4212,4218,8275,4156,4119,3462,4,2713,5807,5800,7,13,4839
274992000,6,81306,São Marcos da Serra,1352,697,655,1346,695,651,642,0,419,1163,1161,2,1,1095
275088000,6,81307,Silves,11014,5506,5508,11009,5527,5482,4359,7,3422,6521,6511,10,22,4652
275356000,6,81308,Tunes,2660,1337,1323,2536,1269,1267,1019,0,836,1520,1512,8,1,968
275424000,6,81401,Cachopo,716,359,357,717,360,357,347,1,222,842,842,0,1,840
275485000,6,81402,Conceição,1438,718,720,1431,713,718,632,0,470,2219,2219,0,1,1138
275571000,6,81403,Luz,3355,1645,1710,3321,1617,1704,1353,2,1088,2396,2392,4,4,2090
275650000,6,81404,Santa Catarina da Fonte do Bispo,1809,911,898,1826,923,903,732,1,584,1429,1429,0,5,1396
275743000,6,81405,Tavira (Santa Maria),8836,4266,4570,9319,4497,4822,3543,3,2764,7325,7319,6,21,3733
276046000,6,81406,Tavira (Santiago),6297,3054,3243,6235,3076,3159,2470,4,1976,4216,4213,3,16,2126
276177000,6,81407,Santo Estêvão,1180,594,586,1174,589,585,494,0,395,963,960,3,3,946
276233000,6,81408,Santa Luzia,1455,727,728,1387,697,690,582,0,459,2274,2271,3,1,1229
276301000,6,81409,Cabanas de Tavira,1081,540,541,1650,841,809,450,0,336,3649,3647,2,7,1646
276406000,6,81501,Barão de São Miguel,451,231,220,485,244,241,201,0,137,488,484,4,18,476
276455000,6,81502,Budens,1520,763,757,1588,800,788,683,0,476,2614,2612,2,24,2275
276655000,6,81503,Raposeira,460,232,228,496,255,241,222,0,135,528,524,4,2,480
276730000,6,81504,Sagres,1909,943,966,2162,1075,1087,787,1,568,1580,1577,3,25,1349
276827000,6,81505,Vila do Bispo,918,455,463,942,469,473,393,0,279,693,690,3,7,604
276920000,6,81601,Vila Nova de Cacela,3902,1877,2025,4327,2111,2216,1598,1,1257,5570,5569,1,9,3780
277102000,6,81602,Vila Real de Santo António,11946,5687,6259,11519,5463,6056,4656,4,3641,8026,8013,13,14,2720
277394000,6,81603,Monte Gordo,3308,1589,1719,4750,2303,2447,1199,0,1002,6029,6027,2,16,1649
